id,municipality,population,latitude,longitude,area_m2,P18LESS,P19MORE
0,AARTSELAAR,14267,51.133233,4.381716,11038007.44,2936,11331
1,ANTWERPEN,472071,51.256454,4.376329,203836008.4,106898,365173
2,BOECHOUT,12335,51.166997,4.516046,20705762.17,3016,9319
3,BOOM,16434,51.09491,4.372092,7373225.92,3847,12587
4,BORSBEEK,10132,51.192807,4.486881,3930256.41,2057,8075
5,BRASSCHAAT,37190,51.310931,4.499741,38638820.82,7981,29209
6,BRECHT,27169,51.337281,4.627448,91306583.02,6584,20585
7,EDEGEM,21389,51.157582,4.432098,8683276.22,4436,16953
8,ESSEN,17416,51.450788,4.465132,47640661.31,4256,13160
9,HEMIKSEM,9862,51.14499,4.339351,5521671.19,2239,7623
10,HOVE,8326,51.148521,4.481519,5988835.49,1993,6333
11,KALMTHOUT,17578,51.400138,4.467834,59498750.61,4197,13381
12,KAPELLEN,26242,51.33522,4.442957,37214800.73,5814,20428
13,KONTICH,20290,51.125052,4.443882,23863854.91,4885,15405
14,LINT,8089,51.12905,4.497256,5589613.06,2065,6024
15,MORTSEL,24421,51.175938,4.460216,7775486.75,5377,19044
16,NIEL,9155,51.108629,4.334882,5309678.69,2144,7011
17,RANST,18061,51.194112,4.58991,43767947.62,4204,13857
18,RUMST,14693,51.095153,4.420288,20218717.28,3282,11411
19,SCHELLE,8034,51.123934,4.342135,7653645.49,1905,6129
20,SCHILDE,19516,51.257524,4.580801,36163312.82,4383,15133
21,SCHOTEN,33256,51.265583,4.507483,29601254.34,7477,25779
22,STABROEK,17737,51.329614,4.375958,21691341.97,3959,13778
23,WIJNEGEM,8886,51.230912,4.516127,7891460.25,1870,7016
24,WOMMELGEM,12187,51.208084,4.51818,12979851.5,2803,9384
25,WUUSTWEZEL,18837,51.39538,4.599679,89371579.1,4648,14189
26,ZANDHOVEN,12341,51.212643,4.678503,40137704.33,2733,9608
27,ZOERSEL,21003,51.258878,4.66913,38532001.83,4792,16211
28,ZWIJNDRECHT,18421,51.225909,4.322611,20158426.68,3785,14636
29,MALLE,14225,51.294577,4.712673,51884572.09,3448,10777
30,BERLAAR,10730,51.108521,4.655395,24524550.64,2273,8457
31,BONHEIDEN,14558,51.02212,4.569978,29123159.95,3198,11360
32,BORNEM,20347,51.096746,4.242113,46270562.67,4484,15863
33,DUFFEL,16235,51.097086,4.51342,22647080.5,3542,12693
34,HEIST-OP-DEN-BERG,39199,51.072957,4.735268,86659523.45,8054,31145
35,LIER,33492,51.119699,4.573136,49788544.84,7097,26395
36,MECHELEN,79503,51.029977,4.449491,65744254.07,18734,60769
37,NIJLEN,21210,51.152187,4.66283,39156754.82,4577,16633
38,PUTTE,15907,51.052062,4.635583,35189939.89,3242,12665
39,PUURS,16399,51.067188,4.304816,33366758.09,3678,12721
40,SINT-AMANDS,7887,51.052493,4.230212,15735386.75,1826,6061
41,SINT-KATELIJNE-WAVER,19976,51.063694,4.535531,36221022.66,4589,15387
42,WILLEBROEK,23664,51.0553,4.367713,27416992.13,5483,18181
43,ARENDONK,12518,51.336038,5.084635,55242015.68,2964,9554
44,BAARLE-HERTOG,2385,51.417787,4.903047,7521299.5,570,1815
45,BALEN,20643,51.159953,5.182249,73009631.11,4379,16264
46,BEERSE,16756,51.315703,4.822524,37330407.59,4127,12629
47,DESSEL,8932,51.242848,5.12126,27368939.27,1984,6948
48,GEEL,36014,51.167863,4.98396,110106351.7,7330,28684
49,GROBBENDONK,10815,51.181116,4.738345,28373873.56,2436,8379
50,HERENTALS,26268,51.1652,4.826892,47981507.7,5314,20954
51,HERENTHOUT,8534,51.140509,4.759204,23621071.27,1754,6780
52,HERSELT,14107,51.048706,4.882212,52358466.15,2833,11274
53,HOOGSTRATEN,19193,51.441793,4.762898,105388623.5,4600,14593
54,HULSHOUT,9594,51.0642,4.811665,17389860.18,2067,7527
55,KASTERLEE,18053,51.244617,4.941282,72214809.47,4190,13863
56,LILLE,15805,51.257069,4.833418,59576824.54,3643,12162
57,MEERHOUT,9578,51.125842,5.072789,36548709.73,1877,7701
58,MERKSPLAS,8321,51.371773,4.86943,44640200.82,2086,6235
59,MOL,33400,51.23502,5.15196,114618281.6,6905,26495
60,OLEN,11547,51.164827,4.884909,23153322.98,2522,9025
61,OUD-TURNHOUT,12677,51.322088,5.003525,39216345.82,2767,9910
62,RAVELS,14138,51.41626,5.025183,95070529.65,3317,10821
63,RETIE,10545,51.268451,5.076097,48536762.86,2384,8161
64,RIJKEVORSEL,10982,51.35644,4.766643,46904136.35,2630,8352
65,TURNHOUT,40070,51.330263,4.93937,56640703.31,8081,31989
66,VORSELAAR,7399,51.219021,4.772121,27632788.68,1576,5823
67,VOSSELAAR,10250,51.306609,4.884305,11858100.82,2374,7876
68,WESTERLO,23433,51.107796,4.881192,55459633.34,4976,18457
69,LAAKDAL,15080,51.08236,5.005198,42449870.38,3075,12005
70,ANDERLECHT,99085,50.830312,4.292204,17878792.61,26020,73065
71,OUDERGEM,30086,50.811452,4.43746,8986997.36,6828,23258
72,SINT-AGATHA-BERCHEM,20976,50.866007,4.29312,2974981.89,5301,15675
73,BRUSSEL,148873,50.874348,4.374641,33420451.94,37229,111644
74,ETTERBEEK,42902,50.834291,4.393792,3194065.01,8634,34268
75,EVERE,34727,50.870438,4.408341,4807634.23,8747,25980
76,VORST,48906,50.815443,4.323462,6325668.89,11916,36990
77,GANSHOREN,21743,50.875731,4.308694,2431541.99,4854,16889
78,ELSENE,79768,50.823602,4.376345,6419724.18,13466,66302
79,JETTE,44601,50.883049,4.320649,5197955.13,10678,33923
80,KOEKELBERG,19020,50.86435,4.323327,1178102.27,4942,14078
81,SINT-JANS-MOLENBEEK,83674,50.856521,4.317615,6015467.64,25105,58569
82,SINT-GILLIS,45235,50.830791,4.343932,2511909.9,10169,35066
83,SINT-JOOST-TEN-NODE,24078,50.855144,4.368668,1161176.38,6906,17172
84,SCHAARBEEK,116039,50.863191,4.385327,7919315.53,31475,84564
85,UKKEL,76732,50.791163,4.360613,22815608.97,16768,59964
86,WATERMAAL-BOSVOORDE,24134,50.794235,4.422713,12982367.76,5536,18598
87,SINT-LAMBRECHTS-WOLUWE,49261,50.849221,4.430855,7308193.38,10030,39231
88,SINT-PIETERS-WOLUWE,38651,50.83241,4.442288,8954310.13,8684,29967
89,ASSE,29558,50.908596,4.214611,50237868.93,6886,22672
90,BEERSEL,23587,50.751754,4.301134,30460744.63,5907,17680
91,BEVER,2093,50.712041,3.931404,19221992.48,524,1569
92,DILBEEK,39654,50.854611,4.23305,41467326.52,9040,30614
93,GALMAARDEN,8285,50.754208,3.987226,35265785.9,1869,6416
94,GOOIK,8931,50.782268,4.095011,40250272.61,2075,6856
95,GRIMBERGEN,34526,50.946011,4.375727,38574671.05,7674,26852
96,HALLE,35350,50.727681,4.236287,45042761.82,8084,27266
97,HERNE,6566,50.724215,4.035904,44727724.3,1539,5027
98,HOEILAART,10244,50.762295,4.450119,20470495.32,2580,7664
99,KAMPENHOUT,11090,50.942589,4.559876,33720240.4,2674,8416
100,KAPELLE-OP-DEN-BOS,8969,51.004989,4.353867,15404503.87,1925,7044
101,LIEDEKERKE,12206,50.867669,4.092293,10087681.67,2630,9576
102,LONDERZEEL,17525,51.011928,4.275641,36468610.04,3885,13640
103,MACHELEN,12953,50.904014,4.443289,11444101.64,3360,9593
104,MEISE,18466,50.962476,4.314833,35109970.44,4380,14086
105,MERCHTEM,15110,50.952605,4.246293,36920313.48,3447,11663
106,OPWIJK,12575,50.963765,4.179969,19942024.72,2813,9762
107,OVERIJSE,24394,50.772647,4.53205,45019532.34,6092,18302
108,PEPINGEN,4401,50.745574,4.146884,35973247.41,1050,3351
109,SINT-PIETERS-LEEUW,31119,50.788807,4.244059,40621611.62,7416,23703
110,STEENOKKERZEEL,11201,50.92247,4.498341,23520785.99,2587,8614
111,TERNAT,14781,50.869175,4.159426,24683492.99,3339,11442
112,VILVOORDE,38557,50.931576,4.43307,21598985.56,10185,28372
113,ZAVENTEM,29500,50.872682,4.485735,27751476.28,7232,22268
114,ZEMST,21700,50.980231,4.457249,43271173.99,5118,16582
115,ROOSDAAL,10934,50.838877,4.0966,21936445.02,2520,8414
116,DROGENBOS,4893,50.794984,4.308228,2539204.75,1204,3689
117,KRAAINEM,13080,50.846831,4.470582,5909406.98,3300,9780
118,LINKEBEEK,4721,50.769255,4.344746,4167286.29,1222,3499
119,SINT-GENESIUS-RODE,18021,50.745881,4.37309,22778351.51,4766,13255
120,WEMMEL,14916,50.910957,4.308595,8781676.54,3531,11385
121,WEZEMBEEK-OPPEM,13534,50.844373,4.491745,6838006.97,3631,9903
122,LENNIK,8747,50.814594,4.162922,31154150.49,1952,6795
123,AFFLIGEM,12229,50.905401,4.114874,17988941.83,2729,9500
124,AARSCHOT,28129,50.990325,4.86377,63031531.32,5388,22741
125,BEGIJNENDIJK,9647,51.008378,4.783827,17646656.23,2011,7636
126,BEKKEVOORT,5915,50.935725,4.977148,37229782.12,1321,4594
127,BERTEM,9435,50.855124,4.608996,29905223.27,2359,7076
128,BIERBEEK,9280,50.831462,4.766544,38982336.98,2148,7132
129,BOORTMEERBEEK,11673,50.981423,4.560064,18767137.47,2655,9018
130,BOUTERSEM,7538,50.836645,4.842004,31469426.03,1777,5761
131,DIEST,23025,51.002822,5.068336,58667298.27,4603,18422
132,GEETBETS,5837,50.892839,5.130348,35556038.9,1184,4653
133,HAACHT,13894,50.965382,4.640366,30701773.53,3263,10631
134,HERENT,19563,50.912011,4.645779,32602342.9,4787,14776
135,HOEGAARDEN,6356,50.780485,4.875478,34071804.5,1519,4837
136,HOLSBEEK,9460,50.931039,4.801058,38766260.65,2371,7089
137,HULDENBERG,9300,50.79112,4.611152,40019332.19,2331,6969
138,KEERBERGEN,12637,51.006544,4.653523,18545995.85,2884,9753
139,KORTENAKEN,7587,50.894521,5.022329,49477319.1,1492,6095
140,KORTENBERG,18662,50.891188,4.568079,34933635.75,4447,14215
141,LANDEN,15058,50.756099,5.06088,53234875.98,3070,11988
142,LEUVEN,92704,50.88353,4.705078,57606128.8,17975,74729
143,LUBBEEK,13784,50.883423,4.827836,44930450.68,3148,10636
144,OUD-HEVERLEE,10937,50.821346,4.686096,31065933.55,2647,8290
145,ROTSELAAR,15290,50.960894,4.731433,37213327.43,3644,11646
146,TERVUREN,20969,50.822957,4.523614,33512219.33,5439,15530
147,TIENEN,32207,50.813244,4.941045,72943521.76,6299,25908
148,TREMELO,14050,51.000512,4.72595,21897237.87,3047,11003
149,ZOUTLEEUW,8048,50.836478,5.100382,46772124.32,1619,6429
150,LINTER,7049,50.822171,5.041214,36880373.52,1488,5561
151,SCHERPENHEUVEL-ZICHEM,22317,50.999434,4.967795,51211169.57,4278,18039
152,TIELT-WINGE,10219,50.924744,4.895805,44608489.22,2268,7951
153,GLABBEEK,5246,50.868383,4.948663,26971798.95,1162,4084
154,BEAUVECHAIN,6621,50.777435,4.763867,38705488.66,1711,4910
155,BRAINE-L'ALLEUD,37728,50.674626,4.353994,52261064.11,9118,28610
156,BRAINE-LE-CHATEAU,9580,50.680994,4.283357,22729441.99,2432,7148
157,CHAUMONT-GISTOUX,11155,50.688491,4.689807,48293782.14,3073,8082
158,COURT-SAINT-ETIENNE,9607,50.627834,4.561777,26944432.53,2684,6923
159,GENAPPE,14405,50.611464,4.455304,90257557.14,3717,10688
160,GREZ-DOICEAU,12607,50.74976,4.687275,55519023.13,3257,9350
161,INCOURT,4739,50.700383,4.780723,38760121.47,1317,3422
162,ITTRE,6137,50.643818,4.256863,35022513.3,1557,4580
163,JODOIGNE,12763,50.729709,4.85953,73672479.33,3249,9514
164,LA_HULPE,7344,50.737596,4.464075,15448492.06,1797,5547
165,MONT-SAINT-GUIBERT,6637,50.638709,4.622618,18752240.1,1829,4808
166,NIVELLES,25035,50.598307,4.331397,60829105.24,5572,19463
167,PERWEZ,7773,50.635519,4.788974,51148341.13,2091,5682
168,RIXENSART,21571,50.722164,4.524854,17496868.91,5261,16310
169,TUBIZE,22945,50.691466,4.189763,32797547.91,5812,17133
170,VILLERS-LA-VILLE,9853,50.56382,4.526133,47985408.25,2602,7251
171,WATERLOO,29448,50.71109,4.40276,21363726.89,7421,22027
172,WAVRE,32784,50.717179,4.592433,42168462.72,7884,24900
173,CHASTRE,6891,50.590741,4.622597,31493286.32,1981,4910
174,HELECINE,3147,50.749727,4.981978,16979967.27,764,2383
175,LASNE,14043,50.683687,4.4609,47627518.28,3645,10398
176,ORP-JAUCHE,8054,50.69126,4.962491,50804343.94,2080,5974
177,OTTIGNIES-LOUVAIN-LA-NEUVE,30283,50.671676,4.563409,33382891.74,7624,22659
178,RAMILLIES,5945,50.658055,4.885228,49207049.12,1667,4278
179,REBECQ,10237,50.672829,4.129546,39248816.62,2648,7589
180,WALHAIN,6160,50.632532,4.696517,38102121.97,1701,4459
181,BEERNEM,14806,51.152033,3.335875,72456571.18,3261,11545
182,BLANKENBERGE,18450,51.301639,3.139447,17712383.46,3045,15405
183,BRUGGE,117073,51.241137,3.215561,129210291.5,23638,93435
184,DAMME,10875,51.253531,3.326695,90371884.45,2404,8471
185,JABBEKE,13675,51.189915,3.095683,53739715.77,3232,10443
186,OOSTKAMP,22111,51.120693,3.229545,80173851.65,5061,17050
187,TORHOUT,19755,51.063675,3.094742,45332089.38,4111,15644
188,ZEDELGEM,22060,51.127963,3.133533,60668118.67,5133,16927
189,ZUIENKERKE,2768,51.255227,3.130647,49001257.53,621,2147
190,KNOKKE-HEIST,34026,51.332045,3.309838,56698549.39,5465,28561
191,DIKSMUIDE,15998,51.048723,2.853439,150599498.3,3751,12247
192,HOUTHULST,9307,50.971323,2.89561,56035211.94,2171,7136
193,KOEKELARE,8342,51.090343,2.962999,39441700.16,1788,6554
194,KORTEMARK,12019,51.026128,3.001056,55510743.74,2601,9418
195,LO-RENINGE,3346,50.961939,2.774568,63523200.35,864,2482
196,IEPER,34812,50.855657,2.865683,131443469.5,7674,27138
197,MESEN,997,50.76112,2.896763,3548871.8,231,766
198,POPERINGE,19837,50.862358,2.690752,120414546,4697,15140
199,WERVIK,17775,50.811499,3.055715,43741841.7,4082,13693
200,ZONNEBEKE,12092,50.867807,3.002857,68079590.01,2938,9154
201,HEUVELLAND,8167,50.77682,2.829473,94836362.95,1975,6192
202,LANGEMARK-POELKAPELLE,7792,50.917235,2.928574,53099630.7,1954,5838
203,VLETEREN,3672,50.915034,2.740804,38474481.64,880,2792
204,ANZEGEM,14116,50.83206,3.453194,42357334.22,3312,10804
205,AVELGEM,9597,50.778924,3.452716,21977911.15,2145,7452
206,DEERLIJK,11283,50.843897,3.365386,17003143.82,2561,8722
207,HARELBEKE,26328,50.865155,3.306537,29376182.39,5622,20706
208,KORTRIJK,73941,50.801387,3.263723,80782015.47,15970,57971
209,KUURNE,12649,50.861602,3.270779,10096346.16,2796,9853
210,LENDELEDE,5467,50.887358,3.231279,13296821.31,1163,4304
211,MENEN,32450,50.793844,3.153651,33189983.16,7329,25121
212,WAREGEM,35963,50.882359,3.401334,45253734.71,8094,27869
213,WEVELGEM,30930,50.832669,3.173062,39116069.01,7200,23730
214,ZWEVEGEM,23898,50.788291,3.371764,63652629.4,5484,18414
215,SPIERE-HELKIJN,2050,50.731829,3.36195,10811371.63,535,1515
216,BREDENE,15578,51.237981,2.976812,12985704.97,3458,12120
217,GISTEL,11384,51.152413,2.942439,42859913.23,2784,8600
218,ICHTEGEM,13574,51.114553,3.029697,46401039.17,3061,10513
219,MIDDELKERKE,18378,51.153637,2.839684,76008919.65,3228,15150
220,OOSTENDE,69175,51.21064,2.925474,37832909.64,12196,56979
221,OUDENBURG,8955,51.188061,3.011647,34988872.35,2001,6954
222,DE_HAAN,12243,51.260267,3.046783,42002861.89,2207,10036
223,HOOGLEDE,9928,50.990788,3.0815,38110096.08,2337,7591
224,INGELMUNSTER,10620,50.922818,3.259879,16404081.57,2377,8243
225,IZEGEM,26781,50.922524,3.204787,25576923.75,5669,21112
226,LEDEGEM,9371,50.87321,3.148411,24866687.03,2149,7222
227,LICHTERVELDE,8489,51.029141,3.1454,26099839.17,1995,6494
228,MOORSLEDE,10840,50.882235,3.078191,35456439.62,2375,8465
229,ROESELARE,56547,50.938181,3.132783,60443429.9,12550,43997
230,STADEN,11040,50.955091,3.018119,46823328.93,2613,8427
231,DENTERGEM,8223,50.954594,3.405842,26138012.03,1953,6270
232,MEULEBEKE,11031,50.952398,3.294268,29500657.08,2493,8538
233,OOSTROZEBEKE,7502,50.931949,3.336432,16735848.5,1775,5727
234,PITTEM,6586,51.002314,3.264786,34662264.62,1538,5048
235,RUISELEDE,5128,51.056472,3.381532,30536973.58,1177,3951
236,TIELT,19474,51.007851,3.362987,68869286.31,4134,15340
237,WIELSBEKE,9093,50.913593,3.366086,21210358.74,2244,6849
238,WINGENE,13461,51.060862,3.259265,68476219.94,3185,10276
239,ARDOOIE,9086,50.983029,3.202292,34974875.19,1915,7171
240,ALVERINGEM,4963,50.977061,2.676939,80733487.56,1295,3668
241,DE_PANNE,10285,51.080107,2.589108,24281742.46,1928,8357
242,KOKSIJDE,21515,51.110927,2.681446,45092210.99,3379,18136
243,NIEUWPOORT,11062,51.124531,2.766525,31404903.11,1966,9096
244,VEURNE,11748,51.047929,2.663966,97137126.28,2626,9122
245,AALST,78271,50.946054,4.067961,78602683.42,15802,62469
246,DENDERLEEUW,17937,50.887757,4.057332,13878631.27,3877,14060
247,GERAARDSBERGEN,31667,50.780981,3.903274,80043809.95,6806,24861
248,HAALTERT,17528,50.886029,3.992479,30537398.33,3553,13975
249,HERZELE,16999,50.8718,3.891671,47851086.42,3674,13325
250,LEDE,17473,50.967439,3.944812,29918335.4,3650,13823
251,NINOVE,36219,50.827447,4.004038,73101459.28,7792,28427
252,SINT-LIEVENS-HOUTEM,9534,50.932343,3.875067,27038120.7,2035,7499
253,ZOTTEGEM,24660,50.869012,3.804758,57423490.35,4885,19775
254,ERPE-MERE,19201,50.922872,3.951221,34365721.22,3920,15281
255,BERLARE,14452,51.037609,3.978486,38216835.3,3177,11275
256,BUGGENHOUT,13973,51.013217,4.198263,25622415.65,2994,10979
257,DENDERMONDE,43618,51.028877,4.089712,56456904.49,9189,34429
258,HAMME,23547,51.079321,4.139169,40716106.84,5382,18165
259,LAARNE,11851,51.04374,3.883361,32620956.77,2521,9330
260,LEBBEKE,17651,50.993851,4.11816,27367028.89,3836,13815
261,WAASMUNSTER,10312,51.119969,4.074093,32223885.31,2322,7990
262,WETTEREN,23414,50.995795,3.86944,36983355.58,4825,18589
263,WICHELEN,11063,51.000091,3.952656,23210465.36,2393,8670
264,ZELE,20457,51.068673,4.035071,33243578.76,4898,15559
265,ASSENEDE,13637,51.228498,3.714067,87552014.17,2933,10704
266,EEKLO,19825,51.195642,3.561585,30398798.57,4070,15755
267,KAPRIJKE,6171,51.209386,3.626486,33648370.42,1346,4825
268,MALDEGEM,22397,51.199469,3.44963,95584656.26,4876,17521
269,SINT-LAUREINS,6592,51.261338,3.579427,74670361.17,1413,5179
270,ZELZATE,12242,51.200388,3.807764,13860535.44,2521,9721
271,AALTER,19028,51.079573,3.444452,82409664.86,4408,14620
272,DEINZE,28799,50.991717,3.515697,76067197.06,6347,22452
273,DE_PINTE,10251,50.987163,3.668361,17731127.43,2337,7914
274,DESTELBERGEN,17451,51.045534,3.808564,26656956.77,3829,13622
275,EVERGEM,32545,51.144635,3.707291,75198991.74,7278,25267
276,GAVERE,12226,50.930234,3.684784,31650116.66,2718,9508
277,GENT,237250,51.075722,3.724722,157900559.8,49787,187463
278,KNESSELARE,7999,51.134032,3.450718,37422708.16,1712,6287
279,LOCHRISTI,20734,51.104381,3.856264,60706677.97,5062,15672
280,LOVENDEGEM,9418,51.102408,3.624904,19543369.63,1982,7436
281,MELLE,10710,50.998258,3.7956,15337035.36,2375,8335
282,MERELBEKE,22705,50.975675,3.739976,36962792.49,5206,17499
283,MOERBEKE,5942,51.18355,3.944281,37908798.18,1323,4619
284,NAZARETH,11080,50.958353,3.609134,35434763.12,2556,8524
285,NEVELE,11431,51.059219,3.552984,52012806.83,2698,8733
286,OOSTERZELE,13241,50.940154,3.796383,43558825.73,3147,10094
287,SINT-MARTENS-LATEM,8251,51.010915,3.621425,14448182.12,1797,6454
288,WAARSCHOOT,7776,51.153459,3.608866,21933812.76,1657,6119
289,WACHTEBEKE,7026,51.18167,3.872474,34600877.07,1607,5419
290,ZOMERGEM,8033,51.127395,3.55544,39329889.4,1679,6354
291,ZULTE,14713,50.93866,3.471872,32767597.36,3397,11316
292,KRUISHOUTEM,8148,50.909255,3.528672,47274600.91,1918,6230
293,OUDENAARDE,29050,50.854818,3.620214,68883634.87,6149,22901
294,RONSE,24639,50.751047,3.606785,34692902.55,6209,18430
295,ZINGEM,6953,50.909689,3.62143,24309043.83,1591,5362
296,BRAKEL,13881,50.79926,3.757211,57044162.41,2844,11037
297,KLUISBERGEN,6382,50.781025,3.529165,30704259.27,1484,4898
298,WORTEGEM-PETEGEM,6135,50.849663,3.526845,42502537.33,1446,4689
299,HOREBEKE,2073,50.833429,3.693746,11229881.65,471,1602
300,LIERDE,6475,50.80687,3.835779,26378374.67,1430,5045
301,MAARKEDAL,6446,50.796517,3.640266,46144620.49,1468,4978
302,ZWALM,7919,50.878552,3.723154,33892165.94,1792,6127
303,BEVEREN,45887,51.252913,4.233987,153133305.5,10297,35590
304,KRUIBEKE,15489,51.159197,4.290992,33440972.31,3553,11936
305,LOKEREN,38489,51.114622,3.96059,68270312.93,9247,29242
306,SINT-GILLIS-WAAS,18387,51.23083,4.118089,55538222.62,4471,13916
307,SINT-NIKLAAS,70450,51.16605,4.107713,84214786.02,15572,54878
308,STEKENE,17096,51.213628,4.027913,45217985.36,3836,13260
309,TEMSE,27285,51.134426,4.204983,40164321.24,6603,20682
310,ATH,27586,50.640704,3.77212,127867379.9,6619,20967
311,BELOEIL,13538,50.533822,3.68797,62322482.27,3150,10388
312,BERNISSART,11612,50.480815,3.685774,43725916,2869,8743
313,BRUGELETTE,3446,50.603393,3.866437,28561689.8,850,2596
314,CHIEVRES,6408,50.572525,3.783108,47409967.82,1583,4825
315,ELLEZELLES,5784,50.721952,3.698243,45118455.3,1359,4425
316,FLOBECQ,3287,50.754876,3.730812,23282484.12,773,2514
317,FRASNES-LEZ-ANVAING,11064,50.683732,3.59991,112824216.7,2603,8461
318,CHAPELLE-LEZ-HERLAIMONT,14164,50.463832,4.286753,18195061.73,3454,10710
319,CHARLEROI,201593,50.422394,4.433838,102969977.9,48014,153579
320,CHATELET,35755,50.398469,4.52156,27247560.79,8578,27177
321,COURCELLES,30034,50.473837,4.340255,44580183.68,7565,22469
322,FARCIENNES,10998,50.435736,4.546074,10364756.09,2902,8096
323,FLEURUS,22267,50.4877,4.538495,59398969.15,5355,16912
324,FONTAINE-L'EVEQUE,16797,50.408676,4.321042,28670287.52,3966,12831
325,GERPINNES,12033,50.348822,4.527105,47787283.46,2644,9389
326,MANAGE,22460,50.494802,4.23747,19811913.32,5593,16867
327,MONTIGNY-LE-TILLEUL,10169,50.377649,4.370537,15226275.72,2116,8053
328,PONT-A-CELLES,16467,50.515201,4.380527,55969186.93,4180,12287
329,SENEFFE,10729,50.54926,4.26222,63510557.79,2831,7898
330,AISEAU-PRESLES,10744,50.406209,4.575922,22345810.78,2633,8111
331,LES_BONS_VILLERS,8994,50.529228,4.447455,43251952.93,2296,6698
332,BOUSSU,20192,50.428463,3.798742,20077047.98,5023,15169
333,DOUR,16899,50.38871,3.786284,33654293.46,4150,12749
334,FRAMERIES,20727,50.391308,3.885533,26120488.57,4913,15814
335,HENSIES,6726,50.437155,3.712898,26370663.22,1633,5093
336,JURBISE,9746,50.52657,3.900501,58045144.31,2502,7244
337,LENS,4119,50.571764,3.910633,49942579.26,1074,3045
338,MONS,91152,50.453807,3.971155,147775707.9,21002,70150
339,QUAREGNON,18789,50.439156,3.85786,11183665.87,4603,14186
340,QUIEVRAIN,6569,50.397216,3.701638,21458843.36,1507,5062
341,SAINT-GHISLAIN,22708,50.488591,3.800162,70490304.04,5174,17534
342,COLFONTAINE,20044,50.407295,3.843421,13776498.07,5273,14771
343,HONNELLES,5026,50.352854,3.723953,44349657.74,1181,3845
344,QUEVY,7734,50.367939,3.95365,65338829.41,1793,5941
345,MOUSCRON,53760,50.737732,3.250272,40683622.63,13294,40466
346,COMINES-WARNETON,17651,50.752924,2.929577,61389197.77,4271,13380
347,BRAINE-LE-COMTE,20698,50.617534,4.141661,84923933.76,5291,15407
348,ENGHIEN,12481,50.67898,4.029288,39310113.25,3059,9422
349,LA_LOUVIERE,77616,50.474833,4.155775,64253143.77,18602,59014
350,LESSINES,18146,50.713856,3.832303,72686358.17,4445,13701
351,LE_ROEULX,8019,50.508652,4.105466,43315408.09,1949,6070
352,SILLY,8013,50.650045,3.958226,68581365.59,2072,5941
353,SOIGNIES,25871,50.567479,4.037588,111322765.2,6339,19532
354,ECAUSSINNES,10373,50.563997,4.178683,34951186.18,2687,7686
355,ANDERLUES,11613,50.40497,4.264864,17204590.36,2658,8955
356,BEAUMONT,6815,50.230594,4.258475,93629951.73,1735,5080
357,BINCHE,32675,50.410031,4.176411,61331344.9,7437,25238
358,CHIMAY,9944,50.042238,4.323469,198696386.3,2572,7372
359,ERQUELINNES,9607,50.305269,4.137787,44638691.82,2407,7200
360,FROIDCHAPELLE,3599,50.166405,4.346763,86493467.45,826,2773
361,LOBBES,5585,50.357135,4.241171,32227036.13,1307,4278
362,MERBES-LE-CHATEAU,4119,50.322307,4.193821,30681539.03,1088,3031
363,MOMIGNIES,5156,50.003929,4.216687,86083598.71,1352,3804
364,THUIN,14675,50.32556,4.310142,76628867.21,3329,11346
365,ESTINNES,7502,50.380113,4.09979,73190784.69,1842,5660
366,HAM-SUR-HEURE-NALINNES,13372,50.32875,4.413122,45670008.54,2996,10376
367,MORLANWELZ,18813,50.448783,4.242794,20360218.8,4527,14286
368,SIVRY-RANCE,4703,50.161343,4.209801,73452331.53,1199,3504
369,ANTOING,7567,50.557526,3.464881,31335952.91,1810,5757
370,CELLES,5452,50.705071,3.448286,67472272.66,1345,4107
371,ESTAIMPUIS,9872,50.689011,3.28769,32081143.74,2411,7461
372,PECQ,5340,50.686473,3.356077,33177318.57,1355,3985
373,PERUWELZ,16941,50.530792,3.563145,61162410.5,4254,12687
374,RUMES,5066,50.545823,3.319043,23995681.78,1140,3926
375,TOURNAI,68193,50.617554,3.407179,215360397.9,15333,52860
376,BRUNEHAUT,7740,50.528479,3.394331,46540877.87,1934,5806
377,LEUZE-EN-HAINAUT,13331,50.598616,3.628012,74464275.86,3093,10238
378,MONT-DE-L'ENCLUS,3429,50.739435,3.503809,27140823.08,855,2574
379,AMAY,13280,50.554314,5.310782,27662916.1,3263,10017
380,BURDINNE,2895,50.583993,5.098676,32623552,751,2144
381,CLAVIER,4266,50.414323,5.335105,79626978.83,1104,3162
382,FERRIERES,4533,50.408576,5.619989,57082757.1,1109,3424
383,HAMOIR,3620,50.438736,5.554261,27710015.76,879,2741
384,HERON,4656,50.541856,5.104514,38336207.95,1248,3408
385,HUY,20295,50.510075,5.222618,47696055.39,4606,15689
386,MARCHIN,5160,50.468779,5.238774,30127687.42,1310,3850
387,MODAVE,3753,50.47485,5.300223,40230565.78,981,2772
388,NANDRIN,5688,50.518529,5.400056,36013196.84,1399,4289
389,OUFFET,2613,50.446111,5.465062,40313521.38,630,1983
390,VERLAINE,3690,50.610152,5.301357,24442073.74,998,2692
391,VILLERS-LE-BOUILLET,6175,50.594676,5.241995,32862479.36,1637,4538
392,WANZE,12938,50.551612,5.19703,44183469.95,3234,9704
393,ANTHISNES,4003,50.490765,5.497853,37286173.5,960,3043
394,ENGIS,5769,50.558896,5.387922,27723128.22,1521,4248
395,TINLOT,2436,50.476544,5.379372,37265668.76,696,1740
396,ANS,27550,50.684119,5.505277,23273431.15,6175,21375
397,AWANS,8758,50.694187,5.454396,27186351.37,2082,6676
398,AYWAILLE,11227,50.458917,5.700728,79933401.86,2662,8565
399,BASSENGE,8483,50.766907,5.609235,38227357.22,2013,6470
400,BEYNE-HEUSAY,11857,50.629831,5.660822,7268724.75,2989,8868
401,CHAUDFONTAINE,20940,50.582887,5.632936,25571058.34,4558,16382
402,COMBLAIN-AU-PONT,5401,50.483103,5.579175,22565363.77,1340,4061
403,DALHEM,6647,50.722132,5.758153,36099125.89,1643,5004
404,ESNEUX,13065,50.538992,5.56814,34193194.38,2847,10218
405,FLERON,16161,50.616567,5.683256,13696478.3,3639,12522
406,HERSTAL,37685,50.68278,5.605781,23481925.89,8955,28730
407,JUPRELLE,8619,50.71672,5.545326,35483958.09,1981,6638
408,LIEGE,190102,50.633225,5.589709,68610303.2,39351,150751
409,OUPEYE,23669,50.722489,5.640578,36027220.39,5545,18124
410,SAINT-NICOLAS,22600,50.633584,5.525592,6879472.75,5236,17364
411,SERAING,61657,50.590526,5.515032,35281732.77,14371,47286
412,SOUMAGNE,15747,50.63393,5.730427,27227991.24,3963,11784
413,SPRIMONT,13211,50.520575,5.66561,74467902.13,3406,9805
414,VISE,16903,50.740659,5.686774,27982324.24,4016,12887
415,GRACE-HOLLOGNE,21813,50.639124,5.438485,34273141.93,5186,16627
416,BLEGNY,13004,50.675899,5.708125,26016794.65,3147,9857
417,FLEMALLE,24963,50.598349,5.440472,36571126.68,5789,19174
418,NEUPRE,9685,50.545438,5.487249,31834835.19,2133,7552
419,TROOZ,7731,50.569476,5.706669,24212703.09,1899,5832
420,AMEL,5345,50.346924,6.180551,125819981.3,1366,3979
421,AUBEL,4146,50.701818,5.850447,18858041.74,1078,3068
422,BAELEN,4156,50.584491,6.044019,85873909.16,1123,3033
423,BUELLINGEN,5471,50.397376,6.313066,150752085.3,1409,4062
424,BUETGENBACH,5610,50.465909,6.208493,97123393.9,1448,4162
425,DISON,14527,50.61536,5.873678,13979374.23,4136,10391
426,EUPEN,18408,50.61143,6.124707,95829590.4,4146,14262
427,HERVE,16755,50.650073,5.795408,56811672.81,4233,12522
428,JALHAY,8040,50.532181,5.965661,106797008.3,2117,5923
429,KELMIS,10566,50.718831,6.022713,18044850.58,2317,8249
430,LIERNEUX,3366,50.309212,5.784762,92259287.18,798,2568
431,LIMBOURG,5680,50.612735,5.936276,24620523.8,1512,4168
432,LONTZEN,5267,50.679093,6.011764,28747210.59,1358,3909
433,MALMEDY,11943,50.432829,6.040764,100428334.6,2901,9042
434,OLNE,3782,50.588722,5.730995,15918824.3,914,2868
435,PEPINSTER,9574,50.573608,5.796246,24980221.33,2644,6930
436,RAEREN,10312,50.666188,6.12354,72404096.41,2408,7904
437,SANKT_VITH,9242,50.288235,6.125043,147198748.8,2116,7126
438,SPA,10549,50.473392,5.866246,39825962.21,2315,8234
439,STAVELOT,6705,50.417848,5.957153,85101717.18,1639,5066
440,STOUMONT,2996,50.409626,5.797636,108581213.4,744,2252
441,THEUX,11763,50.511343,5.816815,83493038.85,3084,8679
442,VERVIERS,54519,50.586363,5.866075,33016681.92,14157,40362
443,WAIMES,6816,50.463537,6.123594,97285769.16,1769,5047
444,WELKENRAEDT,9343,50.66489,5.938309,24685896.76,2186,7157
445,TROIS-PONTS,2529,50.357954,5.883476,68769170.27,650,1879
446,BURG-REULAND,3948,50.204894,6.092252,109926079,997,2951
447,PLOMBIERES,9781,50.726977,5.948309,53261972.35,2372,7409
448,THIMISTER-CLERMONT,5430,50.664292,5.868953,28669636.92,1546,3884
449,BERLOZ,2854,50.705127,5.202245,14455102.59,726,2128
450,BRAIVES,5660,50.616783,5.14868,43990459.81,1464,4196
451,CRISNEE,2906,50.711961,5.395882,16946285.47,710,2196
452,DONCEEL,2883,50.650756,5.325081,23440320.77,727,2156
453,FEXHE-LE-HAUT-CLOCHER,3046,50.665147,5.401335,19517553.91,715,2331
454,GEER,2979,50.670991,5.180743,23588617.16,797,2182
455,HANNUT,14724,50.667375,5.072381,86627783.33,3618,11106
456,LINCENT,3040,50.722845,5.026778,14787150.82,775,2265
457,OREYE,3549,50.724419,5.346403,19592481.44,868,2681
458,REMICOURT,5191,50.686901,5.340233,22660623.25,1255,3936
459,SAINT-GEORGES-SUR-MEUSE,6571,50.597981,5.359768,20941140.96,1622,4949
460,WAREMME,14306,50.695202,5.266056,30806352.79,3100,11206
461,WASSEIGES,2582,50.619185,5.023599,24412772.57,709,1873
462,FAIMES,3614,50.64623,5.241971,28412415.86,916,2698
463,AS,7605,51.010011,5.583958,22100205.67,1725,5880
464,BERINGEN,41984,51.06681,5.23527,78594888.24,9902,32082
465,DIEPENBEEK,18001,50.912821,5.416605,41390047.71,3899,14102
466,GENK,64294,50.968574,5.494146,87632214.36,15500,48794
467,GINGELOM,7966,50.738782,5.168684,56390986.43,1702,6264
468,HALEN,8812,50.951427,5.093511,36624965.53,1828,6984
469,HASSELT,71543,50.936772,5.307426,102671916.1,13575,57968
470,HERK-DE-STAD,11958,50.938709,5.176975,43031733.57,2602,9356
471,LEOPOLDSBURG,14636,51.118652,5.249751,22541177.29,3126,11510
472,LUMMEN,14007,50.996684,5.182477,53655202.91,2878,11129
473,NIEUWERKERKEN,6707,50.880928,5.204068,22402874.21,1374,5333
474,OPGLABBEEK,9807,51.041674,5.570493,25165603.72,2356,7451
475,SINT-TRUIDEN,38828,50.811764,5.202172,107113163.6,7463,31365
476,TESSENDERLO,17228,51.056186,5.068782,51678885,3682,13546
477,ZONHOVEN,20306,50.993253,5.375833,39672562.96,4570,15736
478,ZUTENDAAL,6985,50.934168,5.574565,31985527.81,1528,5457
479,HAM,9974,51.101636,5.160155,32708927.78,2143,7831
480,HEUSDEN-ZOLDER,31278,51.021182,5.288743,53733074.77,7358,23920
481,BOCHOLT,12561,51.188332,5.563103,59345284.7,2894,9667
482,BREE,14774,51.143225,5.631688,64943151.13,3148,11626
483,KINROOI,12118,51.154293,5.75938,54856032.18,2797,9321
484,LOMMEL,32424,51.22696,5.301281,102354512.4,7282,25142
485,MAASEIK,24139,51.08919,5.714171,76996860.39,5256,18883
486,NEERPELT,16247,51.23022,5.458617,42869767.33,3615,12632
487,OVERPELT,13719,51.201629,5.392621,40835750.74,3032,10687
488,PEER,15996,51.129792,5.460783,87270265.09,3668,12328
489,HAMONT-ACHEL,13898,51.261492,5.506486,43770953.32,3085,10813
490,HECHTEL-EKSEL,11612,51.139811,5.345642,76684503.9,2689,8923
491,HOUTHALEN-HELCHTEREN,29993,51.046837,5.407753,77856775.06,7216,22777
492,MEEUWEN-GRUITRODE,12664,51.085772,5.55141,91207093.77,2913,9751
493,DILSEN-STOKKEM,19296,51.037406,5.711432,66023304.42,4341,14955
494,ALKEN,11153,50.879734,5.289763,28232283.15,2525,8628
495,BILZEN,30384,50.873502,5.532843,76084089.33,6661,23723
496,BORGLOON,10339,50.806116,5.340071,51371739.69,2006,8333
497,HEERS,6898,50.755029,5.310995,53092230.83,1367,5531
498,HERSTAPPE,84,50.727304,5.424475,1349631.27,12,72
499,HOESELT,9412,50.846453,5.471657,30114054.83,2011,7401
500,KORTESSEM,8151,50.854397,5.405123,34013908.26,1773,6378
501,LANAKEN,24935,50.900796,5.643598,58829580.88,5054,19881
502,RIEMST,16145,50.806718,5.591438,58076833.84,3267,12878
503,TONGEREN,29859,50.773118,5.463535,87836913.72,5971,23888
504,WELLEN,7102,50.843983,5.322592,26807003.81,1427,5675
505,MAASMECHELEN,36661,50.970227,5.677008,77007197.45,8335,28326
506,VOEREN,4207,50.746664,5.821924,50627366.51,962,3245
507,ARLON,26929,49.676583,5.793179,118951729,6614,20315
508,ATTERT,4944,49.746877,5.756712,71116733.57,1569,3375
509,AUBANGE,15333,49.576269,5.77631,46166891.19,3846,11487
510,MARTELANGE,1566,49.812519,5.724143,29993725.28,398,1168
511,MESSANCY,7620,49.616187,5.81055,52611825.26,1924,5696
512,BASTOGNE,14577,50.017082,5.760819,173065274.1,4031,10546
513,BERTOGNE,3048,50.064581,5.645499,91806903.43,881,2167
514,FAUVILLERS,2116,49.878363,5.695884,74915361.38,609,1507
515,HOUFFALIZE,4819,50.145738,5.770187,167193271.2,1196,3623
516,VIELSALM,7405,50.279503,5.892481,140809460.1,1854,5551
517,VAUX-SUR-SURE,4876,49.935698,5.605801,135697414.9,1464,3412
518,GOUVY,4826,50.193939,5.910657,165474735.4,1337,3489
519,SAINTE-ODE,2345,50.026354,5.527136,98004453.76,608,1737
520,DURBUY,10780,50.362073,5.487527,157025674.1,2601,8179
521,EREZEE,2929,50.297958,5.557074,78905887.38,678,2251
522,HOTTON,5109,50.268828,5.432028,56797576.4,1445,3664
523,LA_ROCHE-EN-ARDENNE,4351,50.167827,5.605085,145847704.6,1057,3294
524,MARCHE-EN-FAMENNE,17134,50.210697,5.342953,122354443.8,4530,12604
525,NASSOGNE,5093,50.138025,5.358095,112886486.6,1394,3699
526,RENDEUX,2358,50.220153,5.517008,71907036.52,599,1759
527,TENNEVILLE,2610,50.101112,5.489394,91989040.69,651,1959
528,MANHAY,3229,50.290375,5.661914,120204685.8,853,2376
529,BERTRIX,8211,49.8554,5.245587,138489539.2,2082,6129
530,BOUILLON,5501,49.807364,5.082514,148731633.9,1225,4276
531,DAVERDISSE,1366,50.005602,5.065717,56868800.17,317,1049
532,HERBEUMONT,1559,49.796697,5.30869,58441610.56,392,1167
533,LEGLISE,4341,49.811251,5.565983,173910718.3,1267,3074
534,LIBIN,4707,49.979489,5.237425,140671846.8,1228,3479
535,NEUFCHATEAU,6700,49.852464,5.432711,114512258.9,1830,4870
536,PALISEUL,5089,49.909102,5.136203,111117394.1,1298,3791
537,SAINT-HUBERT,5811,50.039346,5.34492,111987196,1452,4359
538,TELLIN,2399,50.076759,5.224868,56957998.71,620,1779
539,WELLIN,2990,50.061479,5.097814,67778086.37,779,2211
540,LIBRAMONT-CHEVIGNY,10052,49.947557,5.421617,179002791.3,2691,7361
541,CHINY,5122,49.721588,5.390808,114132751.8,1366,3756
542,ETALLE,5469,49.665342,5.608289,79364178.55,1684,3785
543,FLORENVILLE,5446,49.709043,5.274736,148297971.6,1216,4230
544,MEIX-DEVANT-VIRTON,2724,49.605001,5.469248,55127951.51,688,2036
545,MUSSON,4296,49.570859,5.680346,35444267.44,1205,3091
546,SAINT-LEGER,3200,49.619686,5.675729,36180967.62,855,2345
547,TINTIGNY,3778,49.687172,5.483826,81704372.78,1059,2719
548,VIRTON,11233,49.572633,5.571593,95816697.03,2939,8294
549,HABAY,8026,49.736387,5.616415,103304793.6,2338,5688
550,ROUVROY,2067,49.536781,5.483114,28085318.85,590,1477
551,ANHEE,7014,50.320132,4.809285,66025193.13,1740,5274
552,BEAURAING,8540,50.094411,4.951807,174573938.3,2157,6383
553,BIEVRE,3162,49.923354,5.018912,109646652,751,2411
554,CINEY,15317,50.270863,5.121739,147975221.1,3703,11614
555,DINANT,13186,50.250761,4.942342,99809193.71,3232,9954
556,GEDINNE,4458,49.985752,4.901995,151601389,1069,3389
557,HAMOIS,6752,50.338381,5.138865,76593250.51,1895,4857
558,HAVELANGE,4981,50.362529,5.247322,104785420.7,1374,3607
559,HOUYET,4494,50.187349,5.002135,123114105.6,1095,3399
560,ONHAYE,3139,50.261658,4.811432,65603155.12,819,2320
561,ROCHEFORT,12097,50.158319,5.168525,166440240.1,3097,9000
562,SOMME-LEUZE,4750,50.301065,5.318103,95221154.07,1191,3559
563,YVOIR,8610,50.326601,4.939934,57122757.42,2214,6396
564,HASTIERE,5418,50.196417,4.824998,56739999.44,1083,4335
565,VRESSE-SUR-SEMOIS,2801,49.851586,4.915048,101430592.7,627,2174
566,ANDENNE,24815,50.488126,5.057123,86154711.86,6384,18431
567,ASSESSE,6299,50.376787,4.992153,78574761.34,1700,4599
568,EGHEZEE,14742,50.587989,4.893206,103148428.5,3885,10857
569,FLOREFFE,7567,50.436271,4.754995,39177135.34,1942,5625
570,FOSSES-LA-VILLE,9476,50.394566,4.680183,63267315.88,2505,6971
571,GESVES,6565,50.423806,5.052612,64961342.01,1860,4705
572,METTET,12233,50.324543,4.670491,116842198.3,3195,9038
573,NAMUR,107939,50.461788,4.871817,176030694.1,23771,84168
574,OHEY,4457,50.437126,5.165575,56736343.2,1235,3222
575,PROFONDEVILLE,11501,50.376524,4.827787,50338218.71,3047,8454
576,SOMBREFFE,7801,50.527996,4.601841,35879869.45,2114,5687
577,SAMBREVILLE,27170,50.447791,4.619932,34405570.25,6530,20640
578,FERNELMONT,6860,50.555337,4.986448,65778447.87,1878,4982
579,JEMEPPE-SUR-SAMBRE,18162,50.473112,4.675415,46949445.15,4793,13369
580,LA_BRUYERE,8477,50.531083,4.809009,53195407.01,2333,6144
581,GEMBLOUX,22430,50.555663,4.70834,96395339.56,5427,17003
582,CERFONTAINE_,4624,50.180878,4.436059,83373872.79,1227,3397
583,COUVIN,13576,50.039244,4.480186,207127452.4,3274,10302
584,DOISCHE,2914,50.145573,4.698198,84050683.14,738,2176
585,FLORENNES,10882,50.255122,4.630496,134270256.4,2648,8234
586,PHILIPPEVILLE,8627,50.170582,4.587125,157199178.2,2022,6605
587,WALCOURT,17805,50.267923,4.434166,123765227.1,4325,13480
588,VIROINVAL,5739,50.055185,4.624551,121223456.7,1307,4432
