"Source"	"Target"	"Weight"	"X18LESS"	"X19PLUS"	"Distance"
0	1	2299	401	1898	13.7109941009
0	2	11	0	11	10.0969643239
0	3	159	16	143	4.31530782325
0	4	6	0	6	9.8853339418
0	5	12	1	11	21.4072324909
0	6	2	0	2	28.4252474935
0	7	161	151	10	4.43787942021
0	8	1	0	1	35.7949725683
0	9	64	38	26	3.23291409118
0	10	10	1	9	7.16947841321
0	11	3	0	3	30.2867426481
0	12	2	1	1	22.8682433299
0	13	133	86	47	4.43382994139
0	14	7	2	5	8.07823605328
0	15	115	12	103	7.24957968511
0	16	46	1	45	4.26392419192
0	17	10	0	10	16.0231291121
0	18	122	3	119	5.01943798639
0	19	65	16	49	2.95021012179
0	20	4	0	4	19.5882178612
0	21	14	2	12	17.1333892831
0	22	2	0	2	21.8471070793
0	23	21	8	13	14.3482677784
0	24	25	0	25	12.6449022615
0	25	3	0	3	32.8687288532
0	26	4	1	3	22.5032422971
0	27	1	0	1	24.4265904538
0	28	43	5	38	11.1016501416
0	29	4	0	4	29.220165704
0	30	4	0	4	19.3040446062
0	31	4	0	4	18.0507573306
0	32	33	0	33	10.5589624651
0	33	15	0	15	10.0367744201
0	34	8	0	8	25.5872835672
0	35	20	7	13	13.4472158853
0	36	115	26	89	12.4232373673
0	37	1	0	1	19.7301181315
0	38	2	1	1	19.9008837685
0	39	57	21	36	9.1003936702
0	40	2	0	2	13.8806381766
0	41	11	8	3	13.2386575274
0	42	32	9	23	8.72349344752
0	43	1	0	1	53.9015334562
0	46	7	1	6	36.8079544396
0	48	1	0	1	42.1957250207
0	49	3	0	3	25.4427576213
0	50	12	1	11	31.2644415088
0	51	2	0	2	26.358232068
0	52	2	1	1	36.2074912631
0	53	5	0	5	43.3712285189
0	55	1	0	1	40.9294685373
0	58	0	0	0	43.0907384847
0	59	1	0	1	54.8824191461
0	60	5	0	5	35.2852127838
0	61	1	0	1	48.1372258359
0	62	1	0	1	54.7340418928
0	64	2	0	2	36.5341245186
0	65	9	1	8	44.5962688626
0	66	1	0	1	28.8479848343
0	68	3	0	3	34.9865533821
0	70	16	2	14	34.2719400413
0	71	6	1	5	36.0039692854
0	72	1	0	1	30.3635858576
0	73	137	6	131	28.7999930624
0	74	9	0	9	33.2620191498
0	75	15	0	15	29.2899936173
0	76	12	0	12	35.5824112729
0	78	8	1	7	34.4422584235
0	79	6	1	5	28.1542069743
0	81	10	0	10	31.1040448464
0	82	2	0	2	33.7444622294
0	83	4	0	4	30.9452780124
0	84	19	1	18	30.0377902286
0	85	3	0	3	38.0770998007
0	86	7	0	7	37.8159066473
0	87	15	0	15	31.7773864142
0	88	7	1	6	33.7282543927
0	89	7	0	7	27.5865454038
0	90	3	0	3	42.8060389336
0	92	8	1	7	32.6920383432
0	95	12	3	9	20.8288839333
0	96	5	0	5	46.2472079875
0	99	1	0	1	24.5954679578
0	100	3	1	2	14.3967530852
0	102	21	0	21	15.3952721959
0	103	29	0	29	25.8574387333
0	104	1	0	1	19.5606224837
0	106	3	0	3	23.5443275865
0	110	1	0	1	24.8222754533
0	112	19	0	19	22.7161008783
0	113	53	2	51	29.8816031776
0	118	2	0	2	40.5680100057
0	120	3	1	2	25.2474840845
0	122	1	0	1	38.6130650853
0	124	0	0	0	37.2592141697
0	129	3	1	2	20.9904815572
0	131	1	0	1	50.1363693794
0	134	3	0	3	30.7702601236
0	137	0	0	0	41.3085274454
0	140	1	0	1	29.9151384402
0	142	20	1	19	35.827015902
0	144	1	0	1	40.716993192
0	145	1	0	1	31.0726014557
0	147	1	1	0	52.9289830679
0	151	1	0	1	43.5857586507
0	155	1	0	1	51.0478284229
0	164	1	0	1	44.3836898626
0	166	1	0	1	59.6044938564
0	168	1	0	1	46.8113984968
0	183	2	0	2	82.1803953089
0	188	1	0	1	87.1265821738
0	190	1	0	1	77.8593442937
0	208	1	0	1	86.5751957109
0	213	1	0	1	90.99813896
0	214	1	0	1	80.4877913139
0	220	0	0	0	101.920194257
0	230	1	0	1	97.3951619331
0	242	1	0	1	118.727398478
0	244	1	0	1	120.377974416
0	245	5	2	3	30.248905363
0	251	2	1	1	43.0854598445
0	255	1	0	1	30.1145903958
0	257	4	1	3	23.4748605823
0	261	1	0	1	21.5251599383
0	266	2	0	2	57.6241538304
0	271	1	0	1	65.7282612755
0	273	1	0	1	52.4491448331
0	274	2	0	2	41.213765647
0	275	2	0	2	47.0846259542
0	277	20	2	18	46.3290159766
0	279	1	0	1	36.8269736894
0	281	1	0	1	43.6335120409
0	282	1	0	1	48.1694661738
0	285	1	0	1	58.4723070271
0	291	1	0	1	67.2178478323
0	293	1	0	1	61.6528092878
0	294	0	0	0	68.9700317579
0	297	1	0	1	71.433135317
0	303	24	2	22	16.8301474658
0	304	5	3	2	6.95819909202
0	305	5	0	5	29.4724270578
0	306	1	0	1	21.3474444793
0	307	9	1	8	19.463405469
0	309	11	1	10	12.3361622571
0	324	1	0	1	80.7052823689
0	329	1	0	1	65.4952148565
0	415	1	0	1	92.2992074191
0	433	1	0	1	140.287915271
0	464	2	0	2	60.0748978817
0	466	2	0	2	79.9100270506
0	469	1	0	1	68.3375213732
0	471	2	0	2	60.6180245478
0	475	2	1	1	67.6811457834
0	476	1	0	1	48.754742603
0	484	1	0	1	64.9601976059
0	492	1	0	1	81.8537965035
0	505	2	0	2	92.3640015207
0	573	0	0	0	82.2493548755
0	579	1	1	0	76.2723706137
1	0	1256	205	1051	13.7109941009
1	2	276	124	152	13.9206948186
1	3	332	3	329	17.9709411975
1	4	318	8	310	10.460607417
1	5	1335	248	1087	10.508725712
1	6	255	136	119	19.6435031609
1	7	1366	1008	358	11.6640040832
1	8	110	0	110	22.4787033677
1	9	310	69	241	12.6631538775
1	10	101	16	85	14.0667295918
1	11	195	106	89	17.2008780415
1	12	760	208	552	9.91122132353
1	13	1307	196	1111	15.3557374718
1	14	83	36	47	16.488736603
1	15	1695	215	1480	10.6941834974
1	16	116	0	116	16.6945659365
1	17	366	21	345	16.4144078754
1	18	199	0	199	18.2014723318
1	19	231	12	219	14.9316769453
1	20	326	256	70	14.2339486957
1	21	1701	1333	368	9.18523010039
1	22	360	3	357	8.13761551586
1	23	1464	273	1191	10.1403811442
1	24	1238	166	1072	11.2496302132
1	25	87	30	57	21.9040587481
1	26	103	13	90	21.6016504911
1	27	155	103	52	20.3835760488
1	28	907	581	326	5.0532639727
1	29	210	34	176	23.7847584284
1	30	48	0	48	25.4822292127
1	31	28	2	26	29.36021066
1	32	186	6	180	20.078958828
1	33	211	31	180	20.1398753438
1	34	73	2	71	32.3014923665
1	35	534	60	474	20.4848935619
1	36	1349	74	1275	25.7031502439
1	37	46	6	40	23.090263685
1	38	32	15	17	29.0516856566
1	39	250	32	218	21.6349607742
1	40	3	1	2	24.8715923021
1	41	152	8	144	24.1460954844
1	42	213	5	208	22.3823984187
1	43	33	1	32	50.0524041037
1	44	2	0	2	40.7635808878
1	45	6	1	5	57.1764832948
1	46	228	0	228	31.7321577255
1	47	15	1	14	51.8853586616
1	48	196	0	196	43.4703459642
1	49	126	0	126	26.5768007476
1	50	341	72	269	32.9954638302
1	51	27	17	10	29.6389528579
1	52	8	1	7	42.1862727786
1	53	173	0	173	33.8555041764
1	54	35	8	27	37.1414129247
1	55	37	0	37	39.3542733436
1	56	30	7	23	31.8185021556
1	57	14	1	13	50.6773273947
1	58	36	0	36	36.603433112
1	59	74	15	59	54.0578394145
1	60	110	13	97	36.8746343027
1	61	13	0	13	44.2353738319
1	62	28	0	28	48.4662154638
1	63	5	0	5	48.723700283
1	64	39	2	37	29.3310004883
1	65	314	9	305	40.0138642581
1	66	18	1	17	27.8755991014
1	67	19	0	19	35.7792457034
1	68	87	7	80	38.891157784
1	69	21	0	21	47.9438147728
1	70	208	4	204	47.7634039198
1	71	67	2	65	49.6818467917
1	72	16	3	13	43.817167086
1	73	2294	0	2294	42.5017504359
1	74	158	124	34	46.972996702
1	75	298	8	290	42.994767623
1	76	83	23	60	49.1927525868
1	77	15	1	14	42.6108275221
1	78	319	0	319	48.1460557861
1	79	56	0	56	41.7156986562
1	80	10	0	10	43.7707693849
1	81	159	12	147	44.6734718351
1	82	132	16	116	47.4005998538
1	83	113	2	111	44.6408576983
1	84	376	88	288	43.7471005315
1	85	63	25	38	51.7659188062
1	86	59	12	47	51.514848912
1	87	205	13	192	45.4566104681
1	88	59	4	55	47.3913492836
1	89	83	8	75	40.3084701051
1	90	23	10	13	56.3838672213
1	91	2	0	2	68.0991369354
1	92	84	3	81	45.8056944893
1	93	0	0	0	62.1491678284
1	95	102	17	85	34.5305487174
1	96	28	0	28	59.6269051731
1	97	1	0	1	63.8184779161
1	98	5	0	5	55.2072800236
1	99	13	0	13	37.1907650497
1	100	17	0	17	28.0143193221
1	101	4	0	4	47.5849275198
1	102	123	35	88	28.0918295733
1	103	406	139	267	39.4800892153
1	104	23	0	23	32.9799221885
1	105	3	0	3	34.9960265931
1	106	3	0	3	35.3256880056
1	107	19	3	16	54.9059294203
1	109	18	1	17	52.8330788232
1	110	54	0	54	38.1144194325
1	111	28	2	26	45.6675113053
1	112	368	28	340	36.3528655087
1	113	721	138	583	43.3665386917
1	114	27	0	27	31.2393911516
1	115	4	0	4	50.3977787561
1	116	8	0	8	51.549864502
1	117	5	1	4	46.0364405723
1	118	5	1	4	54.2361140056
1	119	5	0	5	56.7914021841
1	120	40	0	40	38.7199023264
1	122	2	0	2	51.3647027941
1	123	1	0	1	43.11018708
1	124	28	11	17	45.1026585436
1	126	1	0	1	55.0826547315
1	127	4	2	2	47.5113049931
1	128	8	3	5	54.5828056731
1	129	30	3	27	33.1724699547
1	130	2	0	2	56.9284143646
1	131	18	2	16	55.938973043
1	132	1	0	1	66.4270438758
1	133	13	5	8	37.2580131914
1	134	8	0	8	42.6882373283
1	136	4	0	4	46.8024316574
1	137	2	0	2	54.3037735262
1	138	6	0	6	33.8681502559
1	139	1	0	1	60.4878924396
1	140	42	3	39	42.7814894866
1	141	0	0	0	73.435894031
1	142	417	15	402	47.4190299724
1	143	4	0	4	52.1291804605
1	144	5	0	5	53.0248883478
1	145	6	0	6	41.1793602076
1	146	10	1	9	49.3058214211
1	147	10	1	9	63.1704569861
1	148	7	0	7	37.4975177802
1	151	6	0	6	50.2190584721
1	152	1	0	1	51.753173889
1	154	6	2	4	59.7847534014
1	155	6	0	6	64.7355405886
1	156	2	0	2	64.3387421715
1	160	1	0	1	60.4157941335
1	164	15	1	14	58.0384421525
1	166	6	1	5	73.2733223941
1	167	1	0	1	74.8759581904
1	168	6	0	6	60.3319146519
1	169	5	0	5	64.187550081
1	171	17	5	12	60.6889734646
1	172	10	1	9	61.8624791179
1	173	1	0	1	76.0335976936
1	175	3	0	3	63.9835698777
1	176	1	0	1	75.0835101526
1	177	14	1	13	66.3518564034
1	181	2	0	2	73.4335677239
1	182	2	0	2	86.2046121644
1	183	53	3	50	80.8334819204
1	186	3	0	3	81.3600029226
1	187	4	0	4	91.9344824496
1	188	1	0	1	87.8036988003
1	190	13	0	13	74.65339677
1	191	3	0	3	108.731311042
1	192	1	0	1	108.147070459
1	193	1	0	1	100.276962634
1	194	3	1	2	99.3333669145
1	196	6	0	6	114.636671619
1	198	1	0	1	125.723461423
1	199	1	0	1	104.79509787
1	203	0	0	0	120.415606931
1	204	1	0	1	79.973685449
1	206	1	0	1	84.2760568372
1	207	5	0	5	86.5282376517
1	208	17	0	17	92.8426775226
1	209	3	0	3	88.894717713
1	210	1	0	1	89.9430221355
1	211	1	0	1	99.8220404933
1	212	6	0	6	79.8451752535
1	213	3	0	3	96.4484053653
1	214	6	0	6	87.4722680698
1	216	2	0	2	97.4623637114
1	217	1	0	1	100.594474562
1	218	1	0	1	95.2018548639
1	219	1	0	1	107.6947868
1	220	9	0	9	101.173399168
1	222	5	0	5	92.5476835038
1	225	6	0	6	89.8808568514
1	227	3	0	3	89.5411726549
1	229	7	0	7	93.7998926812
1	231	2	0	2	75.6383653241
1	232	0	0	0	82.7941421911
1	234	1	0	1	82.5778877559
1	236	4	0	4	75.943233955
1	237	2	0	2	80.2289269705
1	239	3	1	2	87.4283527408
1	240	1	0	1	122.655275228
1	241	2	0	2	126.180342499
1	242	6	0	6	119.2708636
1	243	1	0	1	113.174646312
1	244	3	0	3	121.698090161
1	245	37	13	24	40.6930121022
1	246	6	1	5	46.6784447655
1	247	3	0	3	62.3906270108
1	248	2	0	2	49.1665724966
1	249	1	0	1	54.5737897078
1	250	1	0	1	44.0614814176
1	251	4	0	4	54.3592115676
1	252	1	0	1	50.2572734292
1	253	3	0	3	58.767166523
1	254	4	1	3	47.5266382998
1	255	2	0	2	36.9210959648
1	256	16	4	12	29.7732047242
1	257	40	12	28	32.2615970095
1	258	13	0	13	25.7252088649
1	259	3	0	3	41.7474389088
1	260	11	0	11	34.3220268714
1	261	8	1	7	25.9697233442
1	262	13	0	13	45.7460252853
1	263	1	0	1	41.0824790645
1	264	45	1	44	31.6683878924
1	265	1	0	1	46.2196879791
1	266	5	0	5	57.154493139
1	267	1	0	1	52.4860061874
1	268	6	0	6	64.8589800969
1	270	17	1	16	40.0907345376
1	271	2	0	2	67.9061728693
1	272	7	0	7	66.9097182703
1	273	1	0	1	57.7942549642
1	274	6	1	5	46.0393389233
1	275	6	2	4	48.2594818731
1	276	3	0	3	60.4189343861
1	277	513	0	513	49.6957274126
1	279	7	3	4	40.0133800829
1	280	3	0	3	55.1257135521
1	281	8	0	8	49.6806157881
1	282	17	7	10	54.3102585687
1	283	5	0	5	31.1725428399
1	284	11	3	8	63.0082674547
1	285	4	0	4	61.4839400147
1	287	11	0	11	59.3474702181
1	289	2	0	2	36.0747019171
1	291	2	0	2	72.3937323491
1	293	5	0	5	69.2117550575
1	294	3	1	2	77.8548650487
1	297	3	0	3	79.4360612807
1	298	1	0	1	74.6658069491
1	303	775	148	627	9.91685778428
1	304	144	43	101	12.3446352587
1	305	91	2	89	32.9999810672
1	306	25	9	16	18.2059767796
1	307	360	5	355	21.2472831524
1	308	38	0	38	24.7282106171
1	309	163	2	161	18.0797431549
1	310	0	0	0	80.5202043721
1	319	14	1	13	92.8602485924
1	323	1	0	1	86.2626183746
1	324	1	0	1	94.3781514458
1	326	3	0	3	85.2771322122
1	329	4	1	3	79.0672344023
1	332	1	0	1	100.63542735
1	333	1	0	1	105.046166747
1	338	9	0	9	93.7014356964
1	345	0	0	0	97.6856514344
1	349	1	0	1	88.3074192608
1	372	1	0	1	95.5287457429
1	375	2	0	2	98.3086681387
1	382	1	0	1	128.556049221
1	385	0	0	0	102.07317253
1	392	0	0	0	97.263493061
1	406	2	0	2	107.178798803
1	408	9	0	9	109.709395067
1	411	0	0	0	108.905327547
1	415	1	0	1	101.266657889
1	418	1	0	1	111.027352003
1	426	2	0	2	142.009355115
1	442	2	0	2	128.318578421
1	457	1	0	1	90.081702938
1	462	1	0	1	91.0283532552
1	464	20	3	17	63.5198121341
1	465	6	0	6	82.1215929828
1	466	31	3	28	84.367925493
1	467	1	0	1	79.9498037668
1	468	2	0	2	60.4982078665
1	469	65	1	64	74.1248847593
1	470	4	0	4	66.1575398777
1	471	39	2	37	62.7904750078
1	472	9	0	9	63.2594581029
1	475	15	0	15	76.0482225836
1	476	30	0	30	53.1959638887
1	477	2	0	2	75.6679991598
1	479	4	0	4	57.3035209059
1	480	13	0	13	68.8440522304
1	481	3	0	3	83.019999495
1	482	2	0	2	88.3957796637
1	483	2	0	2	97.0493732773
1	484	16	1	15	64.4910979444
1	485	2	0	2	95.1340897194
1	486	3	1	2	75.4170707551
1	487	6	0	6	71.0494858455
1	488	17	3	14	76.8953980902
1	489	2	0	2	78.668936676
1	490	3	0	3	68.7949185429
1	491	15	0	15	75.6447139817
1	493	4	1	3	96.2917614689
1	494	2	0	2	76.3673173963
1	495	2	0	2	91.3755507532
1	499	1	0	1	89.1351830786
1	501	3	0	3	96.9899820063
1	503	4	0	4	93.1560479077
1	505	6	1	5	96.240655927
1	512	1	0	1	168.941266908
1	522	1	0	1	132.603888837
1	523	1	0	1	148.831437836
1	548	1	0	1	205.553688246
1	551	0	0	0	108.505049734
1	568	1	0	1	82.7149994482
1	569	0	0	0	95.0256257222
1	573	7	0	7	94.9897524127
1	579	2	0	2	89.6249716301
1	581	0	0	0	81.352912353
1	586	0	0	0	121.690257644
2	0	37	19	18	10.0969643239
2	1	1466	250	1216	13.9206948186
2	3	15	3	12	12.8552755174
2	4	35	16	19	3.51813381172
2	5	19	1	18	16.0499685132
2	6	9	2	7	20.4669900057
2	7	109	51	58	5.94862040779
2	8	1	1	0	31.7639192005
2	9	9	3	6	12.5675674015
2	10	53	13	40	3.1662104108
2	12	10	0	10	19.3909551663
2	13	140	45	95	6.86465957232
2	14	17	5	12	4.41977594775
2	15	301	16	285	4.01859735966
2	16	3	0	3	14.2130482126
2	17	50	15	35	5.96838022873
2	18	17	1	16	10.4180338811
2	19	4	2	2	13.0465122613
2	20	10	4	6	11.0340046275
2	21	30	4	26	10.981921884
2	22	4	0	4	20.5499553942
2	23	40	1	39	7.10925703178
2	24	78	44	34	4.57252108376
2	25	1	0	1	26.0608806035
2	26	10	0	10	12.4112714899
2	27	5	0	5	14.7722938931
2	28	19	5	14	14.9908905137
2	29	5	1	4	19.7213804827
2	30	12	5	7	11.6998953088
2	31	1	0	1	16.5491923164
2	32	4	0	4	20.6555828432
2	33	36	4	32	7.77834880438
2	34	8	4	4	18.5384785116
2	35	190	61	129	6.59916629558
2	36	66	0	66	15.9339735878
2	37	9	0	9	10.3710428422
2	38	1	0	1	15.2682736334
2	39	13	0	13	18.4599271246
2	41	20	2	18	11.5706437569
2	42	9	3	6	16.1756253017
2	43	1	0	1	43.8230465612
2	46	11	1	10	27.0008165862
2	47	1	0	1	43.0125414979
2	48	9	0	9	32.6353587175
2	49	8	1	7	15.5816435655
2	50	9	0	9	21.681890393
2	52	3	1	2	28.7581080268
2	53	1	0	1	35.0558558724
2	54	2	0	2	23.5967921455
2	55	1	0	1	30.8659692638
2	57	1	0	1	39.1171283615
2	59	4	0	4	44.9613967734
2	60	4	0	4	25.7287825293
2	64	1	0	1	27.3542426512
2	65	15	4	11	34.6187153723
2	66	1	1	0	18.7648741795
2	67	1	0	1	29.9811133752
2	69	1	0	1	35.4219936626
2	70	8	1	7	40.5953074287
2	71	1	0	1	39.9281347624
2	72	1	0	1	36.9347574217
2	73	82	27	55	34.0216648383
2	74	2	0	2	37.9833702158
2	75	14	0	14	33.8361323546
2	76	3	0	3	41.3625795891
2	78	8	1	7	39.4279408518
2	81	2	0	2	37.2215316742
2	82	5	0	5	39.2890077668
2	83	4	0	4	36.1882216089
2	84	8	2	6	35.0084268896
2	85	1	0	1	43.1978390129
2	86	2	0	2	41.9742371759
2	87	5	0	5	35.8454999635
2	88	2	0	2	37.5724811123
2	89	2	1	1	35.6452740312
2	92	4	0	4	39.9944569772
2	95	2	1	1	26.4656066523
2	96	1	0	1	52.6511412117
2	102	2	0	2	24.0748375015
2	103	12	0	12	29.6909327978
2	104	1	0	1	26.7457470979
2	107	1	0	1	43.8778064267
2	110	2	0	2	27.2268639589
2	111	2	0	2	41.4733647891
2	112	7	0	7	26.8209251372
2	113	28	0	28	32.8052347613
2	114	1	0	1	21.1764624232
2	116	1	0	1	43.8634709678
2	118	1	0	1	45.8390814049
2	120	1	0	1	31.9622372261
2	124	2	0	2	31.2508038299
2	127	1	0	1	35.294190599
2	131	1	0	1	42.691606973
2	133	0	0	0	24.0503893998
2	134	2	0	2	29.778062631
2	138	0	0	0	20.2677582344
2	140	1	0	1	30.8933751208
2	142	15	0	15	34.1911615828
2	145	1	0	1	27.4268493771
2	146	1	0	1	38.2711791893
2	148	1	0	1	23.6226028165
2	166	1	0	1	64.5688225979
2	168	1	0	1	49.4825507528
2	183	2	0	2	91.0051407842
2	186	1	0	1	89.9210285447
2	220	0	0	0	110.989095778
2	227	1	0	1	96.9598286163
2	242	0	0	0	128.183996543
2	245	1	0	1	39.8164142282
2	257	1	0	1	33.5092138459
2	266	1	0	1	66.6258333597
2	270	2	0	2	49.5219069689
2	275	1	0	1	56.4763880186
2	277	14	0	14	56.1718385291
2	281	1	0	1	53.7255259862
2	303	17	0	17	21.8545389494
2	304	4	2	2	15.722109342
2	305	3	0	3	39.1985796112
2	307	6	1	5	28.480435101
2	309	1	0	1	22.0036390634
2	350	1	0	1	69.5482759627
2	464	1	0	1	51.4395071605
2	465	1	0	1	69.0378426285
2	466	1	0	1	71.8397124231
2	469	3	0	3	60.9718200651
2	470	0	0	0	52.7283074922
2	471	1	0	1	51.4818985082
2	472	1	0	1	50.2728653035
2	475	2	0	2	62.200894999
2	476	1	0	1	40.5180169592
2	479	1	0	1	45.5403576314
2	484	0	0	0	55.1367571333
2	491	1	0	1	63.6924857358
2	496	1	0	1	70.2866922729
2	503	0	0	0	79.5219238419
2	573	0	0	0	82.3285595931
3	0	293	27	266	4.31530782325
3	1	1235	517	718	17.9709411975
3	2	9	0	9	12.8552755174
3	4	8	0	8	13.5179500935
3	5	11	2	9	25.621973309
3	6	2	0	2	32.3003133297
3	7	63	4	59	8.13276914197
3	8	1	0	1	40.1102152406
3	9	74	1	73	6.02118303822
3	10	8	5	3	9.69143520027
3	11	1	0	1	34.5986891517
3	12	10	0	10	27.181833617
3	13	127	56	71	6.03107910822
3	14	5	2	3	9.52950784269
3	15	77	14	63	10.9114163216
3	16	87	52	35	3.01382095208
3	17	6	1	5	18.7824341647
3	18	258	102	156	3.36687531295
3	19	85	22	63	3.84690508058
3	20	6	0	6	23.215812633
3	21	15	0	15	21.2016574376
3	22	3	0	3	26.1074765208
3	23	12	1	11	18.1598569673
3	24	17	1	16	16.1973811711
3	25	0	0	0	36.9876931068
3	26	4	0	4	25.0695044253
3	28	19	8	11	14.9742363744
3	29	2	0	2	32.5089078082
3	30	3	1	2	19.8452972821
3	31	4	0	4	16.0294094235
3	32	54	11	43	9.08191699809
3	33	29	15	14	9.87532957763
3	34	4	0	4	25.4932003456
3	35	21	6	15	14.308522095
3	36	137	17	120	9.02433374015
3	37	0	0	0	21.2735428425
3	38	3	0	3	19.0216664208
3	39	151	1	150	5.62207998676
3	40	4	0	4	10.9809363479
3	41	14	1	13	11.9371597998
3	42	130	126	4	4.41642940358
3	43	1	0	1	56.4267417176
3	46	5	0	5	39.8555550392
3	48	2	0	2	43.4727720687
3	49	4	0	4	27.3003600974
3	50	6	0	6	32.694820231
3	52	1	0	1	36.0211272491
3	55	1	0	1	43.0478267679
3	58	1	0	1	46.3478584373
3	60	11	0	11	36.6311639793
3	65	5	0	5	47.409379352
3	67	13	0	13	42.7654999837
3	68	2	0	2	35.5874953664
3	70	7	0	7	29.9585824585
3	71	4	1	3	31.8599448786
3	72	1	0	1	26.0545302167
3	73	74	6	68	24.533723743
3	74	5	0	5	29.0284377091
3	75	14	0	14	25.0966800272
3	76	6	0	6	31.2712541719
3	78	19	1	18	30.1790145854
3	79	2	0	2	23.8389326083
3	80	1	0	1	25.8715275634
3	81	7	0	7	26.7890521428
3	82	5	0	5	29.4440733927
3	83	4	2	2	26.6702103208
3	84	17	2	15	25.7907255172
3	85	3	0	3	33.795305146
3	86	1	0	1	33.6316649545
3	87	8	0	8	27.6361474596
3	88	3	1	2	29.6090363064
3	89	4	1	3	23.4729507325
3	90	1	0	1	38.4920631379
3	92	3	0	3	28.447118369
3	95	13	0	13	16.5639636662
3	96	4	0	4	41.9425234941
3	98	1	0	1	37.3989244771
3	99	1	0	1	21.4405378693
3	100	10	0	10	10.0827553676
3	102	54	0	54	11.4311824559
3	103	19	7	12	21.8103726654
3	104	6	0	6	15.2655086326
3	105	1	0	1	18.1109455068
3	110	1	0	1	21.1177486948
3	111	5	2	3	29.192658133
3	112	20	3	17	18.6620215616
3	113	34	6	28	25.9677293452
3	114	7	1	6	14.0777672602
3	116	2	1	1	33.6596120861
3	117	1	0	1	28.443040818
3	119	1	1	0	38.8225005311
3	120	4	1	3	20.9381983952
3	122	1	0	1	34.4522477331
3	123	1	0	1	27.7219116449
3	124	3	1	2	36.2998434927
3	125	1	0	1	30.355306743
3	128	0	0	0	40.2773885458
3	130	1	0	1	43.6897011636
3	131	1	0	1	49.7508154677
3	137	1	0	1	37.716174321
3	140	3	0	3	26.4903433487
3	142	16	0	16	33.1111627775
3	144	1	0	1	37.5483723979
3	147	1	0	1	50.7029891172
3	151	1	1	0	42.9885737817
3	156	1	0	1	46.4589130727
3	166	1	0	1	55.3109555293
3	172	1	0	1	44.7672392479
3	183	2	0	2	82.2852653326
3	191	1	0	1	106.262232494
3	194	1	0	1	96.1496371365
3	245	4	0	4	26.9621595787
3	253	1	0	1	47.0071242461
3	256	1	0	1	15.1749956019
3	257	4	0	4	21.0621307583
3	276	1	0	1	51.4674431676
3	277	5	1	4	45.2821849744
3	282	0	0	0	46.1600590784
3	286	2	0	2	43.8073758965
3	292	1	0	1	62.5431160278
3	296	1	0	1	54.2048493531
3	303	27	0	27	20.0405401771
3	304	3	0	3	9.12045475102
3	305	4	0	4	28.823197813
3	307	24	7	17	20.0791362724
3	309	10	1	9	12.4689398112
3	468	1	0	1	52.9363612867
3	469	1	1	0	67.7721360369
3	471	1	0	1	61.3504300465
3	476	1	0	1	48.8782599824
3	489	1	0	1	81.2415399577
3	503	1	0	1	84.4661199637
3	505	1	0	1	92.3252095621
4	0	17	4	13	9.8853339418
4	1	2028	40	1988	10.460607417
4	2	35	11	24	3.51813381172
4	3	5	0	5	13.5179500935
4	5	20	2	18	13.1693804127
4	6	5	1	4	18.8135861068
4	7	45	1	44	5.47226890113
4	8	1	0	1	28.734981629
4	9	6	1	5	11.5826967201
4	10	14	4	10	4.94009840714
4	11	4	1	3	23.0994100605
4	12	7	0	7	16.1328772262
4	13	61	5	56	8.11137605926
4	14	3	0	3	7.12851332143
4	15	122	49	73	2.64138158283
4	17	45	9	36	7.18330169532
4	18	4	0	4	11.8143232619
4	19	1	0	1	12.6746142404
4	20	18	7	11	9.72730207701
4	21	46	0	46	8.22106962853
4	22	2	1	1	17.063620822
4	23	85	61	24	4.70286217137
4	24	166	0	166	2.76515814186
4	25	1	0	1	23.8589946666
4	26	7	1	6	13.5357226568
4	27	3	0	3	14.6688057675
4	28	18	0	18	12.0243881444
4	29	11	3	8	19.3732599247
4	30	3	1	2	15.0376677585
4	32	7	1	6	20.1467950385
4	33	8	0	8	10.8068863653
4	34	4	0	4	21.8697311044
4	35	47	0	47	10.1160957408
4	36	42	0	42	18.2987862449
4	37	4	1	3	13.0758334424
4	38	1	0	1	18.7844667328
4	39	7	0	7	18.8876336118
4	41	2	0	2	14.7572904759
4	42	7	0	7	17.4110489446
4	46	2	0	2	27.0706001567
4	48	6	0	6	34.7705264523
4	49	4	1	3	17.5794094519
4	50	16	0	16	23.9065688076
4	51	1	1	0	19.8646431225
4	53	0	0	0	33.6925993652
4	55	3	0	3	32.1777279426
4	56	2	0	2	25.175524457
4	59	3	1	2	46.577138743
4	60	2	0	2	27.9280404975
4	61	1	0	1	38.7318495324
4	62	1	0	1	44.9327898226
4	64	1	0	1	26.6501993909
4	65	9	0	9	35.0098408856
4	66	0	0	0	20.0905296789
4	67	2	0	2	30.4272995613
4	70	5	0	5	42.5597071432
4	71	1	0	1	42.5588714511
4	73	54	1	53	36.281755374
4	74	1	0	1	40.4062329915
4	75	8	0	8	36.2754946908
4	76	4	0	4	43.5046815959
4	78	7	0	7	41.7888982461
4	79	1	0	1	36.3631223135
4	81	7	0	7	39.2348281646
4	82	2	0	2	41.4910010691
4	83	4	1	3	38.45801634
4	84	2	1	1	37.3451085407
4	85	1	0	1	45.5410189522
4	87	4	1	3	38.417525326
4	88	2	0	2	40.2081774708
4	89	2	0	2	36.9025822164
4	90	1	0	1	50.7539656099
4	92	1	0	1	41.5986511827
4	95	2	0	2	28.5292695211
4	99	1	0	1	28.2955015373
4	100	2	0	2	22.8638335444
4	102	3	2	1	24.9491223624
4	103	15	8	7	32.2667001802
4	105	1	1	0	31.5683174129
4	110	2	0	2	30.0802112074
4	112	10	0	10	29.2991595955
4	113	18	1	17	35.6075405953
4	115	0	0	0	47.9127194988
4	133	1	0	1	27.476273891
4	134	1	0	1	33.1500812564
4	142	4	1	3	37.6339380486
4	147	1	0	1	52.848279485
4	168	1	0	1	52.4171031827
4	171	1	0	1	53.9045439383
4	172	1	0	1	53.4184480372
4	183	2	0	2	88.7364534012
4	208	1	0	1	96.0568063983
4	214	1	0	1	90.1090976944
4	217	0	0	0	107.7987037
4	224	1	0	1	90.8854918224
4	245	1	0	1	40.1324968833
4	251	2	0	2	52.8521096805
4	257	2	0	2	33.1919146276
4	258	1	0	1	27.3547095765
4	260	1	0	1	33.9589592113
4	262	0	0	0	48.3797021605
4	266	1	0	1	64.4988200765
4	274	1	0	1	50.1123747418
4	277	14	0	14	54.7666868321
4	279	2	0	2	45.086890731
4	282	1	0	1	57.5049514816
4	287	1	0	1	63.7435793597
4	303	16	7	9	18.8431092814
4	304	7	3	4	14.1623158864
4	305	0	0	0	37.7334949147
4	306	1	0	1	26.0427937679
4	307	8	1	7	26.6056405246
4	309	3	1	2	20.7074851772
4	338	1	0	1	89.8316021357
4	465	0	0	0	72.0800150706
4	469	2	0	2	64.0377062542
4	471	2	1	1	53.8559733394
4	472	1	0	1	53.2635161704
4	474	1	0	1	77.5043788044
4	475	1	0	1	65.5973699305
4	476	1	1	0	43.3723519184
5	0	64	19	45	21.4072324909
5	1	5116	0	5116	10.508725712
5	2	12	1	11	16.0499685132
5	3	12	0	12	25.621973309
5	4	13	2	11	13.1693804127
5	6	120	47	73	9.34814178575
5	7	61	8	53	17.6955992242
5	8	39	13	26	15.7407220982
5	9	14	4	10	21.5753078383
5	10	4	2	2	18.1093678922
5	11	108	40	68	10.1669865194
5	12	274	76	198	4.78314983643
5	13	64	17	47	21.0383642146
5	14	1	0	1	20.2313340205
5	15	87	6	81	15.2653908731
5	16	4	0	4	25.2647628742
5	17	20	1	19	14.4306173
5	18	6	0	6	24.6314196085
5	19	12	0	12	23.5201248804
5	20	69	0	69	8.19089272678
5	21	367	240	127	5.07272037987
5	22	51	11	40	8.85214602083
5	23	150	0	150	8.97324778002
5	24	96	26	70	11.5114301674
5	25	91	1	90	11.6802054988
5	26	10	1	9	16.5630744351
5	27	17	0	17	13.1296667659
5	28	90	66	24	15.536778373
5	29	36	9	27	14.9189106938
5	30	3	0	3	24.9904733085
5	31	1	0	1	32.4957788957
5	32	8	0	8	29.8316961592
5	33	14	4	10	23.8050393274
5	34	3	1	2	31.148231879
5	35	33	16	17	21.8767627878
5	36	91	0	91	31.4463542465
5	37	3	0	3	20.9952172543
5	38	1	0	1	30.31174634
5	39	17	0	17	30.3263939278
5	40	1	0	1	34.343850725
5	41	8	2	6	27.6130920744
5	42	10	0	10	29.8867520684
5	43	2	0	2	40.7517020573
5	45	1	0	1	50.4112876787
5	46	19	4	15	22.44789412
5	47	3	0	3	43.9035961222
5	48	16	3	13	37.2860829178
5	49	9	6	3	22.0112842711
5	50	36	1	35	27.9606351
5	51	3	0	3	26.1913615429
5	52	1	0	1	39.5214230087
5	53	33	7	26	23.3601555379
5	54	1	0	1	35.0150038656
5	56	3	0	3	23.974471621
5	57	5	0	5	44.9192174959
5	58	9	0	9	26.5635670054
5	59	6	0	6	46.1642608817
5	60	7	1	6	31.3618862144
5	63	2	0	2	40.3694133097
5	64	5	2	3	19.2265525043
5	65	25	2	23	30.6360670822
5	66	2	0	2	21.5381169167
5	67	4	1	3	26.7439284964
5	68	8	0	8	34.8861257294
5	69	12	0	12	43.4466827778
5	70	10	0	10	55.3920544955
5	71	8	1	7	55.7272998753
5	72	2	0	2	51.551209907
5	73	134	0	134	49.3411703207
5	74	12	1	11	53.5311765608
5	75	27	6	21	49.4102900871
5	76	2	0	2	56.4737864646
5	78	19	0	19	54.8874162738
5	79	2	0	2	49.2099034424
5	80	1	0	1	51.179423592
5	81	11	0	11	52.1212835726
5	82	6	1	5	54.5048071629
5	83	8	1	7	51.517707291
5	84	20	5	15	50.4395039998
5	85	5	0	5	58.6264248401
5	86	5	0	5	57.723803641
5	87	19	0	19	51.5810195217
5	88	9	1	8	53.377057451
5	89	5	1	4	48.9813590643
5	92	5	0	5	54.0690140308
5	95	13	1	12	41.5028490867
5	96	5	0	5	67.4428013711
5	98	1	0	1	61.1233060005
5	99	2	0	2	41.1851136994
5	102	4	0	4	36.7486038409
5	103	33	1	32	45.4326821951
5	104	1	0	1	40.8505893848
5	105	0	0	0	43.6061879348
5	109	2	0	2	60.765246523
5	110	6	0	6	43.2085628181
5	111	1	0	1	54.5861581939
5	112	16	0	16	42.4515486153
5	113	46	4	42	48.7561821342
5	114	1	0	1	36.9030145265
5	115	1	0	1	59.5875533041
5	116	1	0	1	58.9301283416
5	117	1	0	1	51.6619638776
5	118	1	0	1	61.2178926855
5	120	3	0	3	46.448261867
5	121	1	0	1	51.8981766375
5	127	1	0	1	51.2708495239
5	128	2	0	2	56.4972028574
5	129	1	0	1	36.8920324001
5	131	4	0	4	52.42037171
5	134	2	0	2	45.5285972308
5	138	0	0	0	35.5158233496
5	140	3	0	3	46.9312983663
5	142	33	1	32	49.6563328234
5	144	1	1	0	55.99267057
5	145	0	0	0	42.159062183
5	147	1	0	1	63.3729304664
5	151	1	0	1	47.6100122194
5	160	1	0	1	63.7825773587
5	164	1	0	1	63.8207535851
5	166	1	0	1	80.1378248391
5	171	1	0	1	67.0645045684
5	172	4	2	2	66.3606861824
5	175	1	0	1	69.8212046118
5	177	3	0	3	71.2438043365
5	183	4	1	3	89.6911671257
5	188	1	0	1	97.3303490023
5	190	1	0	1	82.7462431313
5	208	0	0	0	103.341253238
5	211	1	0	1	110.298676063
5	212	1	0	1	90.3285724486
5	220	0	0	0	110.141106299
5	225	1	0	1	100.206740026
5	229	1	0	1	104.044388405
5	236	0	0	0	86.1653403086
5	241	0	0	0	135.626460707
5	242	0	0	0	128.634396571
5	243	1	0	1	122.517473707
5	244	1	0	1	131.301546106
5	245	2	0	2	50.5528195755
5	246	1	0	1	56.306716607
5	257	2	0	2	42.4499780229
5	258	3	0	3	35.9911417297
5	260	1	0	1	44.1886078055
5	264	1	0	1	42.1356976028
5	270	1	0	1	49.7147364342
5	271	1	0	1	77.9287722809
5	272	2	0	2	77.2941377003
5	275	2	0	2	58.2145218449
5	277	31	3	28	60.0253639528
5	279	1	0	1	50.3837039296
5	281	1	0	1	60.1893023788
5	282	4	1	3	64.8187631983
5	284	1	0	1	73.4971054578
5	287	1	0	1	69.7658422626
5	290	2	1	1	68.881688963
5	293	1	0	1	79.6905103207
5	303	68	7	61	19.5831434679
5	304	8	0	8	22.2755619694
5	305	4	0	4	43.4515378024
5	306	1	0	1	28.0136229179
5	307	27	8	19	31.7017579408
5	309	5	1	4	28.4089410281
5	319	1	0	1	98.9400340053
5	329	1	0	1	86.3412595261
5	379	1	0	1	101.561748119
5	415	2	0	2	99.5294744557
5	464	2	0	2	58.0220438525
5	465	1	0	1	77.8454135234
5	466	2	0	2	79.1580387034
5	468	1	0	1	57.5909673752
5	469	4	0	4	70.0809713783
5	471	1	0	1	56.4635638438
5	472	2	0	2	59.0808933164
5	475	1	0	1	74.1206894587
5	476	2	0	2	48.7538661557
5	479	1	0	1	51.5752401935
5	484	2	0	2	56.5575635698
5	488	1	0	1	69.9174691885
5	491	4	1	3	69.7965980614
5	503	1	0	1	90.1195863905
5	573	0	0	0	97.9918669294
6	0	35	1	34	28.4252474935
6	1	3044	132	2912	19.6435031609
6	2	6	0	6	20.4669900057
6	3	5	1	4	32.3003133297
6	4	23	0	23	18.8135861068
6	5	347	193	154	9.34814178575
6	7	38	2	36	24.1766404432
6	8	50	1	49	16.9205477695
6	9	4	1	3	29.3245935018
6	10	2	0	2	23.3253851759
6	11	61	0	61	13.1047070608
6	12	78	2	76	12.8224548553
6	13	35	6	29	26.8461636671
6	14	1	0	1	24.8731460962
6	15	48	5	43	21.3911787627
6	17	31	0	31	16.1375445594
6	18	6	2	4	30.555601298
6	19	1	0	1	30.9522622676
6	20	108	36	72	9.44596870523
6	21	468	52	416	11.5413117476
6	22	22	9	13	17.4980698391
6	23	106	46	60	14.1407373804
6	24	66	0	66	16.2581708353
6	25	108	6	102	6.74393580908
6	26	30	11	19	14.3114112421
6	27	96	26	70	9.18995484958
6	28	55	8	47	24.5613988332
6	29	266	75	191	7.59390302355
6	30	3	0	3	25.5193067226
6	31	1	0	1	35.2835980796
6	32	4	0	4	37.9019083188
6	33	5	1	4	27.8729940524
6	34	2	0	2	30.3456771243
6	35	30	5	25	24.4954940714
6	36	40	9	31	36.3635767643
6	37	5	0	5	20.7348528654
6	38	3	0	3	31.729929082
6	39	6	0	6	37.5250989513
6	41	5	0	5	31.0980367055
6	42	3	1	2	36.2146794488
6	43	4	0	4	31.7702108528
6	44	2	1	1	21.1259878898
6	45	1	0	1	43.3714951284
6	46	65	1	64	13.7696385394
6	47	2	0	2	35.9198965239
6	48	9	2	7	31.1626539491
6	49	6	0	6	19.0081766159
6	50	22	1	21	23.6465183882
6	51	3	0	3	23.7322944379
6	52	1	0	1	36.683362175
6	53	302	12	290	14.9508044834
6	54	1	0	1	32.9767826891
6	55	16	0	16	24.1409553834
6	56	11	0	11	16.8763866282
6	57	1	0	1	38.9255551283
6	58	21	5	16	17.2410638287
6	59	7	1	6	38.220197449
6	60	7	0	7	26.2532241795
6	61	8	0	8	26.1921414622
6	62	6	0	6	28.9780644414
6	63	1	0	1	32.1251756169
6	64	74	5	69	9.90253971446
6	65	77	7	70	21.6908845846
6	66	3	0	3	16.5637011399
6	67	5	0	5	18.1777541783
6	68	4	0	4	31.0485577199
6	69	3	1	2	38.6892602803
6	70	4	1	3	61.0616291653
6	71	2	0	2	59.9760032178
6	72	1	0	1	57.385512464
6	73	59	7	52	54.4347587062
6	74	7	0	7	58.2806431261
6	75	4	1	3	54.134765174
6	77	1	0	1	55.9566957232
6	78	11	1	10	59.7698922819
6	79	3	0	3	54.878878774
6	82	2	0	2	59.7181148427
6	83	1	0	1	56.5926147847
6	84	5	0	5	55.3783189816
6	85	2	0	2	63.5437170396
6	86	2	0	2	62.0750134191
6	87	4	1	3	55.9970315833
6	88	1	0	1	57.6276443964
6	89	4	1	3	55.7161432354
6	90	4	0	4	69.0100173984
6	92	1	0	1	60.3433925513
6	95	2	0	2	46.9322982441
6	96	0	0	0	73.117986092
6	102	4	0	4	43.7209249765
6	103	7	0	7	49.8778387068
6	104	1	0	1	47.0507057881
6	109	1	0	1	66.6336653737
6	111	1	0	1	61.4775749917
6	112	8	0	8	47.1217128527
6	113	27	1	26	52.6164837463
6	124	1	0	1	41.964806247
6	128	0	0	0	57.0953973607
6	129	2	0	2	39.8601567485
6	131	1	0	1	48.2641826092
6	137	0	0	0	60.760075598
6	140	1	0	1	49.7917192785
6	142	14	1	13	50.7609470625
6	146	1	0	1	57.66644423
6	147	1	0	1	62.2723260258
6	154	1	0	1	62.997678275
6	171	1	0	1	71.402914308
6	183	4	0	4	98.7925938301
6	208	0	0	0	112.417663909
6	220	0	0	0	119.263996318
6	229	0	0	0	113.364554133
6	236	1	0	1	95.4901117032
6	242	1	0	1	137.873465479
6	245	2	0	2	58.4640148756
6	247	1	0	1	79.9483545456
6	257	0	0	0	50.8173008579
6	258	1	0	1	44.5083883259
6	260	1	0	1	52.1634746014
6	264	1	0	1	50.9608794555
6	265	1	0	1	64.6866216058
6	274	2	0	2	65.6629625767
6	277	15	4	11	69.309425617
6	281	0	0	0	69.1952981757
6	282	0	0	0	73.8295979638
6	284	1	0	1	82.613108345
6	287	2	0	2	78.9908543268
6	293	0	0	0	88.4877147522
6	294	1	0	1	96.6764826859
6	303	51	18	33	28.9306450911
6	304	3	0	3	30.6775793105
6	305	7	1	6	52.6413714923
6	306	2	0	2	37.361758855
6	307	3	0	3	40.8897750083
6	309	5	0	5	37.0774594645
6	373	1	0	1	116.67297862
6	422	1	0	1	129.842717537
6	442	1	0	1	120.438072387
6	464	1	0	1	51.9571210583
6	465	0	0	0	72.553291606
6	466	0	0	0	73.0628786532
6	469	5	0	5	65.0898790365
6	471	3	0	3	49.7016039223
6	472	1	0	1	54.1645149428
6	475	1	0	1	70.9223124337
6	476	2	0	2	43.8617169157
6	479	1	0	1	45.4347660861
6	480	1	0	1	57.9860936306
6	482	1	0	1	73.186058659
6	484	1	0	1	48.4595640459
6	485	1	0	1	80.5902913955
6	495	0	0	0	81.6047996437
6	507	1	0	1	202.284018537
6	573	1	0	1	98.8781370011
7	0	124	42	82	4.43787942021
7	1	3117	123	2994	11.6640040832
7	2	47	0	47	5.94862040779
7	3	33	12	21	8.13276914197
7	4	27	2	25	5.47226890113
7	5	29	0	29	17.6955992242
7	6	7	0	7	24.1766404432
7	8	4	0	4	32.6940552935
7	9	23	6	17	6.62086458614
7	10	45	21	24	3.59228579341
7	12	7	0	7	19.7731056608
7	13	342	160	182	3.71058088866
7	14	23	2	21	5.54492037084
7	15	433	28	405	2.83104396315
7	16	5	4	1	8.70008075858
7	17	11	2	9	11.7309522579
7	18	27	24	3	6.99273746539
7	19	28	18	10	7.30913689622
7	20	10	1	9	15.1972910025
7	21	36	14	22	13.111152471
7	22	6	1	5	19.5302993862
7	23	53	1	52	10.0417230878
7	24	78	2	76	8.22053055785
7	25	2	0	2	28.9064146632
7	26	7	4	3	18.2382770152
7	27	6	0	6	19.9943686001
7	28	42	0	42	10.7708757557
7	29	7	0	7	24.7824085094
7	30	8	4	4	16.5134666936
7	31	3	1	2	17.8834375724
7	32	16	3	13	14.8888596577
7	33	34	1	33	8.80371383891
7	34	6	2	4	23.1672649421
7	35	83	17	66	10.7070253852
7	36	163	57	106	14.2453943191
7	37	4	1	3	16.1082558489
7	38	1	0	1	18.4316352453
7	39	15	3	12	13.4197729821
7	40	1	0	1	18.3149825829
7	41	18	1	17	12.6976466177
7	42	11	1	10	12.2331821288
7	43	2	0	2	49.5802677905
7	46	15	1	14	32.3823288013
7	48	8	2	6	38.5111543594
7	49	7	0	7	21.5185024033
7	50	23	0	23	27.5520270505
7	52	1	0	1	33.6893410229
7	53	5	0	5	39.0976686084
7	55	2	0	2	36.7844392516
7	56	2	0	2	30.0760580621
7	57	2	0	2	44.849765907
7	59	4	0	4	50.9099937266
7	60	7	0	7	31.5963843557
7	61	1	0	1	43.797608626
7	63	1	0	1	46.5356762729
7	64	1	0	1	32.1180815637
7	65	11	0	11	40.2060593776
7	66	1	0	1	24.669999888
7	67	3	2	1	35.5912038106
7	68	6	0	6	31.8315727217
7	70	19	11	8	37.696620965
7	71	9	0	9	38.5018128934
7	72	2	0	2	33.8587603368
7	73	188	35	153	31.7595841005
7	74	12	2	10	36.059452618
7	75	29	7	22	31.9822163837
7	76	7	0	7	38.8088142113
7	78	29	2	27	37.3530552425
7	79	4	1	3	31.5161884037
7	81	20	1	19	34.4321963162
7	82	10	2	8	36.8692301807
7	83	14	0	14	33.9317934578
7	84	24	0	24	32.9082478892
7	85	7	1	6	41.063081996
7	86	5	0	5	40.4203705765
7	87	20	1	19	34.2990529482
7	88	8	0	8	36.1758615368
7	89	7	3	4	31.5979383611
7	90	1	0	1	46.0634232711
7	92	10	1	9	36.4654758583
7	95	8	2	6	23.8608023262
7	96	4	0	4	49.7481106198
7	99	2	0	2	25.5282249991
7	100	1	0	1	17.8314816864
7	102	7	1	6	19.5442971112
7	103	30	3	27	28.2151884522
7	105	1	0	1	26.240776643
7	109	3	0	3	43.0812111182
7	110	5	2	3	26.5586787517
7	111	4	0	4	37.325379015
7	112	27	0	27	25.1387015875
7	113	67	2	65	31.9108765152
7	114	1	0	1	19.8048954803
7	115	0	0	0	42.5232480321
7	117	1	0	1	34.6695858453
7	118	1	0	1	43.6248630242
7	120	7	0	7	28.7601231885
7	124	3	0	3	35.4434796177
7	125	1	0	1	29.6552816337
7	128	1	0	1	43.174249946
7	131	1	0	1	47.6750879638
7	133	6	2	4	25.8651478877
7	134	2	0	2	31.1366128275
7	135	2	0	2	52.1904970406
7	138	2	0	2	22.8390884318
7	140	3	0	3	31.1207431035
7	142	34	9	25	35.9722255272
7	144	1	0	1	41.4122577422
7	145	1	0	1	30.2744352342
7	146	2	1	1	37.7677568629
7	147	1	0	1	52.3155407411
7	150	1	0	1	56.6620429351
7	155	2	0	2	53.9976014632
7	157	1	0	1	55.2170319953
7	162	2	0	2	58.4529984272
7	164	1	0	1	46.7686877096
7	166	1	0	1	62.6082338392
7	168	1	0	1	48.8658637096
7	172	1	0	1	50.2585620539
7	177	1	0	1	54.8260831263
7	183	2	0	2	85.2970239436
7	186	1	0	1	84.0243697714
7	187	0	0	0	93.9714428227
7	194	1	0	1	101.035259861
7	196	1	0	1	114.657859347
7	199	1	0	1	103.779099674
7	208	1	0	1	90.9076421133
7	209	1	0	1	87.6880081505
7	220	1	0	1	105.207242289
7	242	0	0	0	122.296565211
7	244	1	0	1	124.09129743
7	245	3	1	2	34.6673526257
7	249	0	0	0	49.4022565426
7	252	1	0	1	46.3147706695
7	256	1	0	1	22.9081346763
7	257	6	1	5	27.875403767
7	262	1	0	1	43.2426421622
7	264	1	0	1	29.4347220582
7	266	1	0	1	60.8500545215
7	270	1	0	1	43.7935390336
7	271	1	0	1	69.5008185976
7	272	1	0	1	66.6479210878
7	275	2	0	2	50.5907919762
7	277	30	0	30	50.2232181252
7	281	0	0	0	47.8796374016
7	282	0	0	0	52.4388548847
7	291	1	0	1	71.4237618277
7	303	35	12	23	17.408261719
7	304	5	3	2	9.84518829569
7	305	4	0	4	33.2533287591
7	307	17	0	17	22.6469851859
7	309	5	0	5	16.0557192589
7	319	2	0	2	81.774930153
7	329	2	1	1	68.7069625357
7	338	1	0	1	84.7207256349
7	375	1	0	1	93.700927499
7	392	1	0	1	86.1849995968
7	406	1	0	1	97.7841887723
7	415	1	0	1	91.1579080199
7	464	1	0	1	56.986584035
7	465	1	0	1	74.0479966053
7	466	3	0	3	77.1598468298
7	469	1	0	1	65.9531091566
7	475	1	0	1	66.2353690822
7	487	1	0	1	67.1537149326
7	493	2	0	2	90.3570567279
7	563	1	0	1	99.1003773402
7	566	1	0	1	86.4492649772
7	573	0	0	0	83.3354759977
7	581	1	0	1	69.7042650157
8	0	4	0	4	35.7949725683
8	1	1321	0	1321	22.4787033677
8	3	4	0	4	40.1102152406
8	4	2	0	2	28.734981629
8	5	130	31	99	15.7407220982
8	6	38	0	38	16.9205477695
8	7	3	1	2	32.6940552935
8	9	3	0	3	35.1207602206
8	11	360	7	353	5.63690692755
8	12	134	6	128	12.9464143914
8	13	16	7	9	36.261703638
8	15	30	0	30	30.5734301553
8	17	8	1	7	29.8384544599
8	19	2	0	2	37.349177486
8	20	11	0	11	22.9492136043
8	21	58	0	58	20.8092805761
8	22	56	18	38	14.8313968134
8	23	18	1	17	24.7121161825
8	24	11	0	11	27.246523391
8	25	107	18	89	11.1834629219
8	26	3	0	3	30.3570159579
8	27	12	0	12	25.6212914077
8	28	16	1	15	26.9024172689
8	29	14	0	14	24.4403791604
8	30	2	0	2	40.3061386603
8	33	4	0	4	39.4854414124
8	34	2	0	2	46.0403430428
8	35	4	1	3	37.5856307297
8	36	13	2	11	46.8194076696
8	39	1	0	1	44.1028793897
8	41	1	0	1	43.3343752574
8	42	2	0	2	44.5097760804
8	43	1	1	0	44.8503208489
8	46	9	2	7	29.0051032234
8	48	5	0	5	47.8719071671
8	49	4	0	4	35.5036411848
8	50	5	0	5	40.5192581704
8	51	1	0	1	40.1177176839
8	52	1	0	1	53.3232302324
8	53	38	1	37	20.6664800013
8	56	1	0	1	33.4477367457
8	57	1	0	1	55.6159756494
8	58	0	0	0	29.3936057064
8	59	1	0	1	53.4160672442
8	61	1	1	0	40.0201063606
8	64	2	0	2	23.4058695301
8	65	11	0	11	35.5412961129
8	66	1	0	1	33.4617996741
8	67	0	0	0	33.2277972629
8	68	2	0	2	47.8902582381
8	72	1	0	1	66.1426205291
8	73	35	0	35	64.4272598062
8	74	6	2	4	68.7533264952
8	75	6	2	4	64.6736730211
8	76	1	0	1	71.3577294246
8	78	4	0	4	70.0364470419
8	81	1	0	1	66.8966034089
8	83	2	0	2	66.5943158673
8	84	4	1	3	65.594996135
8	87	4	1	3	66.9549218532
8	89	2	0	2	62.7867275629
8	92	1	0	1	68.2608109774
8	95	3	0	3	56.490995802
8	100	1	0	1	50.1881374763
8	102	3	1	2	50.5669830225
8	103	3	0	3	60.8366500727
8	110	1	0	1	58.8103120057
8	112	4	0	4	57.7950957207
8	113	9	0	9	64.3186914284
8	115	6	0	6	72.7587268126
8	124	1	1	0	58.2617722128
8	128	1	0	1	72.0271543434
8	138	0	0	0	51.1258064119
8	140	1	0	1	62.656898021
8	142	10	1	9	65.2776286791
8	148	1	0	1	53.2774821219
8	164	1	0	1	79.3282615828
8	183	2	0	2	89.8912660231
8	208	2	0	2	110.684190914
8	220	0	0	0	110.286127409
8	221	1	0	1	105.179788802
8	242	0	0	0	129.725350054
8	253	1	0	1	79.4321624935
8	257	1	0	1	53.7194436204
8	258	1	0	1	47.136647611
8	263	1	0	1	61.5421880312
8	275	2	0	2	62.7504042414
8	277	6	0	6	66.3027934178
8	278	1	0	1	78.8661459592
8	281	0	0	0	68.6204387128
8	282	0	0	0	73.1137656565
8	303	13	1	12	27.2442099249
8	306	1	0	1	34.3519009429
8	307	4	1	3	40.2580059658
8	309	1	0	1	39.5687659812
8	317	1	0	1	104.577912846
8	388	1	0	1	122.628759602
8	414	1	0	1	116.279041069
8	426	1	0	1	148.968475058
8	465	1	0	1	89.3390937608
8	469	1	0	1	81.9508548566
8	471	1	0	1	65.9110205786
8	472	1	0	1	71.051136696
8	475	1	0	1	87.74213921
8	476	1	0	1	60.7652129841
8	477	1	0	1	81.3312218028
8	481	0	0	0	81.7178267036
8	482	1	0	1	88.0503372033
8	486	0	0	0	73.2608685619
8	503	2	0	2	102.674279278
8	505	1	0	1	99.938665803
8	573	0	0	0	113.636288005
9	0	221	6	215	3.23291409118
9	1	1381	425	956	12.6631538775
9	2	9	5	4	12.5675674015
9	3	76	24	52	6.02118303822
9	4	4	0	4	11.5826967201
9	5	7	0	7	21.5753078383
9	6	3	0	3	29.3245935018
9	7	47	32	15	6.62086458614
9	10	3	2	1	9.92790688438
9	12	6	2	4	22.3554500731
9	13	70	69	1	7.62538415433
9	14	2	1	1	11.1622585235
9	15	47	18	29	9.10681861841
9	16	64	0	64	4.05644219195
9	17	5	1	4	18.3090224616
9	18	25	4	21	7.91586746269
9	19	65	31	34	2.35010227114
9	20	3	0	3	20.9727412536
9	21	17	6	11	17.8103841364
9	22	1	0	1	20.6933300073
9	23	15	1	14	15.5954594538
9	24	18	0	18	14.3093361449
9	26	4	1	3	24.8171007319
9	27	1	0	1	26.243441451
9	28	23	1	22	9.07595934252
9	29	2	0	2	30.875021831
9	30	1	0	1	22.4321308956
9	32	11	3	8	8.65355824733
9	33	10	0	10	13.2696520608
9	34	2	0	2	28.7862055944
9	35	10	1	9	16.5587381793
9	36	44	0	44	14.9289369264
9	38	2	0	2	23.1299743659
9	39	31	19	12	8.98372180787
9	40	1	0	1	12.8049772629
9	41	7	3	4	16.416436756
9	42	13	0	13	10.1709937162
9	46	6	4	2	38.6407858976
9	48	5	0	5	45.0415850397
9	49	2	1	1	28.1195486149
9	50	4	1	3	34.0874161488
9	54	1	0	1	34.1890526728
9	55	2	0	2	43.3961095524
9	56	1	0	1	36.6213652102
9	59	0	0	0	57.5267116128
9	60	1	0	1	38.1247978738
9	65	1	0	1	46.590606701
9	66	0	0	0	31.2779066184
9	70	9	0	9	35.1569056614
9	71	3	0	3	37.7302333198
9	73	28	0	28	30.2046058199
9	74	1	0	1	34.7685637471
9	75	6	0	6	30.9177269166
9	76	1	0	1	36.6723418076
9	78	8	1	7	35.8416653198
9	79	3	0	3	29.1650317225
9	83	1	0	1	32.3047693059
9	84	6	0	6	31.5092099604
9	85	1	0	1	39.3842881708
9	87	5	1	4	33.5161428247
9	89	1	0	1	27.7043640877
9	99	1	0	1	27.288697986
9	102	14	0	14	15.4555786678
9	103	7	1	6	27.7725961394
9	106	1	0	1	23.032750405
9	111	1	0	1	33.1627220186
9	112	4	0	4	24.6263775424
9	113	6	1	5	31.9744401878
9	114	1	0	1	20.094044556
9	116	1	0	1	38.9920958759
9	120	1	1	0	26.1202183148
9	128	1	0	1	45.9435642997
9	140	1	1	0	32.4514325957
9	142	5	0	5	38.7395363544
9	144	1	0	1	43.4218838689
9	164	1	0	1	46.1498211284
9	175	1	0	1	52.0138474311
9	177	0	0	0	54.9419410088
9	179	1	0	1	54.5408600117
9	183	0	0	0	79.0624438335
9	187	0	0	0	87.3937973199
9	209	1	0	1	81.1637114498
9	211	1	0	1	91.7769640942
9	214	1	0	1	78.5365895039
9	220	1	0	1	98.8589979822
9	239	1	0	1	81.4984232717
9	242	0	0	0	115.791226056
9	245	1	0	1	29.1515040798
9	257	3	0	3	21.7029396428
9	260	1	0	1	22.8391424925
9	262	2	0	2	36.7977990154
9	264	1	0	1	22.8830017431
9	270	1	0	1	37.5805234597
9	277	7	0	7	43.6070314408
9	280	1	0	1	50.1014502823
9	281	0	0	0	41.3596160633
9	293	1	0	1	59.7971816589
9	302	1	0	1	52.3239122786
9	303	18	4	14	14.0723986046
9	304	5	1	4	3.72571141487
9	305	1	0	1	26.6535967743
9	307	11	4	7	16.3289559385
9	309	5	5	0	9.45063436958
9	392	0	0	0	89.3530204516
9	466	1	0	1	83.0852100517
9	469	2	0	2	71.5557646295
9	471	1	0	1	63.6131320632
9	476	1	0	1	51.8972590341
10	0	43	3	40	7.16947841321
10	1	964	10	954	14.0667295918
10	2	60	21	39	3.1662104108
10	3	9	0	9	9.69143520027
10	4	7	1	6	4.94009840714
10	5	8	0	8	18.1093678922
10	6	4	1	3	23.3253851759
10	7	100	33	67	3.59228579341
10	9	9	1	8	9.92790688438
10	11	2	0	2	28.0035124357
10	12	5	0	5	20.9393839799
10	13	138	50	88	3.70330464189
10	14	23	7	16	2.42831554334
10	15	206	97	109	3.39235973919
10	16	6	0	6	11.1563551068
10	17	8	4	4	9.10262839395
10	18	10	3	7	7.31517834709
10	19	7	0	7	10.1051944884
10	20	5	0	5	13.9598017298
10	21	12	0	12	13.1458959614
10	22	2	1	1	21.4423842295
10	23	18	1	17	9.47659085059
10	24	17	1	16	7.1012709812
10	25	1	0	1	28.6627963286
10	26	4	0	4	15.4764035683
10	27	4	0	4	17.9339765012
10	28	12	5	7	14.0295385168
10	29	4	0	4	22.8743947044
10	30	4	0	4	12.9272030788
10	31	2	0	2	15.358119264
10	32	5	0	5	17.6782125435
10	33	21	8	13	6.13931274954
10	34	4	2	2	19.6120955804
10	35	60	1	59	7.1531808668
10	36	78	21	57	13.3741448644
10	37	3	0	3	12.657020412
10	39	8	2	6	15.3011315646
10	41	12	4	8	10.1613882021
10	42	7	2	5	13.0651782564
10	45	1	0	1	48.9036551408
10	46	9	5	4	30.1641960467
10	48	2	0	2	35.1163170333
10	49	1	0	1	18.2768708533
10	50	7	0	7	24.165305654
10	53	4	1	3	38.0409273528
10	56	1	0	1	27.3357124036
10	59	1	0	1	47.7159748639
10	60	2	0	2	28.199872526
10	61	1	0	1	41.1624205242
10	64	2	0	2	30.4771123277
10	65	5	0	5	37.7518887143
10	66	3	0	3	21.7257691796
10	67	4	0	4	33.1111103329
10	68	2	1	1	28.2647529973
10	69	1	0	1	37.2989219678
10	70	5	0	5	37.7948305027
10	71	5	0	5	37.6188703366
10	72	3	0	3	34.0782607776
10	73	117	7	110	31.4000323426
10	74	8	0	8	35.4872931043
10	75	7	0	7	31.3522331801
10	76	0	0	0	38.6661620663
10	78	7	0	7	36.8833486131
10	79	3	1	2	31.6013316802
10	81	6	0	6	34.445752672
10	82	2	1	1	36.6303965428
10	83	1	0	1	33.5747142906
10	84	19	0	19	32.4434369184
10	85	2	0	2	40.6410185242
10	86	8	0	8	39.621842379
10	87	12	0	12	33.4794608432
10	89	3	0	3	32.5702440896
10	90	1	0	1	45.9068367685
10	92	1	0	1	37.0299520489
10	98	1	0	1	43.0161515984
10	99	1	0	1	23.5520705908
10	101	1	0	1	41.4479365417
10	102	2	0	2	20.9236850731
10	103	11	1	10	27.3276657228
10	109	3	0	3	43.3305154125
10	110	1	0	1	25.1711305742
10	112	7	0	7	24.3674988254
10	113	25	0	25	30.6829445917
10	114	2	0	2	18.7955904268
10	116	1	0	1	41.1544059005
10	117	2	0	2	33.5656611527
10	120	1	0	1	29.0614771586
10	124	1	0	1	31.9910671389
10	128	1	0	1	40.5209722899
10	140	1	0	1	29.2568545219
10	142	18	3	15	33.3689663603
10	147	1	0	1	49.257151012
10	155	1	0	1	53.4646000502
10	164	2	0	2	45.7234663451
10	169	1	0	1	54.7999068464
10	171	2	0	2	48.9676505759
10	172	1	0	1	48.6040008023
10	177	3	0	3	53.34943024
10	183	3	0	3	88.8415697789
10	198	0	0	0	129.312376346
10	208	0	0	0	93.6220278071
10	220	1	0	1	108.717524224
10	241	0	0	0	132.355875533
10	245	3	0	3	36.6535275981
10	249	1	0	1	51.4915901523
10	251	1	0	1	48.9192559526
10	257	3	0	3	30.4371362399
10	266	1	0	1	64.3688366444
10	277	6	0	6	53.463576674
10	282	0	0	0	55.287975667
10	284	1	0	1	64.5589562197
10	303	11	0	11	20.7956019598
10	305	1	0	1	36.55601315
10	307	8	2	6	26.1500798923
10	309	1	0	1	19.3617834751
10	357	1	0	1	84.8985892741
10	385	1	0	1	88.0557452178
10	465	1	0	1	70.4695846874
10	466	0	0	0	73.5680024884
10	469	4	3	1	62.3767477246
10	475	0	0	0	62.8481313545
10	481	1	0	1	75.5640276531
10	491	2	0	2	65.6797414498
10	499	1	0	1	77.0259476101
10	573	0	0	0	81.1623860327
11	0	20	1	19	30.2867426481
11	1	1817	53	1764	17.2008780415
11	3	3	0	3	34.5986891517
11	4	2	0	2	23.0994100605
11	5	165	0	165	10.1669865194
11	6	62	15	47	13.1047070608
11	7	18	7	11	27.0937947696
11	8	363	215	148	5.63690692755
11	9	1	0	1	29.7550831603
11	12	203	49	154	7.42459369661
11	13	15	6	9	30.6431519645
11	14	1	0	1	30.2225254941
11	15	26	5	21	24.9433586172
11	17	5	1	4	24.4384967655
11	18	1	0	1	34.0845663584
11	19	3	0	3	31.9436047793
11	20	19	0	19	17.6996411603
11	21	61	0	61	15.2180635743
11	22	53	31	22	10.1116488233
11	23	15	1	14	19.1200644729
11	24	14	7	7	21.6471230963
11	25	105	81	24	9.16499501334
11	26	2	0	2	25.4858118639
11	27	14	0	14	21.0381512651
11	28	33	1	32	21.8519486285
11	29	21	0	21	20.668815255
11	31	1	0	1	42.645006523
11	32	4	0	4	37.2261123284
11	33	3	0	3	33.8575107405
11	34	3	0	3	40.8811372296
11	35	6	3	3	32.0427586113
11	36	23	0	23	41.1927766463
11	37	1	0	1	30.7363754524
11	38	2	0	2	40.4413002974
11	39	3	1	2	38.7352105629
11	41	3	0	3	37.7184663451
11	42	3	0	3	38.9851082176
11	43	1	0	1	43.4213831796
11	45	1	1	0	56.4303215008
11	46	9	2	7	26.3654079502
11	47	1	0	1	48.6743451664
11	48	6	0	6	44.2354912261
11	49	2	0	2	30.7824907422
11	50	9	1	8	36.1510552902
11	53	57	0	57	20.9841768093
11	55	1	0	1	37.1794790222
11	57	1	0	1	51.9974128649
11	58	4	0	4	28.0548534688
11	59	4	1	3	50.9825141614
11	60	4	1	3	39.0771550238
11	63	1	0	1	44.7361608698
11	64	3	0	3	21.3071718241
11	65	8	3	5	33.6563040756
11	66	0	0	0	29.2143674524
11	67	2	0	2	30.7436399052
11	68	5	0	5	43.4213625284
11	69	4	1	3	51.4736105181
11	70	0	0	0	64.5570888206
11	71	1	0	1	65.5137962993
11	73	59	8	51	58.8440792404
11	74	4	0	4	63.1510219826
11	75	5	0	5	59.0645736103
11	76	1	0	1	65.8123864019
11	78	6	3	3	64.4454372338
11	79	1	0	1	58.425638039
11	81	1	0	1	61.3689055216
11	82	5	0	5	63.9165598059
11	83	3	0	3	61.0135465503
11	84	7	2	5	60.0015321282
11	85	3	0	3	68.1490041934
11	86	1	0	1	67.4681454015
11	87	2	0	2	61.3327571411
11	88	1	0	1	63.1734763769
11	92	2	0	2	62.8532523928
11	95	1	0	1	50.9192272438
11	102	6	0	6	45.2099668886
11	103	6	0	6	55.2103539502
11	110	3	1	2	53.1735301634
11	111	1	0	1	62.8592782322
11	112	5	1	4	52.174445281
11	113	9	0	9	58.6821436883
11	115	1	0	1	67.5954422301
11	119	1	0	1	73.0735038277
11	120	1	0	1	55.53398527
11	124	1	0	1	53.2869779419
11	128	1	0	1	66.6035937297
11	129	1	0	1	47.0152835922
11	134	0	0	0	55.6953585421
11	142	16	1	15	59.7996639767
11	146	2	0	2	64.3177968491
11	147	2	2	0	73.1684233535
11	164	1	0	1	73.694904492
11	168	1	0	1	75.5162035552
11	183	3	0	3	88.8281536781
11	188	0	0	0	97.6757466279
11	199	1	0	1	118.373619163
11	205	1	0	1	99.0141109048
11	208	1	0	1	107.276862748
11	211	0	0	0	113.904928659
11	220	2	0	2	109.301161812
11	224	1	0	1	99.5909374521
11	225	1	0	1	102.879630098
11	245	1	0	1	57.6944007619
11	257	1	0	1	48.9834818605
11	277	12	1	11	63.0881336069
11	282	1	0	1	69.3095464768
11	293	0	0	0	84.7347740556
11	303	36	0	36	23.072645087
11	304	2	0	2	29.4892982693
11	305	0	0	0	47.4899434999
11	307	9	0	9	36.1338495104
11	309	1	0	1	34.7583114295
11	338	0	0	0	110.869833873
11	426	1	0	1	145.404210742
11	427	0	0	0	124.844121055
11	465	0	0	0	85.5503700882
11	466	2	0	2	86.1637647182
11	469	2	0	2	78.0075640761
11	475	1	0	1	83.1449093763
11	488	1	1	0	75.3659413063
11	493	1	0	1	95.5718535869
11	566	0	0	0	109.526721405
11	581	0	0	0	95.4288414878
12	0	34	15	19	22.8682433299
12	1	3924	1334	2590	9.91122132353
12	2	8	1	7	19.3909551663
12	3	3	0	3	27.181833617
12	4	6	1	5	16.1328772262
12	5	378	235	143	4.78314983643
12	6	30	11	19	12.8224548553
12	7	42	0	42	19.7731056608
12	8	66	38	28	12.9464143914
12	9	2	0	2	22.3554500731
12	10	2	0	2	20.9393839799
12	11	161	0	161	7.42459369661
12	13	33	12	21	23.3770403719
12	15	49	0	49	17.757600786
12	16	2	1	1	26.3041760755
12	17	10	2	8	18.7337621798
12	18	1	0	1	26.7492826367
12	19	8	0	8	24.5280725115
12	20	21	10	11	12.9073830909
12	21	130	14	116	8.95172368615
12	22	178	72	106	4.69776401903
12	23	55	10	45	12.6697914723
12	24	49	15	34	15.0790727736
12	25	25	8	17	12.7763352513
12	26	2	0	2	21.3199329892
12	27	5	1	4	17.8759451886
12	28	61	13	48	14.762825066
12	29	15	0	15	19.2887132452
12	30	2	0	2	29.2377788509
12	31	3	1	2	35.9346818701
12	32	6	0	6	29.9901799206
12	33	5	2	3	26.9387202195
12	34	3	0	3	35.5803885993
12	35	24	2	22	25.629993245
12	36	60	25	35	33.9551842606
12	37	1	0	1	25.4729519071
12	38	6	3	3	34.2383484533
12	39	8	0	8	31.3291733642
12	41	4	0	4	30.8833091724
12	42	4	1	3	31.5741098882
12	46	16	6	10	26.4717174772
12	48	5	2	3	42.0130244283
12	49	3	0	3	26.7692458935
12	50	23	0	23	32.7432907089
12	51	1	0	1	30.8881795994
12	52	0	0	0	44.1950742519
12	53	12	4	8	25.173284882
12	55	2	0	2	36.0990844439
12	56	1	0	1	28.5144045405
12	57	13	2	11	49.6667626955
12	58	1	0	1	29.9024112636
12	59	4	1	3	50.567334754
12	60	5	0	5	36.1379324289
12	61	1	0	1	38.9879937094
12	62	0	0	0	41.4171205118
12	63	1	0	1	44.6521622275
12	64	3	0	3	22.6119717359
12	65	16	3	13	34.5030673724
12	66	0	0	0	26.2984957968
12	67	5	0	5	30.8444049355
12	68	2	0	2	39.6477013675
12	69	2	0	2	48.2288789632
12	70	8	0	8	57.1401351313
12	71	4	0	4	58.2598939248
12	73	108	0	108	51.4842716778
12	74	5	0	5	55.8240414416
12	75	10	0	10	51.7541258727
12	76	1	0	1	58.4146944605
12	78	13	0	13	57.0972333461
12	79	2	0	2	51.0149906991
12	80	1	0	1	53.0371474633
12	81	6	0	6	53.9606774647
12	82	7	2	5	56.5325748878
12	83	8	0	8	53.6503399959
12	84	8	4	4	52.6577891161
12	85	4	0	4	60.7885015184
12	86	4	0	4	60.1903074135
12	87	7	0	7	54.0641983581
12	88	1	0	1	55.9274919805
12	90	2	0	2	65.6522908577
12	92	6	0	6	55.4325497802
12	93	1	0	1	72.0565833082
12	95	2	0	2	43.5451417713
12	96	1	0	1	69.1054977669
12	98	1	0	1	63.728319932
12	99	2	0	2	44.4280035145
12	100	1	1	0	37.2533343686
12	102	2	0	2	37.805343534
12	103	8	0	8	47.9629770687
12	104	2	0	2	42.4130940999
12	107	1	0	1	62.8841732911
12	110	4	1	3	46.0726013298
12	112	10	1	9	44.9025578633
12	113	28	14	14	51.5347008012
12	114	1	0	1	39.4979526946
12	117	3	0	3	54.3576970961
12	120	1	0	1	48.1139212147
12	121	0	0	0	54.7031202413
12	124	2	1	1	48.3040211331
12	133	1	0	1	43.3816119195
12	142	19	0	19	53.4720543274
12	147	1	0	1	67.6946367456
12	154	2	0	2	65.9743082686
12	164	1	0	1	66.4900258226
12	172	1	0	1	69.5353769639
12	175	1	0	1	72.4807850296
12	177	1	0	1	74.2858337245
12	183	4	0	4	86.0198967569
12	188	0	0	0	94.0674499855
12	208	2	0	2	101.582666341
12	211	1	0	1	108.388385771
12	220	1	0	1	106.499885724
12	229	1	0	1	101.544669152
12	232	0	0	0	90.7643915598
12	245	1	0	1	50.582545764
12	251	1	0	1	64.269368875
12	257	2	1	1	42.0438363891
12	261	1	0	1	35.1194603289
12	262	1	0	1	55.0048429634
12	264	3	0	3	41.0743297052
12	266	1	0	1	63.2754673886
12	270	2	1	1	46.68043117
12	277	26	2	24	57.7786740816
12	281	0	0	0	58.6802621369
12	282	2	0	2	63.2813545265
12	284	1	0	1	71.7094274639
12	287	1	0	1	67.7014479315
12	288	1	0	1	61.4955616625
12	303	64	6	58	17.1777429034
12	304	7	3	4	22.255050332
12	305	2	0	2	41.6065826862
12	306	3	0	3	25.4096105825
12	307	14	0	14	29.980230542
12	308	1	0	1	31.8904408623
12	309	2	1	1	27.8118799623
12	329	1	0	1	88.3350701945
12	345	1	0	1	106.655275523
12	408	1	0	1	112.001226698
12	426	1	0	1	142.667316353
12	464	3	0	3	62.774137872
12	465	0	0	0	82.6285563536
12	466	2	0	2	83.9160980119
12	469	6	1	5	74.8621437738
12	471	2	0	2	61.1429762189
12	472	1	0	1	63.8623325412
12	476	2	0	2	53.5364791448
12	482	1	0	1	85.489652412
12	491	2	0	2	74.5133617691
12	496	0	0	0	85.9933562435
12	505	1	0	1	95.1879538939
12	573	1	0	1	101.702942071
13	0	151	74	77	4.43382994139
13	1	2129	48	2081	15.3557374718
13	2	74	51	23	6.86465957232
13	3	55	3	52	6.03107910822
13	4	19	0	19	8.11137605926
13	5	11	0	11	21.0383642146
13	6	1	0	1	26.8461636671
13	7	310	308	2	3.71058088866
13	8	1	0	1	36.261703638
13	9	26	4	22	7.62538415433
13	10	64	38	26	3.70330464189
13	11	3	1	2	30.6431519645
13	12	15	1	14	23.3770403719
13	14	40	0	40	3.75234146729
13	15	317	168	149	5.77363655532
13	16	16	0	16	7.82683952683
13	17	14	0	14	12.7582754565
13	18	106	100	6	3.7114327744
13	19	16	1	15	7.10416961322
13	20	10	0	10	17.5560706158
13	21	26	0	26	16.2477481339
13	22	8	4	4	23.2400961923
13	23	21	8	13	12.8071755871
13	24	50	8	42	10.5901451578
13	25	3	0	3	31.9643005064
13	26	6	1	5	19.0442281293
13	27	9	0	9	21.6361711448
13	28	30	9	21	14.0487201132
13	29	4	1	3	26.5775599277
13	30	9	0	9	14.8824633315
13	31	4	2	2	14.447979615
13	32	25	0	25	14.4373667924
13	33	181	163	18	5.76683127032
13	34	5	0	5	21.1619907643
13	35	146	34	112	9.04341339711
13	36	237	19	218	10.5824380672
13	37	9	2	7	15.5755766815
13	38	4	0	4	15.6618222389
13	39	39	8	31	11.653017513
13	40	1	0	1	16.9701000538
13	41	33	21	12	9.35776951161
13	42	22	10	12	9.40806300949
13	43	2	0	2	50.4228477247
13	45	1	0	1	51.6720086732
13	46	9	1	8	33.8455394414
13	47	2	0	2	49.0113032146
13	48	5	1	4	37.9851388635
13	49	4	0	4	21.4696665018
13	50	14	5	9	27.0969247659
13	52	1	0	1	31.7807544478
13	53	1	0	1	41.6389316103
13	55	4	2	2	37.1412845244
13	56	1	0	1	30.8707746689
13	57	2	1	1	43.9038094712
13	58	1	0	1	40.3847383816
13	59	3	0	3	50.8647054867
13	60	6	3	3	31.0913307307
13	61	1	0	1	44.7233351322
13	62	1	0	1	51.8225570844
13	65	11	0	11	41.3783045229
13	66	1	0	1	25.1644929495
13	68	6	0	6	30.5946959802
13	69	1	0	1	39.4902299692
13	70	14	3	11	34.4618307137
13	71	8	0	8	34.8845761774
13	72	2	1	1	30.6856716875
13	73	196	34	162	28.3038433147
13	74	18	0	18	32.5309700466
13	75	31	7	24	28.4297450962
13	76	6	1	5	35.4556407251
13	77	1	0	1	29.3019991387
13	78	22	5	17	33.8622294733
13	79	5	1	4	28.2661301422
13	80	2	0	2	30.2010406353
13	81	17	0	17	31.1494401649
13	82	10	4	6	33.470706355
13	83	7	0	7	30.4801691639
13	84	23	1	22	29.4138089924
13	85	6	0	6	37.5938476675
13	86	5	1	4	36.8265955531
13	87	18	2	16	30.6941917939
13	88	10	0	10	32.5507122668
13	89	8	2	6	28.9317509728
13	90	1	0	1	42.7103523411
13	92	8	3	5	33.5077120878
13	95	13	0	13	20.4773247499
13	96	6	0	6	46.5341412495
13	97	1	0	1	52.9718971679
13	102	4	1	3	17.222304605
13	103	58	2	56	24.5860548965
13	104	2	0	2	20.2102089255
13	107	2	0	2	39.6818890062
13	109	1	0	1	39.9350018806
13	110	9	0	9	22.8530179386
13	111	1	0	1	34.735545049
13	112	35	1	34	21.5335910171
13	113	67	0	67	28.2235448991
13	114	2	0	2	16.1355062707
13	116	2	0	2	37.923556825
13	117	2	0	2	31.0028950522
13	120	2	0	2	25.6262580201
13	124	1	0	1	32.9590217165
13	129	2	0	2	17.9224755169
13	131	2	0	2	45.719109186
13	133	3	0	3	22.4547424908
13	137	1	0	1	38.9481460894
13	138	1	0	1	19.7101732548
13	140	9	3	6	27.4264718525
13	142	32	0	32	32.4949323015
13	145	1	0	1	27.1624462543
13	146	2	0	2	34.062836871
13	148	1	0	1	24.0973868572
13	154	1	0	1	44.696291371
13	155	2	0	2	50.496052124
13	168	1	0	1	45.1713491694
13	169	2	0	2	51.4156724779
13	171	2	0	2	46.1351267558
13	172	2	0	2	46.5479997562
13	177	1	0	1	51.121284079
13	183	0	0	0	86.6085852543
13	190	2	0	2	82.2765735116
13	208	1	0	1	90.1726364469
13	209	1	0	1	87.198100394
13	212	2	0	2	77.803918634
13	229	1	0	1	94.037832756
13	242	1	0	1	123.062208999
13	245	3	0	3	32.9814292702
13	249	1	1	0	47.8303312447
13	254	1	0	1	41.1553930686
13	256	1	0	1	21.2004890996
13	257	6	1	5	26.9633255581
13	258	2	1	1	21.8820631018
13	262	2	0	2	42.6540185233
13	268	1	0	1	69.8448340627
13	274	1	0	1	45.2623876124
13	277	18	0	18	50.5302138702
13	282	1	0	1	51.9478864887
13	293	1	0	1	65.0314378799
13	294	1	0	1	71.924783797
13	303	28	2	26	20.4052736333
13	304	3	0	3	11.3251753057
13	305	2	0	2	33.7624793551
13	307	18	2	16	23.8967870606
13	309	8	1	7	16.7084926989
13	319	1	0	1	78.1597250515
13	345	1	0	1	94.1130359031
13	464	6	1	5	55.6599200402
13	465	1	0	1	72.0389305125
13	466	3	0	3	75.4769086207
13	467	1	0	1	66.5398230382
13	470	1	0	1	55.3107182751
13	471	3	1	2	56.2661329066
13	472	1	0	1	53.5708003206
13	475	2	0	2	63.5258906954
13	476	1	1	0	44.323773774
13	480	1	0	1	60.1656873043
13	490	1	0	1	62.9631517763
13	493	1	0	1	89.1058243015
13	573	0	0	0	79.6740838315
13	574	0	0	0	91.8202624565
14	0	38	6	32	8.07823605328
14	1	856	0	856	16.488736603
14	2	60	2	58	4.41977594775
14	3	17	10	7	9.52950784269
14	4	10	7	3	7.12851332143
14	5	6	0	6	20.2313340205
14	6	2	0	2	24.8731460962
14	7	99	0	99	5.54492037084
14	8	1	0	1	35.8565599332
14	9	6	0	6	11.1622585235
14	10	50	13	37	2.42831554334
14	11	1	0	1	30.2225254941
14	12	5	2	3	23.2419991393
14	13	189	8	181	3.75234146729
14	15	153	75	78	5.82049048476
14	16	2	0	2	11.5622194573
14	17	16	0	16	9.70274873816
14	18	20	19	1	6.5652629107
14	19	6	1	5	10.8436564338
14	20	2	1	1	15.4312474798
14	21	11	3	8	15.20326322
14	22	3	0	3	23.85495066
14	23	16	1	15	11.4062441011
14	24	22	15	7	8.91124350689
14	26	3	1	2	15.691788291
14	27	2	0	2	18.7635658804
14	28	10	0	10	16.2597261234
14	29	4	0	4	23.7547083566
14	30	8	2	6	11.2748839451
14	31	5	2	3	12.9341091789
14	32	3	0	3	18.1750248168
14	33	135	46	89	3.73021406534
14	34	9	2	7	17.7565938181
14	35	149	1	148	5.3984342927
14	36	88	11	77	11.5142675666
14	37	11	5	6	11.838005043
14	38	3	2	1	12.9120655201
14	39	7	3	4	15.100917117
14	40	1	0	1	20.5077609585
14	41	16	11	5	7.74561625667
14	42	8	1	7	12.2144480015
14	46	6	0	6	30.7322475289
14	48	6	0	6	34.2330142978
14	49	2	1	1	17.7886638323
14	50	11	1	10	23.3498118527
14	51	2	1	1	18.3272004671
14	53	1	0	1	39.3903478661
14	56	1	0	1	27.4202242779
14	58	0	0	0	37.4201607422
14	60	6	1	5	27.3405014521
14	62	1	0	1	48.6841290271
14	63	1	0	1	43.2214721904
14	65	4	0	4	38.0680736435
14	66	2	0	2	21.623213538
14	67	2	0	2	33.4245768278
14	68	1	1	0	26.9105721196
14	69	1	0	1	35.8525198714
14	70	5	0	5	36.1985967118
14	73	85	4	81	29.6019593785
14	74	8	3	5	33.5769942545
14	75	17	0	17	29.4310119005
14	76	2	0	2	36.9453451557
14	77	1	0	1	31.1146502583
14	78	6	1	5	35.0143083832
14	79	2	0	2	30.0250073653
14	81	7	0	7	32.8187551792
14	82	5	1	4	34.8695635661
14	83	4	0	4	31.7687663725
14	84	9	0	9	30.5919388543
14	85	4	0	4	38.7831623824
14	86	3	0	3	37.6057802689
14	87	4	1	3	31.4706258928
14	88	2	1	1	33.2189919499
14	89	4	0	4	31.5024592759
14	90	2	0	2	44.1604120577
14	92	2	0	2	35.6928135355
14	95	6	0	6	22.0625373535
14	96	1	0	1	48.2476319307
14	100	1	0	1	17.0549909419
14	102	2	0	2	20.2393748005
14	103	14	0	14	25.313970955
14	105	2	0	2	26.3294510796
14	109	1	0	1	41.796332325
14	110	4	0	4	22.9779843263
14	111	1	0	1	37.3467975705
14	112	13	5	8	22.4192218886
14	113	19	0	19	28.5271709229
14	114	1	0	1	16.7877814999
14	120	3	0	3	27.6174266006
14	124	3	0	3	29.9100983821
14	134	1	0	1	26.2828601111
14	140	3	0	3	26.9176116749
14	142	14	0	14	30.9411759967
14	151	1	0	1	35.912591405
14	164	1	0	1	43.6034444617
14	171	3	1	2	46.9594303886
14	172	1	0	1	46.2958231932
14	177	1	0	1	51.0848420947
14	183	0	0	0	90.2235837328
14	222	0	0	0	102.151675579
14	249	1	0	1	51.1433831987
14	258	1	0	1	25.6138305823
14	277	9	0	9	54.2821498529
14	281	0	0	0	51.1597551162
14	282	1	0	1	55.629288346
14	303	12	0	12	22.9484638635
14	304	1	0	1	14.7788577731
14	305	1	0	1	37.5017306815
14	306	1	0	1	28.7601588107
14	307	4	0	4	27.4906616102
14	309	2	0	2	20.4094811592
14	408	1	0	1	94.440645081
14	465	0	0	0	68.673402823
14	469	1	0	1	60.571948169
14	480	1	0	1	56.5997155859
14	487	1	0	1	62.970448948
14	495	1	0	1	77.8612229249
14	507	1	0	1	185.847972046
15	0	85	0	85	7.24957968511
15	1	3413	1008	2405	10.6941834974
15	2	128	88	40	4.01859735966
15	3	27	2	25	10.9114163216
15	4	22	3	19	2.64138158283
15	5	39	0	39	15.2653908731
15	6	7	0	7	21.3911787627
15	7	236	113	123	2.83104396315
15	8	1	0	1	30.5734301553
15	9	18	15	3	9.10681861841
15	10	63	29	34	3.39235973919
15	11	6	0	6	24.9433586172
15	12	17	0	17	17.757600786
15	13	255	81	174	5.77363655532
15	14	23	1	22	5.82049048476
15	16	9	2	7	11.513047022
15	17	27	15	12	9.26543284308
15	18	30	26	4	9.40791362955
15	19	10	3	7	10.0666592932
15	20	10	7	3	12.3666804872
15	21	31	0	31	10.5008512215
15	22	10	0	10	18.0718105111
15	23	58	36	22	7.25073655283
15	24	82	5	77	5.39550534258
15	25	4	1	3	26.2660287913
15	26	11	1	10	15.7540477848
15	27	3	1	2	17.2325586365
15	28	48	2	46	11.0847349346
15	29	16	3	13	21.9833258612
15	30	9	3	6	15.5482529749
15	31	3	0	3	18.748420951
15	32	10	0	10	17.5870050294
15	33	38	16	22	9.5243605569
15	34	4	0	4	22.3587232721
15	35	138	78	60	10.0603630467
15	36	145	43	102	16.2524891626
15	37	5	0	5	14.3774028466
15	38	2	0	2	18.4337003368
15	39	17	0	17	16.2489169515
15	40	3	1	2	21.1298517029
15	41	9	0	9	13.5470514775
15	42	8	1	7	14.8921377151
15	43	1	0	1	46.9734379757
15	46	17	5	12	29.6320951902
15	47	1	0	1	46.660599595
15	48	7	0	7	36.5366311047
15	49	2	1	1	19.4023403429
15	50	33	7	26	25.600405238
15	51	3	0	3	21.226468928
15	53	2	0	2	36.2957244873
15	55	1	0	1	34.3807470778
15	57	1	0	1	43.1015937148
15	59	5	0	5	48.6524578153
15	60	8	0	8	29.644601787
15	61	1	0	1	41.1717812812
15	63	2	0	2	44.1209994512
15	64	2	1	1	29.2900126806
15	65	35	0	35	37.5145923133
15	66	2	0	2	22.261919003
15	68	4	0	4	30.339731701
15	69	1	0	1	39.440172725
15	70	17	0	17	40.202342463
15	71	5	0	5	40.5730057433
15	72	2	0	2	36.4020853053
15	73	228	11	217	34.0758563364
15	74	16	0	16	38.2846661163
15	75	30	0	30	34.173984991
15	76	8	1	7	41.2248080965
15	78	27	3	24	39.6275769195
15	79	5	0	5	34.0095263547
15	80	3	0	3	35.9569849071
15	81	9	1	8	36.9033436919
15	82	13	0	13	39.2439407469
15	83	8	3	5	36.2523569573
15	84	37	15	22	35.1792270186
15	85	6	0	6	43.3630274401
15	86	7	0	7	42.5378938858
15	87	24	6	18	36.3987159086
15	88	7	4	3	38.2311605739
15	89	6	0	6	34.3406800882
15	90	0	0	0	48.4801517081
15	92	5	0	5	39.1166855325
15	95	9	0	9	26.2479058669
15	96	3	1	2	52.2702510147
15	98	1	0	1	46.0148773581
15	102	4	1	3	22.3394850276
15	103	29	11	18	30.269220589
15	104	2	1	1	25.8263787552
15	105	1	0	1	28.9948410557
15	107	2	0	2	45.1392378497
15	110	6	1	5	28.3189620643
15	111	2	0	2	40.0890774374
15	112	40	10	30	27.2465316208
15	113	61	0	61	33.7783301747
15	114	5	0	5	21.7694443593
15	116	2	0	2	43.6894378307
15	119	1	0	1	48.2230214592
15	120	1	0	1	31.3230830049
15	124	2	0	2	34.9479028557
15	128	1	0	1	43.907001815
15	131	1	0	1	46.6455884156
15	133	3	0	3	26.590172458
15	138	1	0	1	23.1815596375
15	140	5	1	4	32.5589291918
15	142	44	4	40	36.7593100453
15	145	1	0	1	30.5204370307
15	146	1	0	1	39.5120274326
15	159	1	0	1	62.7872946212
15	166	1	0	1	64.8825022965
15	168	1	0	1	50.6760398229
15	177	3	0	3	56.553699393
15	182	1	0	1	93.031469283
15	183	3	0	3	87.0342890888
15	208	1	0	1	93.5598871317
15	209	1	0	1	90.2704896491
15	220	0	0	0	107.050211864
15	222	0	0	0	98.9175398071
15	242	1	0	1	124.334568738
15	245	2	0	2	37.4933314432
15	247	0	0	0	58.7466792222
15	257	2	0	2	30.6140812454
15	262	2	0	2	45.8834217182
15	263	1	0	1	40.4977609659
15	264	3	0	3	31.9894629596
15	268	1	0	1	70.5016931053
15	270	1	0	1	45.5667326923
15	275	1	0	1	52.6369197212
15	277	39	4	35	52.5400937683
15	279	1	0	1	42.8931201157
15	281	0	0	0	50.4657548566
15	282	1	0	1	55.0421933319
15	287	2	0	2	61.4036689659
15	294	2	0	2	76.2092684051
15	303	44	7	37	17.9377837677
15	305	5	2	3	35.5245533239
15	306	3	0	3	24.6127868779
15	307	14	0	14	24.6084476119
15	308	1	0	1	30.423824032
15	309	7	3	4	18.3952039461
15	319	1	0	1	83.8370835947
15	338	0	0	0	87.3666550899
15	350	1	0	1	67.6616931279
15	408	0	0	0	99.6013605635
15	415	1	0	1	90.9556652451
15	464	2	0	2	55.4555570181
15	465	1	0	1	73.0046295437
15	466	1	0	1	75.8525200687
15	469	3	0	3	64.9310843714
15	471	2	0	2	55.4581765672
15	475	0	0	0	65.8698860445
15	477	1	0	1	67.1245085994
15	480	2	0	2	60.3782650796
15	487	1	0	1	65.0640324486
15	495	0	0	0	82.2370127279
15	573	1	0	1	84.5365342393
16	0	184	30	154	4.26392419192
16	1	852	11	841	16.6945659365
16	2	6	1	5	14.2130482126
16	3	184	114	70	3.01382095208
16	4	2	1	1	14.1470153703
16	5	4	1	3	25.2647628742
16	7	34	22	12	8.70008075858
16	8	1	0	1	39.1223416343
16	9	109	64	45	4.05644219195
16	10	2	1	1	11.1563551068
16	11	1	0	1	33.7195746164
16	12	3	0	3	26.3041760755
16	13	69	25	44	7.82683952683
16	14	3	1	2	11.5622194573
16	15	44	12	32	11.513047022
16	17	1	0	1	20.1745713815
16	18	71	1	70	6.15065599821
16	19	105	56	49	1.77610375825
16	20	1	0	1	23.8384930103
16	21	7	0	7	21.2032220587
16	23	7	1	6	18.5683544829
16	24	9	2	7	16.9079767225
16	25	2	0	2	36.8394174086
16	28	16	4	12	13.0730803059
16	29	2	0	2	33.4820674047
16	30	4	0	4	22.3830974611
16	31	1	0	1	19.043218847
16	32	26	3	23	6.61281187724
16	33	12	0	12	12.5357127632
16	34	3	0	3	28.2517974729
16	35	8	0	8	16.6820171427
16	36	43	0	43	11.8618797559
16	39	108	50	58	5.06555119007
16	40	4	1	3	9.61682652199
16	41	12	1	11	14.8834847363
16	42	63	2	61	6.35993490684
16	46	2	0	2	41.0489792765
16	48	3	0	3	45.7759065844
16	49	2	0	2	29.2855262586
16	50	4	0	4	34.9102725585
16	51	4	0	4	29.833828842
16	53	1	0	1	47.5423217303
16	54	1	0	1	33.6767323043
16	57	1	0	1	51.557622597
16	60	2	0	2	38.8933877484
16	64	1	0	1	40.7926414203
16	65	3	1	2	48.7979371875
16	67	2	0	2	44.1678904248
16	70	4	0	4	31.1011529462
16	72	1	0	1	27.144759068
16	73	40	3	37	26.207285323
16	74	5	2	3	30.7922755842
16	75	14	1	13	26.988548426
16	77	1	0	1	25.9700055503
16	78	9	0	9	31.8362729047
16	81	1	0	1	28.0679864831
16	83	1	0	1	28.294184029
16	84	8	1	7	27.5275810981
16	85	1	0	1	35.3576946139
16	86	3	1	2	35.5074372917
16	87	3	0	3	29.6263494399
16	88	1	1	0	31.6314407717
16	89	3	0	3	23.7885911188
16	90	1	0	1	39.7655879945
16	92	2	0	2	29.1403570902
16	95	4	1	3	18.312281772
16	99	1	0	1	24.2663946004
16	100	1	0	1	11.6040206625
16	102	27	3	24	11.5257865622
16	103	11	1	10	23.9906901204
16	106	1	0	1	19.4174928925
16	110	3	0	3	23.6555985364
16	111	3	0	3	29.3309694778
16	112	10	5	5	20.8574932742
16	113	17	0	17	28.2898321139
16	116	1	0	1	34.9366391392
16	118	1	0	1	37.7548442545
16	120	1	0	1	22.0638530758
16	124	1	0	1	39.2534763552
16	129	1	0	1	21.1700847414
16	142	10	4	6	36.0347120076
16	143	1	0	1	42.6422966904
16	147	1	0	1	53.6924133395
16	171	1	0	1	44.4737227875
16	172	1	0	1	47.1385909794
16	183	1	0	1	79.4343867195
16	194	1	0	1	93.6803187887
16	208	0	0	0	82.4661619916
16	209	1	0	1	79.4141469411
16	245	2	0	2	25.9940403834
16	261	1	0	1	18.2536372544
16	262	0	0	0	34.8800036311
16	271	1	0	1	62.2864128931
16	277	2	0	2	42.7825436276
16	281	0	0	0	39.653915434
16	285	2	1	1	54.9086467517
16	303	17	1	16	17.5228883005
16	307	9	5	4	17.0926519142
16	308	1	0	1	24.3907665765
16	309	7	0	7	9.51209597376
16	328	1	1	0	66.0848059915
16	408	1	0	1	102.732824774
16	471	1	0	1	63.8924366706
16	476	1	0	1	51.6115947951
16	581	1	0	1	66.8680447734
17	0	24	5	19	16.0231291121
17	1	1893	357	1536	16.4144078754
17	2	89	46	43	5.96838022873
17	3	11	0	11	18.7824341647
17	4	45	33	12	7.18330169532
17	5	45	0	45	14.4306173
17	6	22	0	22	16.1375445594
17	7	64	17	47	11.7309522579
17	8	1	0	1	29.8384544599
17	9	5	0	5	18.3090224616
17	10	16	11	5	9.10262839395
17	11	9	0	9	24.4384967655
17	12	8	1	7	18.7337621798
17	13	70	16	54	12.7582754565
17	14	12	6	6	9.70274873816
17	15	180	1	179	9.26543284308
17	16	7	0	7	20.1745713815
17	18	10	1	9	16.1634564506
17	19	8	0	8	18.9654082561
17	20	82	0	82	7.08178907362
17	21	75	58	17	9.80607653238
17	22	6	1	5	21.1878664693
17	23	158	99	59	6.57154830988
17	24	230	156	74	5.23523906752
17	25	6	0	6	22.3973149398
17	26	73	43	30	6.50918533025
17	27	37	0	37	9.07453053585
17	28	44	7	37	18.9587047961
17	29	49	7	42	14.0691808813
17	30	20	6	14	10.5598631424
17	31	5	3	2	19.1812152066
17	32	8	0	8	26.5758820754
17	33	58	21	37	12.0399037031
17	34	31	6	25	16.8682405514
17	35	445	61	384	8.35925684729
17	36	82	0	82	20.7232746212
17	37	62	43	19	6.8997410288
17	38	4	0	4	16.1187249358
17	39	8	0	8	24.3992468712
17	41	19	8	11	14.9947882093
17	42	5	2	3	21.886271885
17	43	2	0	2	37.878419884
17	44	1	0	1	33.0621453128
17	46	18	0	18	21.0981401376
17	47	1	0	1	37.4133810541
17	48	20	7	13	27.6301105069
17	49	18	2	16	10.4487349952
17	50	45	6	39	16.8342503889
17	51	6	1	5	13.2275924564
17	52	1	0	1	26.0391731214
17	53	9	0	9	30.0598683848
17	55	2	0	2	25.1155827518
17	56	11	4	7	18.350991073
17	57	1	0	1	34.52972898
17	58	5	0	5	27.7249703689
17	59	10	1	9	39.4241953846
17	60	13	2	11	20.826020203
17	61	3	0	3	32.1180134765
17	63	5	2	3	34.8576293014
17	64	6	0	6	21.8458211442
17	65	25	9	16	28.6525572469
17	66	9	6	3	12.996510383
17	67	3	0	3	24.0137724705
17	68	5	0	5	22.4767645187
17	69	3	0	3	31.5361234264
17	70	4	0	4	45.5135571198
17	71	4	0	4	43.8803934957
17	72	2	0	2	41.9872198675
17	73	60	5	55	38.6232907704
17	74	9	1	8	42.3103864837
17	75	16	1	15	38.1767950004
17	78	5	1	4	43.8383821248
17	79	1	0	1	39.3926086078
17	81	6	2	4	42.1059877963
17	82	3	0	3	43.9254398744
17	83	3	0	3	40.756889952
17	84	8	1	7	39.4927131651
17	85	4	1	3	47.6080407881
17	87	4	0	4	39.9436835564
17	88	4	0	4	41.5371480259
17	89	2	0	2	41.196761242
17	90	1	0	1	53.198210461
17	92	1	0	1	45.2697084283
17	95	2	0	2	31.3950713397
17	96	2	1	1	57.4924579978
17	99	3	0	3	28.05550949
17	102	2	0	2	29.873532344
17	103	11	4	7	33.8571604072
17	107	2	0	2	47.0542334651
17	109	1	0	1	51.1730241456
17	110	4	0	4	30.8854187748
17	112	18	1	17	31.1921598852
17	113	25	0	25	36.4876301449
17	119	0	0	0	52.1183839106
17	120	3	0	3	37.1327086031
17	124	4	0	4	29.6618772733
17	129	2	0	2	23.7490838073
17	131	3	0	3	39.6168068152
17	134	0	0	0	31.620261533
17	137	0	0	0	44.8493955074
17	140	2	0	2	33.7287577243
17	142	21	4	17	35.472607264
17	144	1	0	1	42.0056188683
17	145	1	0	1	27.7621179288
17	150	1	0	1	52.0496650374
17	156	1	0	1	60.9846912925
17	172	1	0	1	53.0494725796
17	177	1	0	1	58.140155275
17	183	1	0	1	95.8927524792
17	198	1	0	1	137.883437709
17	203	1	0	1	132.954093506
17	204	1	0	1	89.1582734136
17	208	0	0	0	102.598163433
17	220	0	0	0	116.012362192
17	232	0	0	0	94.4562611408
17	236	0	0	0	88.1641836028
17	240	1	0	1	135.818048768
17	244	1	0	1	135.438134509
17	245	2	0	2	45.7396935952
17	257	1	0	1	39.4693979332
17	258	1	0	1	33.9507819158
17	261	1	0	1	36.9172675128
17	262	1	0	1	54.9505916308
17	266	0	0	0	71.6787938955
17	275	2	0	2	61.8019543621
17	277	10	0	10	61.8049556863
17	279	1	0	1	52.1529676459
17	293	1	0	1	77.6317857741
17	303	27	0	27	25.6422270651
17	304	6	1	5	21.2029378124
17	305	7	0	7	44.7864462667
17	307	14	0	14	33.7667442937
17	309	5	1	4	27.6576451953
17	319	0	0	0	86.5361440001
17	338	1	0	1	93.1159677124
17	356	0	0	0	109.684476263
17	397	1	0	1	82.2350326394
17	464	3	1	2	47.2203659195
17	465	0	0	0	65.7255755782
17	466	1	0	1	67.9821354429
17	469	7	4	3	57.7475062365
17	471	3	0	3	46.7912786844
17	472	2	0	2	46.857982368
17	475	1	0	1	60.3753917895
17	476	2	0	2	36.7821956006
17	479	1	0	1	41.0972695488
17	480	3	1	2	52.4576339563
17	486	1	0	1	60.6630532315
17	487	1	0	1	55.9551338615
17	488	1	0	1	61.1668513142
17	491	1	0	1	59.4025915001
17	494	1	1	0	60.1568120701
17	503	0	0	0	77.0387980578
18	0	243	192	51	5.01943798639
18	1	1339	322	1017	18.2014723318
18	2	16	10	6	10.4180338811
18	3	316	39	277	3.36687531295
18	4	8	1	7	11.8143232619
18	5	5	1	4	24.6314196085
18	6	4	0	4	30.555601298
18	7	113	27	86	6.99273746539
18	9	37	7	30	7.91586746269
18	10	11	0	11	7.31517834709
18	11	3	0	3	34.0845663584
18	12	8	1	7	26.7492826367
18	13	222	200	22	3.7114327744
18	14	11	6	5	6.5652629107
18	15	116	3	113	9.40791362955
18	16	54	42	12	6.15065599821
18	17	5	1	4	16.1634564506
18	19	52	17	35	6.32732775983
18	20	4	1	3	21.2477042755
18	21	6	1	5	19.9079924144
18	22	4	1	3	26.2613425719
18	23	10	1	9	16.5140374
18	24	22	14	8	14.2980498239
18	26	5	0	5	22.2556925791
18	27	1	0	1	25.1543595079
18	28	24	0	24	16.0608973144
18	29	2	0	2	30.1231501502
18	30	2	0	2	16.4883294424
18	31	7	2	5	13.2478342558
18	32	32	9	23	12.4475561812
18	33	187	0	187	6.50920251093
18	34	5	1	4	22.1464067726
18	35	61	14	47	11.01807667
18	36	310	13	297	7.53146109634
18	37	4	2	2	18.081825946
18	38	3	0	3	15.7915025183
18	39	94	5	89	8.64759899072
18	40	1	0	1	14.1060205199
18	41	46	9	37	8.78047110939
18	42	66	1	65	5.75761355764
18	43	1	0	1	53.482543053
18	46	10	0	10	37.2499078383
18	47	1	0	1	51.5746644336
18	48	2	0	2	40.1671609201
18	49	4	0	4	24.1691515265
18	50	8	1	7	29.4319796599
18	51	2	1	1	24.1953274425
18	53	2	0	2	45.333390812
18	54	2	0	2	27.5648279919
18	55	1	0	1	39.9580098706
18	56	1	0	1	33.9750144707
18	58	1	0	1	43.8769762982
18	59	3	1	2	53.3523531252
18	60	7	1	6	33.3449173027
18	61	2	0	2	47.8427635478
18	62	1	0	1	55.2155881473
18	65	10	0	10	44.6321858685
18	66	1	0	1	28.1471293343
18	67	3	0	3	39.9883162785
18	68	1	0	1	32.2229482679
18	69	2	0	2	40.889520309
18	70	10	4	6	30.794484051
18	71	2	0	2	31.5789461057
18	72	2	1	1	26.9988303614
18	73	118	11	107	24.7672154618
18	74	10	0	10	29.0749425245
18	75	16	0	16	25.0090084229
18	76	5	0	5	31.843184096
18	77	1	0	1	25.6266149448
18	78	13	6	7	30.3610653609
18	80	0	0	0	26.5549736555
18	81	6	0	6	27.4997722411
18	82	5	0	5	29.887512488
18	83	7	0	7	26.9398451623
18	84	18	0	18	25.9169984166
18	85	2	0	2	34.0704283827
18	86	1	0	1	33.4714904114
18	87	21	0	21	27.3649859554
18	88	6	1	5	29.265468936
18	89	4	0	4	25.2557701534
18	90	2	0	2	39.0991839512
18	92	4	0	4	29.7962925955
18	95	4	1	3	16.8794905767
18	96	1	0	1	42.8625055874
18	99	3	0	3	19.5797096983
18	100	4	0	4	11.0521388766
18	102	31	3	28	13.7104493676
18	103	43	1	42	21.3212374927
18	105	2	0	2	19.9896738847
18	110	3	0	3	19.9691783877
18	111	1	0	1	31.0721604259
18	112	23	0	23	18.2166157775
18	113	58	7	51	25.1661989244
18	114	6	0	6	13.0415393731
18	116	1	0	1	34.2989315358
18	122	0	0	0	36.0420618764
18	124	3	1	2	33.1340898051
18	129	3	1	2	15.987474155
18	131	1	0	1	46.4639576478
18	133	2	0	2	21.1036617453
18	134	3	0	3	25.7696043657
18	135	2	0	2	47.3601521703
18	138	1	0	1	19.0552428291
18	140	3	0	3	24.93501015
18	142	23	1	22	30.8490095472
18	146	1	0	1	31.1297216778
18	147	1	0	1	48.1106610176
18	165	1	1	0	52.7195044581
18	166	1	0	1	55.6155741752
18	168	2	0	2	42.1307320343
18	171	2	0	2	42.7369526619
18	178	2	0	2	58.5538401754
18	182	0	0	0	92.1796409865
18	183	0	0	0	85.5775115191
18	186	1	0	1	83.2046318741
18	191	1	0	1	109.627668943
18	208	1	0	1	87.3864635661
18	211	1	0	1	94.8839943679
18	214	1	0	1	81.0267276115
18	230	1	0	1	99.3253306008
18	232	0	0	0	80.363527973
18	242	0	0	0	121.456891015
18	245	1	0	1	29.7109175432
18	251	1	0	1	41.6778545163
18	252	1	0	1	42.2331912722
18	256	4	0	4	18.0010014504
18	257	2	0	2	24.2564288242
18	258	3	1	2	19.7198574024
18	261	1	0	1	24.3341874967
18	262	0	0	0	40.0749887441
18	264	2	0	2	27.0778833904
18	270	1	0	1	44.3132503394
18	277	12	0	12	48.6472063298
18	281	0	0	0	44.9933598844
18	293	2	0	2	62.0842732508
18	297	1	0	1	71.5689802592
18	303	18	0	18	21.8336637863
18	304	6	1	5	11.4982817966
18	305	4	1	3	32.178592265
18	306	1	0	1	25.9245631352
18	307	9	0	9	23.1997060001
18	309	10	1	9	15.6556400622
18	320	1	0	1	77.819123145
18	338	1	0	1	78.0186135896
18	415	1	0	1	87.6449745815
18	465	0	0	0	72.6239527991
18	466	1	0	1	76.4248969947
18	473	1	0	1	59.827613097
18	480	1	0	1	61.26949872
18	494	1	0	1	65.4241469728
18	501	1	0	1	88.3198982647
18	506	1	0	1	105.646269203
18	507	1	0	1	185.403453976
19	0	202	142	60	2.95021012179
19	1	913	17	896	14.9316769453
19	2	7	2	5	13.0465122613
19	3	140	0	140	3.84690508058
19	4	1	0	1	12.6746142404
19	5	5	3	2	23.5201248804
19	6	3	1	2	30.9522622676
19	7	50	1	49	7.30913689622
19	9	141	14	127	2.35010227114
19	10	0	0	0	10.1051944884
19	12	1	0	1	24.5280725115
19	13	58	1	57	7.10416961322
19	14	2	0	2	10.8436564338
19	15	38	2	36	10.0666592932
19	16	105	65	40	1.77610375825
19	17	2	0	2	18.9654082561
19	18	61	1	60	6.32732775983
19	21	5	2	3	19.5211999812
19	22	3	0	3	22.9987436223
19	23	8	1	7	16.9938520132
19	24	13	2	11	15.4395515566
19	25	1	0	1	35.113774864
19	26	1	0	1	25.4505178208
19	27	3	0	3	27.2927885974
19	28	14	6	8	11.4240834007
19	29	3	0	3	32.0459363346
19	30	1	0	1	21.9400406407
19	31	2	0	2	19.5400640936
19	32	15	0	15	7.61135028529
19	33	9	0	9	12.3283820886
19	35	8	0	8	16.1342662943
19	36	55	24	31	12.8648763348
19	39	43	18	25	6.82901424805
19	40	1	0	1	11.1485936819
19	41	4	0	4	15.0804883564
19	42	36	3	33	7.84050468185
19	43	1	0	1	56.8430993029
19	46	5	0	5	39.6867309316
19	48	2	0	2	45.051428063
19	49	1	0	1	28.365356332
19	50	3	0	3	34.1366942077
19	51	1	0	1	29.169503363
19	53	2	0	2	45.9010596679
19	58	1	0	1	45.9102376271
19	59	2	0	2	57.803273561
19	60	3	0	3	38.14744857
19	61	1	0	1	51.0741331351
19	65	1	0	1	47.5113092179
19	70	4	0	4	32.8461942634
19	71	3	0	3	35.3928992238
19	73	40	6	34	27.8545041689
19	74	1	0	1	32.4194092008
19	75	6	1	5	28.5746759448
19	76	7	2	5	34.3383211171
19	77	2	0	2	27.7066403337
19	78	6	1	5	33.4916940783
19	79	2	1	1	26.8357705233
19	81	2	0	2	29.7938040097
19	84	1	0	1	29.1596066297
19	85	2	0	2	37.0366964484
19	86	2	0	2	37.1043397683
19	87	5	1	4	31.1813471179
19	88	2	0	2	33.1760579309
19	89	3	0	3	25.5602458266
19	90	1	0	1	41.4971521198
19	95	6	0	6	19.9293392909
19	99	2	0	2	25.2753479489
19	100	3	0	3	13.2556251166
19	102	25	3	22	13.2971089117
19	103	10	1	9	25.4652469754
19	105	1	0	1	20.201477847
19	110	1	0	1	24.9317699766
19	112	10	0	10	22.3216474192
19	113	13	0	13	29.6995940341
19	120	2	0	2	23.8053639084
19	136	1	0	1	38.6145288487
19	142	12	0	12	36.8832345713
19	145	1	0	1	32.7124668732
19	155	1	0	1	49.9833774235
19	164	1	0	1	43.814309344
19	172	1	0	1	48.5280636847
19	183	2	0	2	79.6222623131
19	188	1	0	1	84.3715575951
19	214	1	0	1	77.5642529906
19	240	1	0	1	117.573336221
19	245	1	0	1	27.5543509556
19	262	0	0	0	35.9881573745
19	264	2	1	1	22.3129030524
19	272	1	0	1	59.6197918756
19	277	3	0	3	43.4573706134
19	279	1	1	0	33.996410224
19	282	1	0	1	45.2194154361
19	287	1	0	1	51.9203837877
19	303	28	0	28	16.2068022507
19	304	4	0	4	5.30305836924
19	307	6	1	5	17.0155698818
19	309	2	0	2	9.64464134264
19	464	1	0	1	62.7124549512
19	471	2	0	2	63.3684872561
19	473	1	0	1	66.1090620322
19	503	1	0	1	87.737668729
20	0	34	1	33	19.5882178612
20	1	2334	0	2334	14.2339486957
20	2	9	1	8	11.0340046275
20	3	6	0	6	23.215812633
20	4	9	3	6	9.72730207701
20	5	86	1	85	8.19089272678
20	6	67	34	33	9.44596870523
20	7	37	4	33	15.1972910025
20	8	15	1	14	22.9492136043
20	9	6	0	6	20.9727412536
20	10	3	1	2	13.9598017298
20	11	11	3	8	17.6996411603
20	12	31	8	23	12.9073830909
20	13	54	46	8	17.5560706158
20	15	68	0	68	12.3666804872
20	16	1	0	1	23.8384930103
20	17	57	3	54	7.08178907362
20	18	1	0	1	21.2477042755
20	19	1	0	1	22.3070936869
20	21	185	3	182	5.18134651662
20	22	7	2	5	16.3493297234
20	23	189	16	173	5.38899035546
20	24	80	16	64	7.01875658537
20	25	14	0	14	15.389737546
20	26	24	2	22	8.4392131844
20	27	92	0	92	6.15033248243
20	28	33	0	33	18.3194448393
20	29	99	4	95	10.0589834524
20	30	3	0	3	17.3704563248
20	31	1	0	1	26.1948394329
20	32	7	0	7	29.6240599647
20	33	6	1	5	18.4536732144
20	34	8	1	7	23.1847632181
20	35	36	0	36	15.339561886
20	36	49	0	49	26.9176224562
20	37	5	0	5	13.0368053846
20	38	1	0	1	23.1708737422
20	39	8	1	7	28.6149194058
20	41	4	0	4	21.7897201827
20	42	2	0	2	26.9617607373
20	43	2	0	2	36.1136650051
20	46	30	0	30	18.0178721877
20	47	3	0	3	37.6626481451
20	48	10	0	10	29.8089824345
20	49	6	0	6	13.8815436532
20	50	36	25	11	19.9873732601
20	51	1	0	1	18.0005373835
20	52	1	0	1	31.3319650852
20	53	14	3	11	24.0857849187
20	55	1	0	1	25.1375982672
20	56	3	0	3	17.5848133303
20	57	1	0	1	37.2929253859
20	58	2	0	2	23.7519060386
20	59	5	2	3	39.8466893317
20	60	5	0	5	23.565587497
20	61	0	0	0	30.2693302462
20	62	1	0	1	35.571163858
20	63	4	0	4	34.4947960467
20	64	7	0	7	16.9718765898
20	65	45	11	34	26.2197134785
20	66	1	0	1	13.9947505712
20	67	2	0	2	21.8100274402
20	68	6	0	6	26.758593648
20	70	4	0	4	51.6270102291
20	71	4	0	4	50.619385732
20	72	1	0	1	47.967575998
20	73	81	38	43	44.9908248219
20	74	12	1	11	48.8587738671
20	75	11	4	7	44.7113715068
20	76	5	0	5	52.3632668197
20	78	11	0	11	50.3386516603
20	79	4	0	4	45.448470957
20	81	3	0	3	48.2496600358
20	82	2	0	2	50.2728073371
20	83	3	0	3	47.1499213634
20	84	15	0	15	45.9409764649
20	85	4	2	2	54.1122726136
20	86	3	0	3	52.7050114633
20	87	15	0	15	46.6098423677
20	88	4	1	3	48.2672674752
20	89	3	0	3	46.486515615
20	92	2	0	2	50.9859753614
20	95	6	1	5	37.4933388186
20	96	1	0	1	63.6787716812
20	99	1	0	1	35.060644612
20	102	4	0	4	34.6394099472
20	103	32	0	32	40.4779004469
20	104	1	0	1	37.7093607365
20	112	13	0	13	37.6952957707
20	113	31	0	31	43.3186315304
20	114	2	1	1	32.0268581939
20	118	1	0	1	56.7666195882
20	119	2	0	2	58.7377288214
20	120	2	0	2	42.9852515269
20	122	1	0	1	57.2845259074
20	124	1	0	1	35.6868321706
20	125	1	0	1	31.1254442903
20	129	1	0	1	30.7447773848
20	130	1	0	1	50.2513319201
20	131	1	0	1	44.2800674409
20	134	1	0	1	38.6985919284
20	140	2	0	2	40.7571908578
20	142	23	0	23	42.496436117
20	151	1	0	1	39.4191243127
20	154	1	0	1	54.9150709068
20	155	1	0	1	66.7538365101
20	164	1	0	1	58.4058915787
20	166	1	0	1	75.3804311616
20	169	1	0	1	68.6608664915
20	171	0	0	0	62.0451253337
20	177	0	0	0	65.1751634647
20	183	4	0	4	95.0673596599
20	190	1	0	1	88.7866020976
20	198	0	0	0	139.245154227
20	208	3	0	3	105.179311803
20	214	1	0	1	99.3938381418
20	220	2	0	2	115.40144462
20	230	1	0	1	114.199884632
20	232	0	0	0	96.0468927507
20	254	1	0	1	57.6207874537
20	258	1	0	1	36.6281169758
20	259	1	0	1	54.1605411997
20	264	2	0	2	43.4772330388
20	270	1	0	1	54.2180110332
20	272	0	0	0	80.0174430071
20	275	2	0	2	62.160663697
20	277	25	1	24	63.0402697819
20	280	1	0	1	68.8485046454
20	281	1	0	1	61.9347504719
20	282	2	1	1	66.5544821048
20	303	24	7	17	24.1483479348
20	305	3	0	3	46.068703953
20	306	1	0	1	32.3551898748
20	307	9	1	8	34.4988335774
20	309	3	0	3	29.5581917231
20	310	0	0	0	88.985090012
20	319	1	0	1	93.4631220616
20	380	1	0	1	83.2528776053
20	392	0	0	0	89.6289044211
20	408	1	0	1	99.1008298752
20	415	1	0	1	91.3431515418
20	464	2	0	2	50.3396040117
20	465	0	0	0	69.8591546548
20	466	2	0	2	71.4173797116
20	469	4	1	3	62.0405965419
20	471	1	0	1	49.1272418821
20	472	3	1	2	51.0475498182
20	475	2	1	1	65.9342317585
20	476	1	0	1	40.7482441971
20	478	0	0	0	78.1821620663
20	481	1	0	1	68.8603632667
20	482	1	0	1	74.3376389868
20	484	0	0	0	50.2841109987
20	494	2	0	2	64.9713172137
20	495	1	0	1	79.0761200742
20	499	1	0	1	77.2686435109
20	502	1	0	1	86.6709869295
20	504	1	0	1	69.3254778966
20	573	0	0	0	90.8371806144
21	0	61	17	44	17.1333892831
21	1	5078	1531	3547	9.18523010039
21	2	16	0	16	10.981921884
21	3	9	1	8	21.2016574376
21	4	14	1	13	8.22106962853
21	5	299	15	284	5.07272037987
21	6	118	48	70	11.5413117476
21	7	77	14	63	13.111152471
21	8	12	0	12	20.8092805761
21	9	8	3	5	17.8103841364
21	10	6	1	5	13.1458959614
21	11	25	4	21	15.2180635743
21	12	72	17	55	8.95172368615
21	13	69	0	69	16.2477481339
21	14	2	0	2	15.20326322
21	15	88	1	87	10.5008512215
21	16	9	0	9	21.2032220587
21	17	43	1	42	9.80607653238
21	18	10	0	10	19.9079924144
21	19	5	2	3	19.5211999812
21	20	109	24	85	5.18134651662
21	22	26	10	16	11.5931545514
21	23	267	164	103	3.90312725718
21	24	165	60	105	6.43884364313
21	25	18	2	16	15.7953300497
21	26	18	4	14	13.2856967287
21	27	18	4	14	11.2757797717
21	28	95	2	93	13.6076517983
21	29	44	14	30	14.6359857892
21	30	4	1	3	20.2863402214
21	32	8	0	8	26.3635955977
21	33	9	1	8	18.746464264
21	34	2	0	2	26.6728949407
21	35	30	21	9	16.8596861425
21	36	73	0	73	26.5169733641
21	37	5	3	2	16.621418864
21	38	3	0	3	25.3754324056
21	39	10	0	10	26.2065984122
21	41	9	3	6	22.5411368997
21	42	10	1	9	25.340488301
21	43	2	0	2	40.8954630396
21	46	18	0	18	22.6121596708
21	47	3	1	2	42.8027154029
21	48	12	0	12	34.9310380854
21	49	9	3	6	18.6254855615
21	50	28	0	28	24.8983551805
21	51	4	0	4	22.3897336913
21	53	25	0	25	26.4374162672
21	54	1	0	1	30.8528383325
21	55	2	0	2	30.2881948643
21	56	5	1	4	22.7061880496
21	57	3	0	3	42.3585335095
21	58	1	0	1	27.7959487137
21	59	27	2	25	44.9975251763
21	60	6	1	5	28.5852612516
21	61	3	0	3	35.0698978589
21	63	1	0	1	39.5742174046
21	64	1	0	1	20.6596101982
21	65	32	1	31	30.8867247668
21	66	3	1	2	19.1414930606
21	67	4	2	2	26.6084526853
21	68	3	0	3	31.4138183793
21	69	1	0	1	40.2496365594
21	70	7	0	7	50.7014196713
21	71	3	0	3	50.7497711013
21	72	0	0	0	46.9025720373
21	73	130	45	85	44.4964641364
21	74	13	0	13	48.6267472671
21	75	23	6	17	44.4948316865
21	76	6	1	5	51.6965993744
21	78	11	3	8	50.0095026653
21	79	0	0	0	44.5075560312
21	81	8	0	8	47.3963284607
21	82	3	2	1	49.6956611337
21	83	5	4	1	46.6730439098
21	84	10	2	8	45.5652291699
21	85	2	0	2	53.7605672142
21	86	3	0	3	52.7622478217
21	87	11	0	11	46.6206967793
21	88	3	0	3	48.396941464
21	89	3	1	2	44.6698053024
21	92	5	0	5	49.5750062561
21	95	8	0	8	36.717641074
21	96	1	0	1	62.770448336
21	100	2	0	2	30.9051778905
21	102	8	1	7	32.524227709
21	103	31	2	29	40.4665986793
21	104	1	0	1	36.2991579989
21	106	1	0	1	40.6202800782
21	107	1	0	1	54.8561273002
21	108	1	0	1	63.1069468707
21	109	1	0	1	56.1423813893
21	110	5	0	5	38.1697446965
21	112	10	0	10	37.5133787049
21	113	50	0	50	43.7287400658
21	117	1	0	1	46.6491084234
21	119	1	0	1	58.5666286766
21	120	2	0	2	41.8209111158
21	124	1	0	1	39.4455529695
21	131	5	0	5	48.852480639
21	140	1	0	1	41.8586252058
21	142	27	2	25	44.6830531073
21	160	0	0	0	58.7384979293
21	177	0	0	0	66.1762219753
21	183	4	0	4	89.978730852
21	186	1	0	1	90.5265961251
21	188	1	0	1	96.9811085828
21	191	1	0	1	117.880637341
21	193	0	0	0	109.444951136
21	196	1	0	1	123.4962141
21	208	0	0	0	101.165146655
21	212	1	0	1	88.2777275955
21	213	1	0	1	104.999496015
21	217	1	0	1	109.779546392
21	220	1	0	1	110.337319101
21	225	1	0	1	98.6772580569
21	242	0	0	0	128.455380755
21	245	4	0	4	46.9616847336
21	250	0	0	0	51.4124025291
21	254	1	0	1	54.4341966925
21	258	1	0	1	32.9997535535
21	262	1	0	1	53.7027248508
21	264	4	0	4	39.5645007378
21	270	1	0	1	49.2697911681
21	272	1	0	1	75.6361159119
21	275	1	0	1	57.364296761
21	276	1	0	1	68.5104451
21	277	17	3	14	58.5328831619
21	279	1	0	1	48.8149327318
21	280	1	0	1	64.1549369009
21	281	0	0	0	57.906269022
21	282	3	0	3	62.5390414814
21	303	85	27	58	19.0894149886
21	304	3	0	3	19.1722519795
21	305	6	0	6	41.6587926258
21	306	1	0	1	27.385358716
21	307	14	0	14	29.9727643493
21	308	3	0	3	33.8921163426
21	309	10	2	8	25.6384946982
21	345	1	0	1	105.786610611
21	349	1	0	1	91.3538576423
21	408	2	0	2	103.432144765
21	464	1	0	1	55.3674565303
21	465	0	0	0	74.6570549013
21	466	0	0	0	76.40197071
21	469	6	1	5	66.7784453945
21	470	1	1	0	59.2319608331
21	471	6	2	4	54.2621101309
21	475	0	0	0	70.0619212162
21	485	1	0	1	86.3999369211
21	487	2	0	2	62.0551667128
21	489	0	0	0	69.5324264912
21	491	1	0	1	67.3534788197
21	493	0	0	0	87.7492982508
21	494	1	0	1	69.5054887973
21	503	1	0	1	86.4593389597
21	505	1	0	1	88.0171656925
21	573	0	0	0	92.992475679
22	0	34	6	28	21.8471070793
22	1	3838	1430	2408	8.13761551586
22	2	6	0	6	20.5499553942
22	3	6	0	6	26.1074765208
22	4	5	0	5	17.063620822
22	5	200	45	155	8.85214602083
22	6	28	6	22	17.4980698391
22	7	28	5	23	19.5302993862
22	8	35	5	30	14.8313968134
22	9	8	1	7	20.6933300073
22	10	1	0	1	21.4423842295
22	11	78	0	78	10.1116488233
22	12	379	11	368	4.69776401903
22	13	23	1	22	23.2400961923
22	14	1	0	1	23.85495066
22	15	44	8	36	18.0718105111
22	16	1	0	1	24.7461456633
22	17	10	0	10	21.1878664693
22	18	5	0	5	26.2613425719
22	19	2	0	2	22.9987436223
22	20	12	5	7	16.3493297234
22	21	74	0	74	11.5931545514
22	23	45	22	23	14.6846059608
22	24	19	2	17	16.7538869308
22	25	14	1	13	17.1734909274
22	26	5	0	5	24.7496116313
22	27	5	3	2	21.8566370999
22	28	48	1	47	12.1175943616
22	29	6	0	6	23.7330248852
22	32	8	2	6	27.5296039274
22	33	10	2	8	27.5805163466
22	35	5	0	5	27.0892213447
22	36	48	2	46	33.7206534895
22	38	2	1	1	35.7860720411
22	39	10	0	10	29.6077662308
22	41	4	0	4	31.6003552422
22	42	6	0	6	30.5173131198
22	43	1	0	1	49.2551313722
22	46	7	0	7	31.0798763287
22	48	12	0	12	45.9956472727
22	49	4	1	3	30.1532688145
22	50	11	1	10	36.3341320257
22	51	2	0	2	33.9827361877
22	52	1	0	1	47.1362707055
22	53	7	1	6	29.6164332019
22	54	1	0	1	42.3537711516
22	56	1	0	1	32.8261137735
22	57	6	0	6	53.5687793886
22	58	2	0	2	34.6000861551
22	59	1	0	1	55.0037784611
22	60	2	1	1	39.895628481
22	64	3	1	2	27.3084319853
22	65	14	1	13	39.157255343
22	66	1	0	1	30.1868667698
22	67	5	0	5	35.4318117628
22	68	4	0	4	42.9849152689
22	69	2	0	2	51.7609483788
22	70	1	0	1	55.8447940074
22	71	2	0	2	57.7951415643
22	72	0	0	0	51.890549689
22	73	36	3	33	50.6392447992
22	74	1	0	1	55.1087855216
22	75	11	0	11	51.1241295921
22	76	1	0	1	57.3087140831
22	78	6	1	5	56.2836368697
22	79	2	0	2	49.821312054
22	81	5	1	4	52.7796557739
22	82	3	0	3	55.5291117505
22	83	2	0	2	52.7776760843
22	84	7	0	7	51.8842801544
22	85	1	0	1	59.901420832
22	87	3	0	3	53.5714964178
22	88	1	0	1	55.4977946961
22	92	0	0	0	53.7694463946
22	95	3	0	3	42.6681007621
22	96	1	0	1	67.6620705321
22	102	4	0	4	36.0220879836
22	103	12	1	11	47.5722765111
22	110	2	0	2	46.0853634019
22	112	11	0	11	44.4528133667
22	113	13	0	13	51.3995734648
22	115	1	0	1	57.9695429347
22	118	1	1	0	62.3668354534
22	129	1	0	1	40.8034208103
22	131	1	0	1	60.4427241539
22	138	1	0	1	40.817707597
22	142	5	0	5	54.6830283393
22	147	1	0	1	69.703879279
22	153	0	0	0	65.0551203844
22	156	1	0	1	72.4364151736
22	172	0	0	0	69.7842985711
22	182	1	0	1	86.019943471
22	183	1	0	1	81.323036885
22	191	1	0	1	110.640526966
22	199	1	0	1	108.790561586
22	208	0	0	0	97.4480738519
22	220	0	0	0	101.802507431
22	222	0	0	0	92.7684482464
22	223	0	0	0	97.8452990344
22	229	1	0	1	97.0789188428
22	245	2	0	2	47.7723952678
22	257	1	0	1	38.9530469321
22	258	1	0	1	32.363220565
22	264	1	0	1	37.5088376477
22	271	1	0	1	70.6229190758
22	277	13	0	13	53.4549190213
22	282	0	0	0	59.3184393181
22	283	0	0	0	34.1603554791
22	288	1	0	1	56.89572839
22	294	1	0	1	83.8756813721
22	303	72	25	47	13.0502006769
22	304	3	0	3	19.8572443638
22	305	5	1	4	37.5385396886
22	306	1	0	1	21.0386036856
22	307	9	1	8	26.0729926022
22	309	6	0	6	24.7620541479
22	314	0	0	0	93.8995541634
22	338	1	0	1	101.471345714
22	464	1	0	1	66.6459530524
22	465	0	0	0	86.1836130645
22	466	2	0	2	87.7477271026
22	469	3	0	3	78.3331074436
22	471	2	0	2	65.2347403652
22	476	1	0	1	57.073270251
22	477	0	0	0	79.1467162857
22	490	3	0	3	70.7555274337
22	495	0	0	0	95.4084098049
22	563	0	0	0	118.391599059
23	0	14	0	14	14.3482677784
23	1	1282	213	1069	10.1403811442
23	2	13	0	13	7.10925703178
23	3	0	0	0	18.1598569673
23	4	18	15	3	4.70286217137
23	5	22	10	12	8.97324778002
23	6	11	0	11	14.1407373804
23	7	18	2	16	10.0417230878
23	8	2	0	2	24.7121161825
23	9	1	0	1	15.5954594538
23	10	2	2	0	9.47659085059
23	11	4	1	3	19.1200644729
23	12	10	1	9	12.6697914723
23	13	25	1	24	12.8071755871
23	14	3	0	3	11.4062441011
23	15	42	0	42	7.25073655283
23	16	2	0	2	18.5683544829
23	17	38	3	35	6.57154830988
23	18	2	0	2	16.5140374
23	19	5	0	5	16.9938520132
23	20	58	2	56	5.38899035546
23	21	71	10	61	3.90312725718
23	22	4	0	4	14.6846059608
23	24	120	31	89	2.54317972179
23	25	1	0	1	19.1938979226
23	26	8	0	8	11.4928439418
23	27	39	7	32	11.0983026307
23	28	14	4	10	13.4906505069
23	29	27	15	12	15.4041970729
23	32	2	0	2	24.2488649761
23	33	5	2	3	14.8866411551
23	34	4	0	4	23.2904620417
23	35	17	0	17	12.9933217143
23	36	26	15	11	22.8288380981
23	37	3	0	3	13.4633403049
23	39	4	0	4	23.4313000663
23	41	2	1	1	18.6488448118
23	42	2	0	2	22.1090946211
23	43	1	0	1	41.2436560304
23	46	6	0	6	23.3137629778
23	48	5	0	5	33.3525701936
23	49	3	0	3	16.4466284163
23	50	11	1	10	22.8602637484
23	51	2	0	2	19.7056731086
23	52	0	0	0	32.6106627241
23	53	5	0	5	29.0560910132
23	55	0	0	0	29.6469216151
23	56	1	0	1	22.2838489427
23	59	3	0	3	44.2861754432
23	60	1	0	1	26.7345440449
23	62	1	0	1	40.9521117704
23	64	3	0	3	22.3286643886
23	65	12	0	12	31.4523623632
23	67	1	0	1	26.9705008534
23	68	2	0	2	28.9099223895
23	69	1	1	0	37.9092734361
23	70	1	0	1	47.2316953073
23	73	36	14	22	40.8756976607
23	74	1	0	1	44.9383522795
23	75	5	0	5	40.797632175
23	76	1	0	1	48.13830272
23	78	3	0	3	46.3483477972
23	79	1	1	0	41.0353275107
23	81	2	0	2	43.896457855
23	83	1	0	1	43.0499821471
23	84	5	0	5	41.9117552355
23	85	1	0	1	50.1093215191
23	86	1	0	1	49.0094330143
23	87	1	0	1	42.872247226
23	88	1	0	1	44.6252316212
23	92	2	0	2	46.3014567438
23	102	1	0	1	29.5835006467
23	103	13	1	12	36.715504529
23	104	1	0	1	33.0032750164
23	110	3	0	3	34.3304599654
23	112	4	0	4	33.7971326727
23	113	12	2	10	39.9024876784
23	114	1	0	1	28.1847794205
23	140	1	0	1	37.9615693975
23	142	11	0	11	40.8349689771
23	145	1	0	1	33.5893722749
23	147	1	0	1	55.1552416678
23	151	1	0	1	40.7129814498
23	164	1	0	1	54.9923730357
23	171	1	0	1	58.3623972957
23	177	1	0	1	62.2918959544
23	208	0	0	0	99.8116342825
23	245	1	0	1	44.5455945147
23	257	1	0	1	37.2955330115
23	258	1	0	1	31.2396010838
23	262	1	0	1	52.1827950719
23	270	1	0	1	49.4704778204
23	277	12	0	12	57.8495046292
23	282	0	0	0	61.1926598272
23	284	1	0	1	70.2381501387
23	290	1	0	1	67.9691725854
23	303	20	7	13	19.7982368166
23	304	2	0	2	17.6039109208
23	305	1	0	1	40.8443096599
23	307	8	1	7	29.3661605534
23	309	6	0	6	24.2034202206
23	316	1	0	1	76.3301844156
23	338	0	0	0	94.5325519445
23	375	0	0	0	103.438098197
23	464	1	0	1	53.3942974013
23	471	2	0	2	52.6609436568
23	475	1	0	1	66.9146025689
23	476	1	0	1	43.1856593862
23	495	1	0	1	81.4489707019
24	0	34	1	33	12.6449022615
24	1	1775	838	937	11.2496302132
24	2	42	16	26	4.57252108376
24	3	4	0	4	16.1973811711
24	4	82	43	39	2.76515814186
24	5	29	5	24	11.5114301674
24	6	14	1	13	16.2581708353
24	7	43	1	42	8.22053055785
24	8	2	0	2	27.246523391
24	9	4	1	3	14.3093361449
24	10	3	2	1	7.1012709812
24	11	4	0	4	21.6471230963
24	12	12	2	10	15.0790727736
24	13	53	13	40	10.5901451578
24	14	2	1	1	8.91124350689
24	15	87	31	56	5.39550534258
24	16	1	0	1	16.9079767225
24	17	84	29	55	5.23523906752
24	18	4	3	1	14.2980498239
24	19	7	3	4	15.4395515566
24	20	33	2	31	7.01875658537
24	21	68	12	56	6.43884364313
24	22	11	4	7	16.7538869308
24	23	168	7	161	2.54317972179
24	25	5	0	5	21.5900981797
24	26	15	0	15	11.183025069
24	27	13	2	11	11.9350717031
24	28	27	0	27	13.769040999
24	29	16	11	5	16.6102429154
24	30	3	1	2	14.6378745708
24	32	4	1	3	22.8986479156
24	33	5	2	3	12.3507547343
24	34	2	1	1	21.3406834184
24	35	63	14	49	10.5519418605
24	36	39	10	29	20.3830357029
24	37	7	2	5	11.848376336
24	38	1	0	1	19.1919373548
24	39	2	0	2	21.6181978176
24	41	2	0	2	16.1060666506
24	42	5	0	5	19.9776360381
24	46	9	2	7	24.3315641808
24	47	1	0	1	42.1871131549
24	48	9	1	8	32.7786380326
24	49	4	3	1	15.637047289
24	50	22	8	14	22.0447744373
24	51	2	0	2	18.4120895969
24	53	8	2	6	31.0659454791
24	54	1	0	1	25.9942521469
24	55	0	0	0	29.7508612589
24	57	1	0	1	39.7491490863
24	59	4	0	4	44.2533191126
24	60	3	1	2	26.0161997587
24	61	1	0	1	36.080925719
24	64	2	0	2	23.8980021008
24	65	13	1	12	32.3086995213
24	66	0	0	0	17.7354903246
24	68	5	0	5	27.6719145262
24	69	2	0	2	36.7487268829
24	70	3	0	3	44.8958908519
24	71	4	0	4	44.4775143707
24	73	42	7	35	38.4548037082
24	74	4	0	4	42.4780356932
24	75	11	2	9	38.3339342604
24	76	3	0	3	45.749826684
24	78	6	0	6	43.9024144521
24	81	4	0	4	41.5448225005
24	82	1	0	1	43.7013681286
24	83	2	0	2	40.6266913584
24	84	8	2	6	39.4717791808
24	85	3	1	2	47.6676309804
24	86	1	0	1	46.5148550143
24	87	1	0	1	40.3810199559
24	88	1	0	1	42.1221918268
24	92	1	0	1	44.0864729003
24	95	2	0	2	30.8033064207
24	96	2	0	2	56.9666902078
24	98	3	0	3	49.8135263811
24	99	3	0	3	29.6743805177
24	102	2	0	2	27.6208475676
24	103	11	1	10	34.2245444703
24	104	1	1	0	30.7926658335
24	107	1	1	0	48.4433188068
24	110	3	2	1	31.7990499814
24	112	5	1	4	31.3259309212
24	113	11	0	11	37.375653118
24	116	1	0	1	48.241904127
24	118	1	0	1	50.2986583736
24	119	1	0	1	52.4052840006
24	120	2	0	2	36.1516098246
24	121	1	0	1	40.4977623439
24	122	0	0	0	50.3359910713
24	124	1	0	1	34.1960567318
24	131	3	0	3	44.6941712397
24	137	1	0	1	46.8332119734
24	142	11	0	11	38.3931384399
24	145	2	0	2	31.2727953688
24	171	1	0	1	55.8688369019
24	183	1	0	1	90.8134292414
24	188	1	0	1	96.9816281492
24	208	1	0	1	98.7684209358
24	220	1	0	1	110.982521901
24	232	0	0	0	90.1279743271
24	254	1	0	1	50.763958591
24	262	2	0	2	51.0946917069
24	264	1	0	1	37.1111485186
24	277	10	0	10	57.2949224268
24	279	1	0	1	47.5960914055
24	293	1	0	1	74.0912420186
24	303	21	0	21	20.412664689
24	304	3	1	2	16.7473081674
24	305	5	0	5	40.2601671511
24	306	1	0	1	27.9879313901
24	307	9	0	9	28.9957529293
24	308	2	0	2	34.1676062036
24	309	3	0	3	23.3285093412
24	318	1	0	1	84.3640676069
24	326	1	0	1	81.7502509667
24	329	1	0	1	75.4504228618
24	350	1	0	1	73.0126215268
24	406	1	0	1	96.0378487164
24	464	1	0	1	52.4555980021
24	465	0	0	0	70.8747438351
24	469	2	0	2	62.8753462918
24	471	2	2	0	51.9891685392
24	476	3	0	3	41.9816046683
24	477	1	0	1	64.4942349709
24	479	1	0	1	46.326039992
24	488	1	0	1	66.3147237689
24	493	1	0	1	85.4402730554
24	495	0	0	0	80.1286499948
24	576	1	0	1	75.8736890055
25	0	14	0	14	32.8687288532
25	1	1594	243	1351	21.9040587481
25	2	4	0	4	26.0608806035
25	3	3	0	3	36.9876931068
25	4	4	2	2	23.8589946666
25	5	377	91	286	11.6802054988
25	6	218	46	172	6.74393580908
25	7	19	2	17	28.9064146632
25	8	177	22	155	11.1834629219
25	9	4	0	4	33.2245546784
25	10	2	0	2	28.6627963286
25	11	243	22	221	9.16499501334
25	12	100	18	82	12.7763352513
25	13	7	0	7	31.9643005064
25	15	23	6	17	26.2660287913
25	17	17	0	17	22.3973149398
25	18	3	0	3	35.65373494
25	19	2	0	2	35.113774864
25	20	22	0	22	15.389737546
25	21	117	37	80	15.7953300497
25	22	44	1	43	17.1734909274
25	23	40	0	40	19.1938979226
25	24	32	1	31	21.5900981797
25	26	6	0	6	21.0519319251
25	27	25	19	6	15.9319729707
25	28	26	1	25	26.9526697842
25	29	77	27	50	13.6874585772
25	30	3	1	2	32.142181122
25	31	2	0	2	41.5692018411
25	32	5	2	3	41.5113179764
25	33	4	1	3	33.718390791
25	34	3	1	2	37.085446909
25	35	12	1	11	30.7195659081
25	36	25	4	21	41.9692861949
25	37	3	0	3	27.404928194
25	39	6	0	6	41.8851082318
25	41	2	1	1	37.1629466454
25	42	2	0	2	41.1336356976
25	43	2	0	2	34.3189342005
25	44	1	0	1	21.1959204557
25	45	5	0	5	48.2575419774
25	46	19	0	19	17.8366614154
25	48	10	2	8	36.8133420502
25	49	8	5	3	25.710633691
25	50	7	0	7	30.0900784375
25	51	1	0	1	30.445590472
25	52	1	0	1	43.2931499921
25	53	269	75	194	12.4432722582
25	55	2	0	2	29.0707967003
25	56	1	0	1	22.3744565147
25	58	13	1	12	18.9090203289
25	59	7	0	7	42.3366680034
25	60	1	0	1	32.4261968511
25	61	1	0	1	29.2103852701
25	62	3	0	3	29.6148429347
25	63	1	0	1	35.9941018672
25	64	37	0	37	12.3751298452
25	65	33	1	32	24.6784612868
25	66	0	0	0	22.9908416669
25	67	5	0	5	22.1008212469
25	69	2	0	2	44.8296510495
25	70	0	0	0	66.4183130431
25	71	1	0	1	65.9309489229
25	73	33	3	30	60.0449018862
25	74	3	0	3	64.044157433
25	75	6	2	4	59.897008927
25	78	5	0	5	65.4830987185
25	79	1	0	1	60.2216876421
25	81	1	0	1	63.0885973594
25	84	2	0	2	61.0569703169
25	86	1	0	1	67.9983642909
25	87	2	0	2	61.8819416642
25	88	2	0	2	63.57613612
25	90	1	0	1	74.5687543423
25	92	1	0	1	65.368429423
25	95	1	0	1	52.3666047993
25	96	2	0	2	78.4922521673
25	102	2	0	2	48.2607522785
25	103	7	0	7	55.7331530776
25	109	2	0	2	71.8974437981
25	110	1	0	1	53.074585616
25	111	2	0	2	66.1058400547
25	112	1	0	1	52.8815687715
25	113	9	0	9	58.6810103193
25	116	1	0	1	69.8162883215
25	128	1	0	1	63.7975134048
25	131	1	0	1	54.5299057436
25	132	0	0	0	67.0504988777
25	135	1	0	1	71.0570785934
25	142	15	1	14	57.406174768
25	143	1	0	1	59.1290606016
25	183	1	0	1	97.7370539007
25	209	1	0	1	110.134611209
25	220	0	0	0	118.222706123
25	225	1	0	1	110.608610405
25	232	0	0	0	103.51184545
25	242	0	0	0	137.233388893
25	245	3	0	3	62.2328581596
25	257	1	0	1	54.0786095172
25	268	1	0	1	82.8996290116
25	274	1	0	1	67.4663125941
25	277	6	0	6	70.5489203524
25	281	0	0	0	71.359497751
25	282	1	0	1	75.9720397397
25	291	0	0	0	93.6375367827
25	293	1	0	1	91.0512274698
25	303	22	0	22	29.9538224919
25	304	1	0	1	33.9332256299
25	306	1	0	1	38.1587809369
25	307	4	0	4	42.6878153794
25	309	1	0	1	39.963896071
25	408	0	0	0	109.480309357
25	426	1	0	1	137.82689062
25	464	1	0	1	57.405232178
25	465	0	0	0	78.2890767387
25	488	0	0	0	66.81911824
25	491	1	0	1	68.3518608384
25	503	1	0	1	91.8346441228
25	573	1	0	1	105.581157758
26	0	15	2	13	22.5032422971
26	1	1130	17	1113	21.6016504911
26	2	32	6	26	12.4112714899
26	3	3	0	3	25.0695044253
26	4	25	1	24	13.5357226568
26	5	30	8	22	16.5630744351
26	6	24	0	24	14.3114112421
26	7	19	5	14	18.2382770152
26	8	1	0	1	30.3570159579
26	9	1	0	1	24.8171007319
26	10	9	2	7	15.4764035683
26	11	5	1	4	25.4858118639
26	12	5	0	5	21.3199329892
26	13	32	10	22	19.0442281293
26	14	3	1	2	15.691788291
26	15	80	31	49	15.7540477848
26	17	112	16	96	6.50918533025
26	18	5	0	5	22.2556925791
26	19	4	0	4	25.4505178208
26	20	57	2	55	8.4392131844
26	21	39	22	17	13.2856967287
26	22	1	0	1	24.7496116313
26	23	79	1	78	11.4928439418
26	24	76	1	75	11.183025069
26	25	2	1	1	21.0519319251
26	27	91	1	90	5.18397332484
26	28	19	1	18	24.8380820579
26	29	130	28	102	9.41883974994
26	30	16	8	8	11.6931110574
26	31	2	0	2	22.5058050723
26	32	3	0	3	33.0617035534
26	33	25	0	25	17.2583898167
26	34	12	1	11	16.0342667884
26	35	187	33	154	12.6841366101
26	36	49	0	49	25.854492176
26	37	35	1	34	6.81272411746
26	38	3	0	3	18.1108874072
26	39	4	0	4	30.6897366836
26	41	4	0	4	19.3402808931
26	42	4	0	4	27.8718738035
26	43	2	0	2	31.4170815889
26	44	2	0	2	27.6471527312
26	45	1	0	1	35.6056189266
26	46	35	4	31	15.2277920898
26	47	4	0	4	31.0226740825
26	48	21	4	17	21.8687151193
26	49	78	0	78	5.44933541208
26	50	130	0	130	11.6129903156
26	51	9	1	8	9.80021941836
26	52	5	1	4	23.1233749233
26	53	19	2	17	26.1545767182
26	54	6	2	4	18.9470220802
26	55	8	1	7	18.6458398234
26	56	18	10	8	11.8667454559
26	58	1	0	1	22.128222479
26	59	3	0	3	33.0752025427
26	60	17	0	17	15.3408569904
26	61	3	0	3	25.6876379406
26	62	2	0	2	33.0737097699
26	63	1	0	1	28.3740345871
26	64	9	2	7	17.1296120632
26	65	69	6	63	22.3764942571
26	66	20	2	18	6.56112024401
26	67	4	0	4	17.7327950785
26	68	18	3	15	18.3280198711
26	69	2	0	2	27.0117984189
26	70	1	0	1	50.3886333819
26	71	3	0	3	47.7061336607
26	73	37	5	32	43.2141726033
26	74	4	0	4	46.5600897518
26	75	4	0	4	42.4947857106
26	76	2	0	2	50.6870583822
26	78	3	0	3	48.1616759538
26	81	2	2	0	46.9708477238
26	82	3	1	2	48.4968137289
26	83	2	0	2	45.2868806658
26	84	8	3	5	43.9465242153
26	86	2	0	2	49.8643887839
26	87	5	0	5	43.9789726234
26	88	2	0	2	45.4075943232
26	89	2	1	1	46.8550390007
26	92	2	0	2	50.5646646392
26	95	1	0	1	36.4309153791
26	98	1	0	1	52.5825713288
26	100	1	0	1	32.3643787294
26	102	2	0	2	35.9139917251
26	103	8	1	7	38.0639891744
26	104	1	0	1	37.6812281205
26	109	1	0	1	56.1002641535
26	110	1	0	1	34.6454993411
26	112	5	1	4	35.6596821937
26	113	9	0	9	40.1450296942
26	114	1	0	1	30.1189131644
26	117	1	0	1	43.2106901326
26	118	1	0	1	54.5735851185
26	124	1	0	1	27.9094937613
26	127	1	0	1	40.0628773772
26	131	2	0	2	35.8587601462
26	133	3	1	2	27.6315607158
26	134	2	1	1	33.517401285
26	138	1	0	1	22.990633694
26	140	3	0	3	36.5794977669
26	142	16	0	16	36.6543197242
26	145	1	0	1	28.2451405686
26	183	2	0	2	101.950782242
26	208	0	0	0	109.071695579
26	209	1	0	1	105.918139609
26	213	0	0	0	113.488770225
26	220	1	0	1	122.147357545
26	222	0	0	0	113.757078552
26	241	1	0	1	146.53245848
26	242	0	0	0	139.758705271
26	245	1	0	1	51.9566668844
26	257	0	0	0	45.9087872071
26	261	1	0	1	43.3982288656
26	262	1	0	1	61.4385798958
26	264	1	0	1	47.6729003033
26	275	1	0	1	68.142638022
26	277	8	1	7	68.2759173268
26	282	1	0	1	70.6619999731
26	285	0	0	0	80.3857988556
26	303	17	0	17	31.281699161
26	304	2	1	1	27.6629073193
26	305	2	1	1	51.2488515778
26	307	6	0	6	40.1275385166
26	309	1	0	1	34.1486768122
26	464	2	0	2	42.1055646798
26	465	0	0	0	61.4355378373
26	466	1	0	1	63.118761739
26	469	3	1	2	53.6043304458
26	471	1	0	1	41.1926105168
26	472	1	0	1	42.6134764524
26	475	0	0	0	57.7164730576
26	477	1	0	1	54.4752548271
26	480	5	0	5	47.6340096258
26	491	1	0	1	54.1416568762
26	495	0	0	0	70.6588269389
26	528	1	0	1	123.74268658
26	573	0	0	0	84.6141250196
27	0	25	0	25	24.4265904538
27	1	2172	0	2172	20.3835760488
27	2	19	2	17	14.7722938931
27	3	5	2	3	27.5981475573
27	4	7	0	7	14.6688057675
27	5	90	15	75	13.1296667659
27	6	111	31	80	9.18995484958
27	7	44	0	44	19.9943686001
27	8	7	0	7	25.6212914077
27	9	5	0	5	26.243441451
27	10	4	0	4	17.9339765012
27	11	18	0	18	21.0381512651
27	12	18	0	18	17.8759451886
27	13	46	8	38	21.6361711448
27	14	2	0	2	18.7635658804
27	15	74	19	55	17.2325586365
27	16	1	0	1	28.6772532868
27	17	66	32	34	9.07453053585
27	18	4	0	4	25.1543595079
27	19	8	0	8	27.2927885974
27	20	190	54	136	6.15033248243
27	21	114	26	88	11.2757797717
27	22	15	8	7	21.8566370999
27	23	156	5	151	11.0983026307
27	24	72	2	70	11.9350717031
27	25	21	0	21	15.9319729707
27	26	115	35	80	5.18397332484
27	28	36	0	36	24.4061660441
27	29	608	359	249	4.99466229854
27	30	6	0	6	16.751578406
27	31	0	0	0	27.2284424741
27	32	5	0	5	34.8114280426
27	33	4	1	3	21.0178242603
27	34	5	0	5	21.1882226982
27	35	74	59	15	16.8653601988
27	36	56	14	42	29.7177953413
27	37	7	0	7	11.8753406614
27	38	4	1	3	23.1228547614
27	39	1	0	1	33.1719231321
27	41	4	1	3	23.6259361608
27	42	5	1	4	30.9014256796
27	43	8	0	8	30.1456447988
27	45	1	0	1	37.4102719423
27	46	80	10	70	12.4023019688
27	47	6	2	4	31.5277245753
27	48	29	5	24	24.1596572917
27	49	19	0	19	9.90275656201
27	50	44	19	25	15.1463061235
27	51	4	0	4	14.586302928
27	52	1	0	1	27.7038144123
27	53	66	0	66	21.3629503848
27	55	2	0	2	19.0131472843
27	56	13	0	13	11.4377388191
27	57	3	0	3	31.7921286387
27	58	12	0	12	18.7510050671
27	59	5	0	5	33.7220294281
27	60	16	1	15	18.3165972098
27	61	1	0	1	24.2998743363
27	62	8	0	8	30.3082743369
27	63	1	0	1	28.3451478328
27	64	25	1	24	12.7959525985
27	65	116	22	94	20.4045011722
27	66	12	2	10	8.43166591911
27	67	10	0	10	15.8836564253
27	68	13	0	13	22.3832637696
27	69	1	0	1	30.5749476018
27	70	4	0	4	54.4715500935
27	71	2	0	2	52.3387214917
27	73	56	2	54	47.4666585053
27	74	4	0	4	51.0007340179
27	75	14	0	14	46.8943308823
27	76	3	2	1	54.9298911382
27	78	8	2	6	52.5676019211
27	79	6	0	6	48.3810794122
27	81	7	0	7	51.0573498823
27	82	6	0	6	52.7679233237
27	83	3	0	3	49.5773543076
27	84	11	0	11	48.2771543904
27	85	3	0	3	56.32360838
27	86	4	0	4	54.4814083521
27	87	2	0	2	48.516015873
27	88	3	0	3	50.0180270008
27	89	3	0	3	50.2653441857
27	92	1	0	1	54.3275135584
27	95	3	1	2	40.3855184466
27	96	0	0	0	66.4023154194
27	99	2	0	2	35.9988786763
27	100	2	0	2	35.801249922
27	102	3	1	2	38.8424446053
27	103	15	1	14	42.509167424
27	106	1	0	1	47.3740458347
27	110	2	0	2	39.2748713672
27	112	12	0	12	39.9661930077
27	113	26	7	19	44.8284850931
27	114	6	0	6	34.3432239734
27	118	1	0	1	59.0019141773
27	120	1	0	1	46.1757424326
27	135	1	0	1	55.1354918275
27	136	1	0	1	37.6120099512
27	137	0	0	0	52.186514491
27	138	1	0	1	28.0882007206
27	142	26	1	25	41.8254245255
27	143	1	0	1	43.2097576792
27	147	1	0	1	53.0912372568
27	148	1	0	1	29.0104094048
27	151	4	0	4	35.6007871045
27	166	1	0	1	77.1957866392
27	168	1	0	1	60.5471329469
27	177	1	0	1	65.7328936986
27	179	0	0	0	75.3515970094
27	183	2	0	2	101.21702399
27	187	0	0	0	111.945790463
27	206	1	0	1	102.177775607
27	208	1	0	1	110.699631559
27	212	1	0	1	98.0063777395
27	220	1	0	1	121.551548645
27	236	1	0	1	95.3443875622
27	240	1	0	1	142.580335452
27	242	1	0	1	139.550369897
27	244	1	0	1	141.84467272
27	245	1	0	1	54.5316808772
27	251	1	0	1	66.8296102453
27	257	1	0	1	47.8464930482
27	266	1	0	1	77.4661491689
27	268	2	0	2	85.1973562183
27	270	1	0	1	60.3473843733
27	272	2	0	2	85.8284039906
27	275	1	0	1	68.2280143352
27	277	18	1	17	68.9470807011
27	281	1	0	1	67.5162026962
27	282	0	0	0	72.1180708489
27	284	0	0	0	81.2214818934
27	294	1	0	1	93.3760339731
27	303	27	9	18	30.2985858621
27	304	4	0	4	28.5875645183
27	305	6	0	6	51.937765976
27	307	11	0	11	40.458119598
27	309	3	0	3	35.1890600371
27	338	1	0	1	102.080636591
27	408	0	0	0	94.8936671454
27	415	1	0	1	87.5129971591
27	464	1	0	1	44.898321253
27	466	0	0	0	66.040689594
27	469	1	0	1	57.196987022
27	471	1	0	1	43.3784003346
27	472	1	0	1	46.2022072358
27	474	1	0	1	67.3704327633
27	476	2	0	2	35.8552054655
27	479	1	0	1	38.4461768895
27	482	2	1	1	68.3076167182
27	484	1	0	1	44.160791218
27	489	1	0	1	58.2853628837
27	492	1	0	1	64.4711030131
27	494	1	0	1	60.4993094814
27	495	1	0	1	74.0419247943
27	573	0	0	0	89.794880414
28	0	43	0	43	11.1016501416
28	1	2820	29	2791	5.0532639727
28	2	5	2	3	14.9908905137
28	3	4	1	3	14.9742363744
28	4	2	1	1	12.0243881444
28	5	11	1	10	15.536778373
28	6	1	0	1	24.5613988332
28	7	43	0	43	10.7708757557
28	8	1	0	1	26.9024172689
28	9	10	8	2	9.07595934252
28	10	1	0	1	14.0295385168
28	11	4	0	4	21.8519486285
28	12	7	0	7	14.762825066
28	13	40	0	40	14.0487201132
28	14	4	0	4	16.2597261234
28	15	44	15	29	11.0847349346
28	16	1	0	1	13.0730803059
28	17	15	3	12	18.9587047961
28	18	3	1	2	16.0608973144
28	19	9	0	9	11.4240834007
28	20	7	2	5	18.3194448393
28	21	39	1	38	13.6076517983
28	22	6	0	6	12.1175943616
28	23	19	1	18	13.4906505069
28	24	22	3	19	13.769040999
28	25	1	0	1	26.9526697842
28	27	3	0	3	24.4061660441
28	29	3	0	3	28.2044457118
28	31	2	1	1	28.496209358
28	32	10	0	10	15.4251260562
28	33	34	25	9	19.5569154975
28	34	1	0	1	33.443101684
28	35	12	3	9	21.0903891758
28	36	41	8	33	23.5244909097
28	37	1	0	1	25.0953866044
28	39	20	6	14	17.698122576
28	41	1	0	1	23.3731572061
28	42	6	0	6	19.2360657722
28	43	1	0	1	54.4138660811
28	46	5	0	5	36.194133777
28	47	1	0	1	55.653546381
28	48	4	0	4	46.5469711237
28	50	14	1	13	35.7929494615
28	52	1	0	1	43.7472175601
28	53	4	1	3	38.8948170797
28	55	1	0	1	43.1366122414
28	60	2	0	2	39.7788458122
28	64	1	0	1	34.1286632484
28	65	11	1	10	44.4552878857
28	66	0	0	0	31.3235569917
28	70	1	0	1	44.0535736951
28	71	1	0	1	46.7951468476
28	72	1	0	1	40.0849245483
28	73	63	2	61	39.2729436128
28	74	8	0	8	43.8432760843
28	75	9	2	7	39.9908477803
28	76	1	0	1	45.656103552
28	78	5	0	5	44.9061701201
28	79	3	0	3	38.136507331
28	81	6	0	6	41.0884512597
28	82	6	0	6	43.9742114068
28	83	2	0	2	41.3657317934
28	84	3	1	2	40.5827479295
28	85	1	0	1	48.4298074602
28	86	1	0	1	48.5233870794
28	87	6	1	5	42.5774374204
28	88	2	0	2	44.5623117072
28	89	4	0	4	36.0929315234
28	90	2	0	2	52.7616138755
28	92	1	0	1	41.7717072693
28	95	4	3	1	31.3534195625
28	96	0	0	0	55.7465951341
28	102	3	0	3	24.025935127
28	103	15	1	14	36.7846022644
28	105	1	1	0	30.8636058478
28	112	13	0	13	33.6362524463
28	113	31	1	30	40.9116037702
28	117	1	0	1	43.4163978752
28	119	1	0	1	53.5102940499
28	129	4	0	4	31.8521484411
28	134	1	0	1	41.5842328959
28	140	1	0	1	40.9955491075
28	142	11	2	9	46.533357
28	145	0	0	0	41.0434647816
28	148	4	0	4	37.7064689165
28	155	1	1	0	61.3585365686
28	164	1	0	1	55.2109321006
28	171	1	0	1	57.5377741383
28	177	1	0	1	63.9148724171
28	181	0	0	0	69.2775569276
28	182	1	0	1	82.7775896076
28	183	3	0	3	77.1198167089
28	193	1	0	1	96.0367473684
28	208	1	0	1	87.864583495
28	209	1	0	1	83.979724839
28	212	1	0	1	74.8945559555
28	220	2	0	2	97.3510249595
28	229	1	0	1	89.0854715762
28	237	1	0	1	75.3411690766
28	244	1	0	1	117.438750206
28	245	3	0	3	35.8542393797
28	252	1	0	1	45.2139644178
28	256	2	0	2	25.2003950705
28	257	4	0	4	27.2877786697
28	258	3	1	2	20.7280720451
28	259	1	0	1	36.7486387707
28	260	2	0	2	29.4973315028
28	261	1	0	1	20.9576478604
28	262	1	0	1	40.7010463129
28	264	2	0	2	26.6162212291
28	270	4	2	2	35.9851332138
28	271	1	0	1	63.3926781607
28	274	2	0	2	41.1061135674
28	275	1	0	1	43.8416955765
28	277	32	0	32	44.9359502454
28	279	1	0	1	35.2244551004
28	281	3	1	2	44.67093309
28	282	0	0	0	49.3030317976
28	283	2	1	1	26.7834146189
28	284	1	0	1	58.0517721169
28	285	0	0	0	56.817521473
28	293	1	0	1	64.1629641466
28	294	1	0	1	72.8128523643
28	295	1	0	1	60.3250307046
28	303	433	265	168	6.86366284687
28	304	127	0	127	7.74079422065
28	305	8	0	8	28.1191831779
28	306	7	2	5	14.2563043934
28	307	113	5	108	16.3921438472
28	308	4	1	3	20.5761419763
28	309	42	17	25	13.0695795296
28	464	2	0	2	66.0962249482
28	466	0	0	0	86.6947511409
28	469	3	0	3	75.9587537351
28	472	3	0	3	65.2339350028
28	474	1	0	1	89.4756439054
28	488	1	0	1	80.0813597791
28	491	1	0	1	78.3101720249
28	573	0	0	0	93.335864916
29	0	8	2	6	29.220165704
29	1	943	0	943	23.7847584284
29	2	3	0	3	19.7213804827
29	3	2	0	2	32.5089078082
29	4	5	2	3	19.3732599247
29	5	56	2	54	14.9189106938
29	6	123	6	117	7.59390302355
29	7	16	1	15	24.7824085094
29	8	5	0	5	24.4403791604
29	10	2	0	2	22.8743947044
29	11	20	1	19	20.668815255
29	12	15	1	14	19.2887132452
29	13	19	1	18	26.5775599277
29	14	1	0	1	23.7547083566
29	15	28	1	27	21.9833258612
29	16	1	0	1	33.4820674047
29	17	36	5	31	14.0691808813
29	18	3	1	2	30.1231501502
29	20	84	4	80	10.0589834524
29	21	50	7	43	14.6359857892
29	22	9	1	8	23.7330248852
29	23	75	1	74	15.4041970729
29	24	46	1	45	16.6102429154
29	25	36	8	28	13.6874585772
29	26	67	7	60	9.41883974994
29	27	216	141	75	4.99466229854
29	28	11	1	10	28.2044457118
29	30	3	1	2	21.0764767998
29	33	6	1	5	25.9891578537
29	34	5	0	5	24.7010423565
29	35	20	2	18	21.7466946304
29	36	28	1	27	34.6874815353
29	37	1	1	0	16.2141454008
29	39	2	1	1	38.0582690116
29	40	1	0	1	43.0936404809
29	41	5	2	3	28.4971058863
29	42	4	0	4	35.8750411934
29	43	4	0	4	26.2676722317
29	45	1	0	1	35.9732995329
29	46	184	24	160	7.99206102684
29	47	4	0	4	29.011069467
29	48	21	0	21	23.5727472334
29	49	16	1	15	12.746248724
29	50	33	0	33	16.4432242093
29	51	5	1	4	17.440894562
29	53	132	6	126	16.7421241651
29	54	1	0	1	26.5381755861
29	55	4	2	2	16.8518789053
29	56	25	0	25	9.38053070015
29	58	35	7	28	13.8709957766
29	59	6	0	6	31.2833072792
29	60	8	1	7	18.767061739
29	61	6	1	5	20.4539971413
29	62	5	0	5	25.581287116
29	63	6	0	6	25.4511496639
29	64	91	15	76	7.83712299254
29	65	171	19	152	16.2536464302
29	66	10	4	6	9.36768850216
29	67	18	0	18	12.0108937014
29	68	7	2	5	23.8656656135
29	70	1	0	1	59.4189662289
29	71	2	0	2	57.0791639583
29	73	27	2	25	52.3703230325
29	74	1	0	1	55.8393581021
29	76	3	0	3	59.8391583556
29	78	9	0	9	57.420996329
29	79	1	0	1	53.3423228946
29	81	2	0	2	56.002970669
29	82	1	0	1	57.6681711814
29	83	1	0	1	54.4704248631
29	84	3	0	3	53.1565382917
29	85	1	0	1	61.1684484955
29	87	1	0	1	53.3089164513
29	88	2	0	2	54.7712025548
29	89	5	1	4	55.2571436576
29	95	1	0	1	45.3496290393
29	98	1	0	1	61.9891244132
29	99	1	0	1	40.5790084721
29	102	2	0	2	43.795917532
29	103	3	0	3	47.3420963089
29	107	1	0	1	59.4130289625
29	109	1	0	1	65.1064713908
29	110	1	0	1	44.0126952114
29	111	1	0	1	61.1012884401
29	112	4	1	3	44.8492333184
29	113	14	1	13	49.5338765943
29	124	1	0	1	35.4464670285
29	131	2	0	2	40.8529180379
29	142	13	2	11	45.7237682199
29	145	1	0	1	37.1385999605
29	147	1	0	1	55.8688273162
29	164	1	0	1	64.3487106056
29	177	0	0	0	70.0690873958
29	183	2	0	2	104.358095884
29	184	1	0	1	96.54975767
29	208	1	0	1	115.214933372
29	220	1	0	1	124.766849421
29	229	0	0	0	117.217061485
29	242	0	0	0	143.023488925
29	245	1	0	1	59.4042487692
29	252	1	0	1	71.02223961
29	257	2	0	2	52.551850353
29	262	0	0	0	67.5767336654
29	265	1	0	1	69.8938400493
29	275	2	0	2	71.9999360433
29	277	7	0	7	73.0538622301
29	282	1	1	0	76.5968359687
29	303	9	0	9	33.6303307884
29	307	2	1	1	44.495158694
29	308	1	0	1	48.5123694739
29	309	2	0	2	39.605397253
29	408	1	0	1	95.8432162239
29	464	1	0	1	44.3801918756
29	469	4	0	4	57.5194863257
29	470	1	0	1	51.1643784829
29	471	4	1	3	42.2339494429
29	472	1	0	1	46.6109546543
29	476	3	0	3	36.328780031
29	477	1	0	1	57.1385377836
29	482	1	0	1	66.2020969997
29	563	0	0	0	108.846030711
30	0	16	9	7	19.3040446062
30	1	461	179	282	25.4822292127
30	2	29	0	29	11.6998953088
30	3	2	0	2	19.8452972821
30	4	9	2	7	15.0376677585
30	5	3	0	3	24.9904733085
30	6	1	0	1	25.5193067226
30	7	20	1	19	16.5134666936
30	9	8	0	8	22.4321308956
30	10	8	0	8	12.9272030788
30	11	4	0	4	34.9658529848
30	12	4	0	4	29.2377788509
30	13	44	33	11	14.8824633315
30	14	7	1	6	11.2748839451
30	15	100	29	71	15.5482529749
30	16	2	0	2	22.3830974611
30	17	24	18	6	10.5598631424
30	18	13	0	13	16.4883294424
30	20	6	0	6	17.3704563248
30	21	9	0	9	20.2863402214
30	23	6	0	6	16.7233164699
30	24	20	1	19	14.6378745708
30	26	9	2	7	11.6931110574
30	27	4	1	3	16.751578406
30	28	12	0	12	26.6310851541
30	29	7	0	7	21.0764767998
30	31	28	1	27	11.3140800933
30	32	3	1	2	28.8950305423
30	33	85	5	80	9.9973386888
30	34	233	106	127	6.84001019695
30	35	702	30	672	5.87691650532
30	36	164	63	101	16.8357641471
30	37	65	25	40	4.88461048408
30	38	51	44	7	6.43071425398
30	39	8	0	8	24.9214637896
30	40	1	0	1	30.3573111218
30	41	55	1	54	9.74671671
30	43	2	0	2	39.1735298674
30	45	1	0	1	37.214809245
30	46	2	0	2	25.8200811771
30	47	1	0	1	35.7576279471
30	48	11	0	11	23.8617822377
30	49	19	9	10	9.93506686979
30	50	65	10	55	13.5280160567
30	51	21	11	10	8.07334616982
30	52	5	1	4	17.1898327537
30	53	1	0	1	37.8169920408
30	54	22	0	22	11.9797549751
30	55	3	0	3	25.0316615231
30	56	2	0	2	20.6657535488
30	59	5	1	4	37.379529513
30	60	7	1	6	17.1992336577
30	64	1	0	1	28.6438308459
30	65	11	0	11	31.6184718436
30	66	2	0	2	14.7429907561
30	67	2	0	2	27.2015093474
30	68	11	2	9	15.7689365965
30	69	1	0	1	24.608155182
30	70	4	0	4	40.05968715
30	72	1	0	1	37.0278639888
30	73	44	0	44	32.6314196261
30	74	8	5	3	35.5829288777
30	75	3	1	2	31.6305818015
30	78	1	0	1	37.2351052869
30	79	1	0	1	34.323726601
30	81	5	0	5	36.6762308928
30	82	2	0	2	37.8187423931
30	83	3	0	3	34.603884841
30	84	11	0	11	33.1998799204
30	85	1	0	1	40.899439406
30	86	1	0	1	38.5732670709
30	88	1	0	1	34.1470448741
30	89	2	0	2	38.0283372192
30	90	0	0	0	46.8137951079
30	92	4	0	4	40.894186957
30	95	3	0	3	26.6369827851
30	96	1	0	1	51.5570270598
30	99	2	0	2	19.6291169663
30	102	5	1	4	28.6395810376
30	103	10	0	10	27.1628159237
30	104	1	0	1	28.8325287205
30	107	1	0	1	38.3464093291
30	110	2	0	2	23.4315635666
30	111	3	0	3	43.7563524248
30	112	10	0	10	25.0867900378
30	113	16	1	15	28.796391386
30	114	2	0	2	19.8905442673
30	116	1	0	1	42.5208218991
30	119	1	0	1	44.9304369411
30	122	0	0	0	47.5308380085
30	124	10	4	6	19.6250259682
30	125	3	0	3	14.3071205911
30	129	4	0	4	15.6301330626
30	132	1	0	1	40.9976611972
30	133	3	0	3	15.9559904937
30	134	3	0	3	21.8681317112
30	136	1	0	1	22.2169739538
30	137	1	0	1	35.440327063
30	138	3	1	2	11.3436397098
30	142	24	5	19	25.2662443439
30	144	1	0	1	32.0147464478
30	145	1	0	1	17.2603965189
30	146	1	0	1	33.0774915229
30	147	1	0	1	38.4601423373
30	148	3	1	2	12.9871581565
30	183	1	0	1	101.483020254
30	188	1	0	1	106.277520689
30	242	0	0	0	137.843963872
30	245	3	1	2	44.8933249797
30	258	1	0	1	36.2081003508
30	262	0	0	0	56.3663078009
30	277	1	1	0	65.1187724516
30	282	1	0	1	65.703097778
30	303	2	0	2	33.4860038596
30	304	1	0	1	26.0513358702
30	305	1	0	1	48.5233141607
30	307	3	1	2	38.7555744153
30	426	1	0	1	117.040828021
30	464	1	0	1	40.7787200791
30	465	0	0	0	57.5471963644
30	466	1	0	1	60.6928557008
30	469	4	0	4	49.4575830874
30	471	2	1	1	41.5176933748
30	472	2	0	2	38.8961986319
30	475	0	0	0	50.5661065706
30	476	1	0	1	29.4660571309
30	477	1	0	1	51.9805267134
30	480	2	0	2	45.3250342303
30	491	2	0	2	53.0217893178
31	0	21	0	21	18.0507573306
31	1	360	90	270	29.36021066
31	2	2	2	0	16.5491923164
31	3	16	1	15	16.0294094235
31	4	2	1	1	19.852610964
31	5	6	1	5	32.4957788957
31	6	3	0	3	35.2835980796
31	7	16	1	15	17.8834375724
31	9	1	0	1	21.1296420139
31	10	2	2	0	15.358119264
31	11	3	0	3	42.645006523
31	12	3	1	2	35.9346818701
31	13	36	0	36	14.447979615
31	14	2	1	1	12.9341091789
31	15	42	6	36	18.748420951
31	16	1	0	1	19.043218847
31	17	7	1	6	19.1812152066
31	18	16	0	16	13.2478342558
31	19	1	0	1	19.5400640936
31	20	1	0	1	26.1948394329
31	21	5	0	5	27.4292482074
31	23	5	0	5	23.5261830878
31	24	3	0	3	20.9985704227
31	26	1	0	1	22.5058050723
31	27	2	0	2	27.2284424741
31	28	7	0	7	28.496209358
31	29	3	1	2	31.8983259667
31	30	10	6	4	11.3140800933
31	32	8	0	8	24.3775702851
31	33	87	0	87	9.22840005939
31	34	55	11	44	12.8673544339
31	35	79	1	78	10.8559399241
31	36	1196	581	615	8.47443990507
31	37	1	0	1	15.8552595235
31	38	61	34	27	5.66986199054
31	39	20	1	19	19.2088837134
31	40	1	0	1	24.0031367903
31	41	174	56	118	5.21414403906
31	42	33	0	33	14.6200525565
31	45	2	0	2	45.4386629455
31	46	6	1	5	37.1025002771
31	48	4	1	3	33.1527031629
31	49	3	0	3	21.2380149419
31	50	14	0	14	23.9872748178
31	51	1	0	1	18.6611623765
31	52	1	0	1	22.0387241932
31	53	4	1	3	48.5754598906
31	54	7	2	5	17.5382459867
31	55	1	0	1	35.8346472623
31	60	2	0	2	27.1289463316
31	61	1	0	1	45.0267073236
31	64	1	0	1	39.6331995252
31	65	13	1	12	42.8749541256
31	67	1	0	1	38.4967974302
31	68	2	0	2	23.7499581376
31	70	15	6	9	28.8866816839
31	71	10	3	7	25.2079431135
31	72	2	1	1	26.0385367151
31	73	292	0	292	21.3902551017
31	74	18	0	18	24.2704235242
31	75	29	4	25	20.3214843396
31	76	7	2	5	28.7625721902
31	77	1	0	1	24.5026057286
31	78	38	2	36	25.9210550857
31	79	8	3	5	23.3346954111
31	80	0	0	0	24.6328905814
31	81	17	0	17	25.5373118313
31	82	17	0	17	26.5341848043
31	83	11	1	10	23.3247001508
31	84	36	0	36	21.9084024905
31	85	6	0	6	29.5902636589
31	86	5	2	3	27.3712453414
31	87	31	0	31	21.5627598057
31	88	4	1	3	22.9218473422
31	89	6	2	4	27.9133524103
31	90	1	0	1	35.499909677
31	92	8	0	8	30.0809573764
31	95	25	0	25	16.0213194604
31	96	6	0	6	40.2632051383
31	98	1	0	1	30.0989375903
31	99	30	7	23	8.87445893687
31	100	11	0	11	15.2427418771
31	102	3	0	3	20.6269569612
31	103	77	1	76	15.8539326047
31	104	5	4	1	19.055068036
31	105	2	0	2	23.9465135347
31	110	17	7	10	12.1668304764
31	111	3	0	3	33.4250034788
31	112	74	15	59	13.905502888
31	113	108	0	108	17.6392279106
31	114	16	1	15	9.16367225488
31	116	3	0	3	31.2299882348
31	117	2	0	2	20.7048931505
31	118	1	0	1	32.2608683351
31	120	1	0	1	22.0937091223
31	121	1	0	1	20.5172800126
31	124	10	0	10	20.8643434325
31	125	1	0	1	15.0421957781
31	128	2	0	2	25.291306128
31	129	56	10	46	4.57960250043
31	131	3	0	3	34.9412124191
31	133	35	0	35	8.00693906546
31	134	8	0	8	13.3488803608
31	136	1	0	1	19.093018336
31	137	0	0	0	25.8558793005
31	138	44	2	42	6.09758621822
31	140	5	0	5	14.5641522952
31	142	139	48	91	18.0899758214
31	145	9	0	9	13.1967342436
31	146	1	0	1	22.390121694
31	147	1	0	1	34.8832602285
31	148	17	5	12	11.1767292949
31	151	2	0	2	27.9544897738
31	152	2	1	1	25.2605487193
31	153	1	0	1	31.5709504942
31	164	1	0	1	32.5085586718
31	171	3	1	2	36.5330903091
31	172	1	0	1	33.9551415258
31	177	5	0	5	38.9825575998
31	182	0	0	0	104.515610746
31	183	0	0	0	97.6255983502
31	196	1	0	1	120.879941239
31	208	1	0	1	94.8421461035
31	220	0	0	0	116.721305098
31	225	1	0	1	96.2574430512
31	229	1	0	1	101.076030784
31	236	1	0	1	84.4750820407
31	242	0	0	0	132.371492534
31	245	2	0	2	36.1566271831
31	256	1	0	1	26.0286606743
31	257	2	0	2	33.6081032282
31	258	1	0	1	30.7878475799
31	264	1	0	1	37.7630231676
31	272	1	0	1	73.8646428634
31	277	4	0	4	59.4044552943
31	282	1	0	1	58.3297636884
31	293	1	0	1	69.1223085618
31	303	7	4	3	34.7687997424
31	304	1	0	1	24.7458111565
31	305	4	0	4	43.818729721
31	307	3	1	2	36.0430080004
31	309	4	0	4	28.4008788
31	314	1	0	1	74.5726755805
31	329	2	0	2	56.8746169908
31	408	0	0	0	83.6897964376
31	411	1	0	1	81.9585117409
31	465	0	0	0	60.5376707884
31	469	2	0	2	52.5086838787
31	471	2	0	2	48.7093140172
31	472	1	0	1	42.9588944982
31	474	1	0	1	70.0203419892
31	475	1	0	1	50.1276770002
31	476	2	0	2	35.0915149876
31	477	1	0	1	56.4909019867
31	488	0	0	0	63.3946189878
31	500	1	0	1	61.437753329
31	555	1	0	1	89.7291274139
32	0	97	0	97	10.5589624651
32	1	774	135	639	20.078958828
32	2	7	0	7	20.6555828432
32	3	106	22	84	9.08191699809
32	4	1	0	1	20.1467950385
32	5	4	0	4	29.8316961592
32	6	5	0	5	37.9019083188
32	7	16	0	16	14.8888596577
32	9	38	26	12	8.65355824733
32	11	3	0	3	37.2261123284
32	12	2	0	2	29.9901799206
32	13	40	16	24	14.4373667924
32	14	2	0	2	18.1750248168
32	15	50	6	44	17.5870050294
32	16	26	2	24	6.61281187724
32	17	8	0	8	26.5758820754
32	18	28	4	24	12.4475561812
32	19	23	1	22	7.61135028529
32	20	7	0	7	29.6240599647
32	21	6	0	6	26.3635955977
32	22	3	0	3	27.5296039274
32	23	9	0	9	24.2488649761
32	24	8	0	8	22.8986479156
32	25	0	0	0	41.5113179764
32	26	2	0	2	33.0617035534
32	27	6	0	6	34.8114280426
32	28	41	12	29	15.4251260562
32	29	2	0	2	39.4970832773
32	31	15	2	13	24.3775702851
32	33	13	4	9	18.9516038053
32	34	8	0	8	34.5586702469
32	35	7	4	3	23.2577886702
32	36	234	3	231	16.2881268052
32	37	1	0	1	30.0111346845
32	38	5	0	5	27.9439175075
32	39	758	412	346	5.47775983456
32	40	88	86	2	4.99202769923
32	41	17	0	17	20.8304665216
32	42	231	32	199	9.91446520558
32	43	5	1	4	64.4523315598
32	46	3	0	3	47.213573304
32	47	1	0	1	63.4307114307
32	48	3	1	2	52.380979554
32	49	17	0	17	35.8806221174
32	50	4	0	4	41.5223705958
32	51	4	1	3	36.4299336704
32	52	2	0	2	45.0539978112
32	53	1	0	1	52.7871498883
32	56	1	0	1	44.923698998
32	58	6	0	6	53.3345285887
32	60	1	0	1	45.5026491078
32	62	12	1	11	65.0722596703
32	63	0	0	0	61.2039215355
32	65	6	3	3	55.0896975724
32	67	2	0	2	50.4785393943
32	70	9	0	9	29.8424370106
32	71	3	0	3	34.5593105952
32	72	4	0	4	25.9124212749
32	73	173	1	172	26.4205726021
32	74	7	0	7	31.0663305881
32	75	23	6	17	27.7331374918
32	76	5	0	5	31.8041854302
32	78	17	2	15	31.8039208635
32	79	14	0	14	24.3971977807
32	80	0	0	0	26.467620863
32	81	17	4	13	27.238361751
32	82	9	1	8	30.4299020343
32	83	8	0	8	28.2972630834
32	84	34	0	34	27.8469950643
32	85	2	0	2	34.9898161253
32	86	2	0	2	35.9498896586
32	87	12	10	2	30.541335106
32	88	8	1	7	32.5747899368
32	89	18	7	11	21.0162400243
32	90	4	0	4	38.5958824984
32	91	1	0	1	48.0210047126
32	92	6	1	5	26.940114135
32	95	19	3	16	19.1963996805
32	96	3	0	3	41.0530716694
32	99	2	1	1	28.0775867751
32	100	11	1	10	12.8539897141
32	102	72	4	68	9.72116539645
32	103	52	7	45	25.6490014558
32	104	5	3	2	15.7774389998
32	105	3	0	3	16.0354462525
32	106	6	0	6	15.417041375
32	109	5	0	5	34.2522751453
32	110	10	0	10	26.4068668303
32	111	5	0	5	25.9664701484
32	112	36	4	32	22.7175415298
32	113	53	0	53	30.2016880356
32	114	3	2	1	19.858683856
32	115	1	0	1	30.4399757507
32	116	3	0	3	33.8832268756
32	117	1	0	1	32.0749496441
32	119	1	0	1	40.0926552258
32	120	9	0	9	21.1827022778
32	128	1	0	1	47.1207438596
32	129	2	0	2	25.6719420373
32	131	1	0	1	58.7095271403
32	133	2	0	2	31.4579628244
32	140	1	0	1	32.3037795314
32	142	44	4	40	40.1635324787
32	145	2	0	2	37.417530599
32	147	2	0	2	58.2461103588
32	150	1	0	1	63.7733311308
32	153	1	0	1	55.6155443063
32	155	1	0	1	47.604163962
32	164	3	0	3	42.8732932905
32	166	1	0	1	55.7947299437
32	168	1	0	1	46.1430057796
32	171	2	0	2	44.3517814754
32	172	1	0	1	48.8486657655
32	180	1	0	1	60.6937554353
32	183	1	0	1	73.3744585915
32	185	1	0	1	80.6685964277
32	188	0	0	0	77.4887505388
32	207	1	0	1	70.3980464373
32	220	2	0	2	92.7262067326
32	225	4	1	3	75.1381093421
32	226	2	0	2	80.5172467993
32	229	1	0	1	79.6006392029
32	242	0	0	0	109.010145093
32	245	7	0	7	20.7223735698
32	247	1	0	1	42.39844907
32	254	2	0	2	28.0798248846
32	255	4	3	1	19.5657692868
32	256	28	0	28	9.78368104354
32	257	40	0	40	13.0569987654
32	258	19	8	11	7.44888926495
32	260	5	2	3	14.3570314935
32	261	5	0	5	12.014733264
32	262	1	1	0	28.3768812176
32	263	1	1	0	22.9186253287
32	264	13	3	10	14.8000705568
32	271	1	0	1	55.7619265062
32	272	1	0	1	52.125786823
32	274	1	0	1	30.8322476859
32	275	2	0	2	37.7175852994
32	276	1	0	1	43.1753960581
32	277	50	17	33	36.2250868899
32	279	1	1	0	26.9638856852
32	281	1	0	1	33.0894703983
32	283	1	0	1	22.9180398492
32	287	1	0	1	44.4348025859
32	290	1	0	1	48.0712243453
32	291	1	0	1	56.6912737983
32	293	3	0	3	51.197183078
32	294	1	0	1	58.845586067
32	303	48	6	42	17.3796699426
32	304	19	2	17	7.73916783882
32	305	14	1	13	19.7617360378
32	306	5	1	4	17.2415033013
32	307	227	0	227	12.1421135409
32	308	8	2	6	19.8073519721
32	309	142	7	135	4.92820230888
32	319	0	0	0	76.2114049207
32	329	1	0	1	60.9131628489
32	345	2	0	2	80.1994320218
32	350	1	0	1	51.3814587134
32	404	1	0	1	111.944654285
32	411	1	0	1	105.654682027
32	464	2	0	2	69.4769006788
32	466	1	0	1	88.7312454509
32	468	1	0	1	61.7199735018
32	470	0	0	0	67.7347544247
32	471	1	0	1	70.4116258569
32	472	1	0	1	66.6931839691
32	479	1	0	1	64.1266185196
32	480	2	1	1	73.6506313705
32	488	1	0	1	85.1758741603
33	0	49	3	46	10.0367744201
33	1	821	114	707	20.1398753438
33	2	24	11	13	7.77834880438
33	3	30	7	23	9.87532957763
33	4	3	1	2	10.8068863653
33	5	9	0	9	23.8050393274
33	6	5	2	3	27.8729940524
33	7	75	4	71	8.80371383891
33	8	2	0	2	39.4854414124
33	9	8	0	8	13.2696520608
33	10	19	0	19	6.13931274954
33	11	1	0	1	33.8575107405
33	12	2	0	2	26.9387202195
33	13	193	0	193	5.76683127032
33	14	31	1	30	3.73021406534
33	15	107	53	54	9.5243605569
33	16	3	0	3	12.5357127632
33	17	20	6	14	12.0399037031
33	18	105	2	103	6.50920251093
33	19	8	2	6	12.3283820886
33	20	3	0	3	18.4536732144
33	21	8	0	8	18.746464264
33	22	4	0	4	27.5805163466
33	23	14	0	14	14.8866411551
33	24	15	11	4	12.3507547343
33	25	2	0	2	33.718390791
33	26	9	0	9	17.2583898167
33	27	3	0	3	21.0178242603
33	28	11	1	10	19.5569154975
33	29	7	0	7	25.9891578537
33	30	14	0	14	9.9973386888
33	31	21	2	19	9.22840005939
33	32	13	5	8	18.9516038053
33	34	33	0	33	15.7313353474
33	35	325	164	161	4.87009534548
33	36	659	195	464	8.69998254264
33	37	9	4	5	12.0978323192
33	38	22	3	19	9.89798419795
33	39	24	2	22	14.9507902577
33	41	178	49	129	4.02273790454
33	42	19	0	19	11.1932169335
33	43	0	0	0	47.856616845
33	46	10	4	6	32.4853643267
33	47	1	0	1	45.3866956304
33	48	8	2	6	33.7735682718
33	49	6	0	6	18.2692415526
33	50	14	2	12	23.1552350448
33	51	2	1	1	17.8273366375
33	52	2	0	2	26.3303061758
33	53	0	0	0	42.0892830244
33	54	4	1	3	21.1591689087
33	55	1	0	1	34.0540498182
33	56	2	0	2	28.5406763812
33	58	1	0	1	39.347918754
33	59	3	0	3	47.1054874292
33	60	3	0	3	27.0029793052
33	61	1	0	1	42.3400190793
33	63	1	0	1	43.6167559089
33	64	1	0	1	33.8130106736
33	65	7	0	7	39.414474744
33	66	1	0	1	22.5753588799
33	68	5	0	5	25.7144473799
33	69	1	0	1	34.3964142726
33	70	8	3	5	33.4762090962
33	71	7	1	6	32.213742949
33	72	1	0	1	29.9771077772
33	73	173	73	100	26.6126560415
33	74	9	0	9	30.40814336
33	75	16	2	14	26.2618568985
33	76	2	0	2	34.0371343704
33	77	1	0	1	28.4902423004
33	78	30	7	23	31.8994350471
33	79	5	0	5	27.3669011372
33	80	1	0	1	29.1092994971
33	81	13	1	12	30.0672044053
33	82	6	1	5	31.9110291933
33	83	7	0	7	28.757327149
33	84	16	0	16	27.5191245871
33	85	3	0	3	35.6731706407
33	86	6	0	6	34.2806080082
33	87	11	0	11	28.1699262149
33	88	3	0	3	29.8585914909
33	89	4	0	4	29.6141876561
33	90	2	0	2	41.1940866298
33	92	6	3	3	33.3612035962
33	93	1	0	1	53.0615671538
33	95	14	4	10	19.3697739672
33	96	2	0	2	45.453633996
33	99	1	0	1	17.4893893018
33	100	8	2	6	15.1459846473
33	101	1	0	1	38.9975068341
33	102	12	1	11	19.1338346284
33	103	28	10	18	22.0293000514
33	104	2	0	2	20.4246770325
33	110	2	0	2	19.4511563291
33	111	1	0	1	35.4556398649
33	112	47	16	31	19.2491509992
33	113	54	2	52	25.0355852027
33	114	10	0	10	13.5785149075
33	116	1	0	1	36.5503223243
33	117	3	2	1	27.997062856
33	120	4	0	4	25.1822927003
33	121	1	0	1	28.1501936136
33	124	2	0	2	27.2271592661
33	125	1	0	1	21.3265503053
33	128	2	0	2	34.4579467826
33	129	4	0	4	13.2723474353
33	131	3	0	3	40.1933878821
33	133	1	0	1	17.130730285
33	134	4	0	4	22.5743459824
33	137	1	0	1	34.7149525235
33	138	3	0	3	14.0495097581
33	142	45	22	23	27.2819249731
33	144	1	0	1	32.9702239376
33	145	2	0	2	21.4960176495
33	148	2	0	2	18.3370053884
33	151	2	0	2	33.5780414923
33	155	1	0	1	48.3034499769
33	166	3	2	1	56.9327379831
33	171	3	0	3	43.6302731314
33	172	2	0	2	42.6188401402
33	177	1	0	1	47.4481296557
33	183	1	0	1	91.9234577761
33	194	1	0	1	106.015952065
33	204	1	0	1	79.9069738344
33	211	2	0	2	101.085928895
33	225	1	0	1	93.6181391274
33	245	4	0	4	35.4063309879
33	257	3	0	3	30.5751449785
33	265	2	0	2	57.6412861902
33	270	1	0	1	50.5595742648
33	272	1	0	1	70.7498836353
33	275	1	0	1	56.5289381571
33	277	12	2	10	55.156303794
33	293	1	0	1	68.1127766217
33	303	12	0	12	26.0793097997
33	304	1	0	1	16.994355406
33	305	2	0	2	38.6584522935
33	307	12	1	11	29.3390573874
33	309	6	0	6	21.9332468134
33	319	3	0	3	75.25447507
33	329	1	0	1	63.4394176125
33	331	1	0	1	63.3326552363
33	406	1	0	1	89.4313546276
33	416	1	0	1	96.0333342596
33	465	0	0	0	66.4545260357
33	466	1	0	1	70.0742997857
33	468	1	0	1	43.6989137283
33	469	1	0	1	58.3505524452
33	471	1	0	1	51.4783631285
33	476	1	1	0	39.0762750163
33	480	1	0	1	54.8561192817
33	491	2	0	2	62.7544504236
33	496	1	0	1	66.3530201878
33	502	1	0	1	82.1525690218
33	503	1	0	1	75.7230769115
33	573	1	0	1	75.0249841418
34	0	20	3	17	25.5872835672
34	1	1120	226	894	32.3014923665
34	2	39	3	36	18.5384785116
34	3	12	1	11	25.4932003456
34	4	7	0	7	21.8697311044
34	5	15	0	15	31.148231879
34	6	1	0	1	30.3456771243
34	7	37	5	32	23.1672649421
34	8	3	0	3	46.0403430428
34	9	6	1	5	28.7862055944
34	10	6	0	6	19.6120955804
34	11	6	0	6	40.8811372296
34	12	11	0	11	35.5803885993
34	13	69	27	42	21.1619907643
34	14	5	0	5	17.7565938181
34	15	284	112	172	22.3587232721
34	16	4	0	4	28.2517974729
34	17	18	7	11	16.8682405514
34	18	21	2	19	22.1464067726
34	19	6	0	6	28.0398174895
34	20	5	1	4	23.1847632181
34	21	12	0	12	26.6728949407
34	22	3	0	3	37.9747977666
34	23	16	3	13	23.2904620417
34	24	16	0	16	21.3406834184
34	25	2	0	2	37.085446909
34	26	25	3	22	16.0342667884
34	27	7	2	5	21.1882226982
34	28	14	0	14	33.443101684
34	29	19	8	11	24.7010423565
34	30	191	44	147	6.84001019695
34	31	176	8	168	12.8673544339
34	32	10	2	8	34.5586702469
34	33	188	11	177	15.7313353474
34	35	1023	96	927	12.4618728891
34	36	836	36	800	20.5458747655
34	37	103	34	69	10.1612327728
34	38	344	158	186	7.34582592332
34	39	15	6	9	30.0925669607
34	40	1	0	1	35.3789299367
34	41	152	12	140	13.9987947198
34	42	23	0	23	25.7679071403
34	45	1	0	1	32.6753422268
34	46	25	1	24	27.6771654578
34	47	7	3	4	32.8961608194
34	48	108	0	108	20.3202141323
34	49	86	4	82	12.0324249122
34	50	312	81	231	12.0910880418
34	51	65	1	64	7.69750260889
34	52	41	3	38	10.6207236465
34	53	4	0	4	41.0706251922
34	54	308	108	200	5.42793122659
34	55	11	5	6	23.897828952
34	56	8	0	8	21.5927300987
34	57	3	1	2	24.2983094457
34	58	4	1	3	34.5262869019
34	59	7	0	7	34.2063494039
34	60	79	2	77	14.6143657604
34	61	3	0	3	33.4288765824
34	62	1	0	1	43.1929194313
34	64	7	1	6	31.6074526607
34	65	57	0	57	31.9601849892
34	66	16	0	16	16.4489301763
34	67	3	1	2	27.9888862338
34	68	185	80	105	10.9063100888
34	69	10	2	8	18.8922039868
34	70	12	0	12	41.1375323468
34	71	7	0	7	35.8009774527
34	72	2	1	1	38.5879456641
34	73	196	0	196	33.5556490486
34	74	10	4	6	35.7382699366
34	75	33	5	28	32.1211610772
34	76	9	3	6	40.6616262034
34	77	2	1	1	37.0653336866
34	78	17	1	16	37.4419859149
34	79	9	2	7	35.907189347
34	80	1	0	1	37.0270031481
34	81	19	6	13	37.8888218743
34	82	7	1	6	38.4381246788
34	83	5	0	5	35.3058112611
34	84	22	0	22	33.8415168984
34	85	2	0	2	40.8928493068
34	86	9	0	9	37.9628000836
34	87	13	2	11	32.7740141714
34	88	4	0	4	33.7243350407
34	89	7	2	5	40.7801833192
34	90	5	0	5	46.9405080586
34	92	4	0	4	42.7506611902
34	95	13	3	10	28.8535119765
34	96	1	0	1	51.9629328092
34	98	2	0	2	39.9231607367
34	99	34	8	26	18.99880724
34	100	10	0	10	27.7259089118
34	102	2	0	2	32.8529826649
34	103	64	4	60	27.7677804942
34	104	1	0	1	31.882292595
34	105	1	0	1	36.7436918912
34	107	1	0	1	36.3154716609
34	109	2	0	2	46.7409655186
34	110	21	2	19	23.5639660909
34	111	8	0	8	46.2661750518
34	112	68	0	68	26.3577369546
34	113	106	12	94	28.3143133674
34	114	13	0	13	22.0153623568
34	116	2	2	0	43.035666342
34	119	0	0	0	44.3709445086
34	120	3	0	3	34.8858159616
34	122	0	0	0	49.3439637234
34	124	200	26	174	12.8560249749
34	125	46	1	45	7.94548000813
34	126	4	1	3	22.7950982617
34	127	1	0	1	25.7937485021
34	128	5	0	5	26.9507007036
34	129	29	0	29	15.9339800813
34	131	12	5	7	24.5669270914
34	133	39	1	38	13.6845946863
34	134	23	5	18	18.9666479639
34	135	0	0	0	33.984335597
34	136	10	0	10	16.4435067704
34	138	93	90	3	9.34106438578
34	140	7	0	7	23.3632323537
34	141	2	0	2	41.9946671872
34	142	258	14	244	21.1757456472
34	143	6	0	6	22.0560505495
34	144	5	0	5	28.1979930406
34	145	27	1	26	12.4676370549
34	146	1	0	1	31.515829343
34	147	7	3	4	32.2876995541
34	148	117	73	44	8.08435854366
34	151	9	2	7	18.2042925604
34	152	4	0	4	19.9515640832
34	154	1	0	1	32.9319621136
34	163	1	0	1	39.1618177208
34	168	1	1	0	41.7174675659
34	169	1	0	1	57.1492114582
34	171	3	0	3	46.5225331071
34	172	3	0	3	40.8221714
34	177	1	0	1	46.2357611873
34	182	1	0	1	114.122848258
34	183	3	0	3	107.653462517
34	190	0	0	0	103.436424548
34	208	0	0	0	107.476324376
34	210	1	0	1	107.325144317
34	220	0	0	0	127.218359167
34	222	1	0	1	119.593567517
34	224	1	0	1	104.620324157
34	242	0	0	0	143.538306394
34	245	2	0	2	48.7877464075
34	249	1	0	1	63.1803296541
34	251	1	0	1	58.0626140952
34	255	1	1	0	53.0566361182
34	257	1	0	1	45.4041504994
34	258	6	0	6	41.6638433104
34	261	1	0	1	46.4803526604
34	262	5	0	5	61.1671189863
34	272	2	0	2	85.7857224197
34	275	1	0	1	72.2294645604
34	277	10	1	9	70.6241314424
34	294	1	0	1	86.864335671
34	302	1	0	1	74.1083266631
34	303	6	1	5	40.289742517
34	304	2	0	2	32.4702923915
34	305	2	0	2	54.3149707477
34	306	1	0	1	46.5031750964
34	307	2	0	2	45.0218835929
34	309	3	0	3	37.6622284677
34	356	1	0	1	99.5462028953
34	396	1	0	1	69.216593562
34	426	0	0	0	110.266015099
34	464	12	0	12	34.9536190994
34	465	2	1	1	50.9172199258
34	466	5	0	5	54.3513941732
34	469	27	0	27	42.8154076747
34	471	3	1	2	36.2965339545
34	472	4	0	4	32.4107764928
34	474	3	0	3	58.4960970155
34	475	4	0	4	43.7590927299
34	476	13	6	7	23.3877017833
34	480	4	1	3	39.1295007049
34	482	2	0	2	63.0880028635
34	484	4	2	2	43.0471111244
34	485	1	0	1	68.4259476349
34	487	0	0	0	48.0583005674
34	488	1	0	1	51.067017746
34	491	5	1	4	47.1021397623
34	493	1	0	1	68.3633571702
34	495	0	0	0	60.1056122408
34	496	1	0	1	51.7484386601
34	499	1	0	1	57.4140104416
34	503	3	0	3	60.9887645528
34	512	1	0	1	138.01126731
34	569	1	0	1	70.8320807398
34	573	1	0	1	68.655551155
35	0	49	1	48	13.4472158853
35	1	1878	497	1381	20.4848935619
35	2	199	15	184	6.59916629558
35	3	34	6	28	14.308522095
35	4	33	0	33	10.1160957408
35	5	19	0	19	21.8767627878
35	6	11	0	11	24.4954940714
35	7	86	5	81	10.7070253852
35	8	2	1	1	37.5856307297
35	9	10	2	8	16.5587381793
35	10	47	1	46	7.1531808668
35	11	3	1	2	32.0427586113
35	12	14	0	14	25.629993245
35	13	200	86	114	9.04341339711
35	14	64	24	40	5.3984342927
35	15	383	271	112	10.0603630467
35	16	7	2	5	16.6820171427
35	17	172	11	161	8.35925684729
35	18	49	0	49	11.01807667
35	19	5	0	5	16.1342662943
35	20	22	0	22	15.339561886
35	21	41	1	40	16.8596861425
35	22	6	0	6	27.0892213447
35	23	47	19	28	12.9933217143
35	24	98	0	98	10.5519418605
35	25	2	0	2	30.7195659081
35	26	45	1	44	12.6841366101
35	27	23	0	23	16.8653601988
35	28	31	9	22	21.0903891758
35	29	29	8	21	21.7466946304
35	30	122	45	77	5.87691650532
35	31	23	0	23	10.8559399241
35	32	8	0	8	23.2577886702
35	33	327	253	74	4.87009534548
35	34	133	10	123	12.4618728891
35	36	441	21	420	13.2009049906
35	37	122	21	101	7.22821786876
35	38	57	7	50	8.69691541054
35	39	23	0	23	19.6332460155
35	40	1	0	1	25.0988571228
35	41	161	87	74	6.76073106835
35	42	29	5	24	16.0405251715
35	43	1	0	1	42.9931817312
35	46	27	1	26	27.8781479939
35	47	1	0	1	40.5986168049
35	48	36	9	27	29.1643707631
35	49	33	5	28	13.3992147908
35	50	110	5	105	18.4171600618
35	51	16	0	16	13.1926980354
35	52	1	0	1	22.9941798061
35	53	10	4	6	38.1817069223
35	54	8	0	8	17.7704023257
35	55	5	0	5	29.1879333165
35	57	2	0	2	34.8893082322
35	58	4	1	3	34.8100965651
35	59	14	0	14	42.3512265975
35	60	20	1	19	22.3283915079
35	61	3	0	3	37.4935022416
35	64	1	0	1	29.5804402649
35	65	52	1	51	34.6320434568
35	66	11	4	7	17.738211834
35	68	18	1	17	21.5514563558
35	69	2	0	2	30.4624952634
35	70	10	0	10	37.7256138938
35	71	5	1	4	35.5791714877
35	72	1	0	1	34.3594496948
35	73	238	18	220	30.6242249599
35	74	15	0	15	34.1402534227
35	75	35	4	31	30.0297396276
35	76	6	1	5	38.0942495836
35	77	1	0	1	32.8491750343
35	78	26	21	5	35.7027772592
35	79	7	0	7	31.7052230513
35	81	21	0	21	34.3074614574
35	82	14	0	14	35.9215097684
35	83	7	0	7	32.7241938791
35	84	37	0	37	31.4154333839
35	85	5	0	5	39.4603772438
35	86	7	3	4	37.7042271239
35	87	19	0	19	31.6919357332
35	88	6	1	5	33.2431415684
35	89	8	1	7	34.3627457107
35	90	1	0	1	45.1496528237
35	92	5	0	5	37.9002240716
35	95	10	0	10	23.7468674408
35	96	5	0	5	49.5894183472
35	98	1	0	1	40.6782213157
35	99	7	1	6	19.7217407036
35	100	2	1	1	19.9435245163
35	102	3	1	2	24.0025303995
35	103	39	16	23	25.6538443019
35	104	2	0	2	25.1429616851
35	109	1	0	1	43.4311768804
35	110	4	0	4	22.5532960509
35	111	2	0	2	40.1912451397
35	112	39	2	37	23.1056846923
35	113	58	15	43	28.1486700041
35	114	4	0	4	17.5018813031
35	116	1	0	1	40.6077857154
35	117	2	0	2	31.1890574824
35	118	1	0	1	42.1381312056
35	119	1	0	1	43.8807764056
35	120	1	0	1	29.6945427372
35	122	0	0	0	44.4678653053
35	124	17	0	17	24.8994143002
35	125	2	0	2	19.2413078847
35	128	1	0	1	34.8045716559
35	129	4	1	3	15.4075520959
35	131	5	0	5	36.9782619717
35	133	3	1	2	17.7969532109
35	134	1	0	1	23.6537481585
35	137	0	0	0	36.6447222029
35	138	2	1	1	13.7836843084
35	140	4	0	4	25.4197046868
35	142	70	25	45	27.8452220943
35	147	3	0	3	42.7329171693
35	148	5	1	4	17.0258080096
35	152	1	0	1	31.3032291078
35	171	1	0	1	46.9936951114
35	172	1	0	1	44.7926753779
35	175	2	1	1	49.132423815
35	177	1	0	1	49.8381956391
35	182	0	0	0	101.928087542
35	183	2	0	2	95.6166224539
35	187	0	0	0	103.467830714
35	188	0	0	0	100.504475937
35	190	1	0	1	91.1119761895
35	207	1	0	1	93.0842570424
35	208	1	0	1	98.3294666192
35	212	1	0	1	86.1659039338
35	213	1	0	1	103.119084134
35	220	1	0	1	115.365810687
35	225	1	0	1	98.2180586143
35	242	0	0	0	132.087389276
35	245	2	0	2	40.2706861744
35	247	2	0	2	60.189345212
35	251	1	0	1	51.4337862896
35	254	1	0	1	48.7105213264
35	255	0	0	0	42.5456405128
35	257	6	2	4	35.2630012868
35	258	1	0	1	30.6430182672
35	262	1	0	1	51.090533164
35	267	1	0	1	66.7783188674
35	270	2	0	2	54.1392579192
35	275	0	0	0	60.4989108056
35	277	15	1	14	59.4643434035
35	281	2	0	2	56.010594229
35	282	2	0	2	60.422521647
35	289	0	0	0	49.3696992298
35	292	1	0	1	76.7448537192
35	303	16	0	16	27.9038387557
35	304	5	0	5	20.1745967558
35	305	5	0	5	42.7729729614
35	306	1	0	1	34.0549560214
35	307	12	2	10	32.8854048903
35	309	2	0	2	25.7519034939
35	326	1	0	1	73.4022261952
35	338	0	0	0	85.309844818
35	379	0	0	0	81.4837178415
35	414	1	0	1	88.7263093169
35	464	1	0	1	46.6280608843
35	465	1	0	1	63.348088826
35	466	7	0	7	66.565497608
35	469	8	0	8	55.251054396
35	471	5	0	5	47.2407300193
35	475	1	0	1	55.8105229129
35	476	2	1	1	35.3422083986
35	480	6	0	6	51.2019400936
35	484	3	0	3	52.1614198381
35	488	1	0	1	61.9771694323
35	495	0	0	0	72.5496248414
35	496	1	0	1	64.0562560081
35	503	1	0	1	73.3461569431
35	505	1	0	1	78.9645001076
35	555	1	0	1	100.092434575
36	0	97	0	97	12.4232373673
36	1	2108	180	1928	25.7031502439
36	2	17	1	16	15.9339735878
36	3	97	8	89	9.02433374015
36	4	6	0	6	18.2987862449
36	5	27	0	27	31.4463542465
36	6	12	3	9	36.3635767643
36	7	73	0	73	14.2453943191
36	8	3	0	3	46.8194076696
36	9	13	0	13	14.9289369264
36	10	14	0	14	13.3741448644
36	11	3	0	3	41.1927766463
36	12	12	0	12	33.9551842606
36	13	200	0	200	10.5824380672
36	14	14	5	9	11.5142675666
36	15	131	0	131	16.2524891626
36	16	18	4	14	11.8618797559
36	17	17	0	17	20.7232746212
36	18	146	47	99	7.53146109634
36	19	19	9	10	12.8648763348
36	20	7	0	7	26.9176224562
36	21	49	7	42	26.5169733641
36	22	3	0	3	33.7206534895
36	23	31	3	28	22.8288380981
36	24	33	5	28	20.3830357029
36	25	4	0	4	41.9692861949
36	26	12	0	12	25.854492176
36	27	4	0	4	29.7177953413
36	28	36	0	36	23.5244909097
36	29	9	1	8	34.6874815353
36	30	27	0	27	16.8357641471
36	31	306	9	297	8.47443990507
36	32	85	26	59	16.2881268052
36	33	408	11	397	8.69998254264
36	34	97	4	93	20.5458747655
36	35	289	0	289	13.2009049906
36	37	17	3	14	20.172153123
36	38	71	10	61	13.2445697104
36	39	179	2	177	10.9304694278
36	40	11	7	4	15.5388567783
36	41	676	311	365	7.08978745182
36	42	272	2	270	6.37511706238
36	43	1	0	1	55.8566576316
36	46	22	0	22	41.0706625994
36	47	1	0	1	52.5242239725
36	48	16	0	16	40.3600868277
36	49	15	5	10	26.2599374147
36	50	81	0	81	30.3510634571
36	52	2	0	2	30.3360032528
36	53	6	1	5	50.740466003
36	54	20	1	19	25.610602598
36	55	4	0	4	41.8095978919
36	56	3	0	3	36.8212979331
36	58	3	1	2	47.9787221138
36	59	3	0	3	54.0761593827
36	60	4	1	3	33.9122451038
36	61	3	0	3	50.4807196296
36	64	4	1	3	42.5128147166
36	65	87	0	87	47.7739473934
36	66	3	1	2	30.8129742329
36	67	3	1	2	43.2022690937
36	68	18	0	18	31.3907608008
36	69	3	0	3	39.2863074543
36	70	110	45	65	24.7953677274
36	71	48	15	33	24.3211340715
36	72	11	0	11	21.2771544245
36	73	1556	0	1556	18.0876947943
36	74	126	4	122	22.1135645455
36	75	210	119	91	17.9782511393
36	76	40	1	39	25.4461795487
36	77	12	0	12	19.7910527804
36	78	186	0	186	23.5209116496
36	79	66	7	59	18.6702440531
36	80	7	4	3	20.4344107611
36	81	103	3	100	21.3930337702
36	82	107	23	84	23.3586054258
36	83	83	4	79	20.2548504357
36	84	259	163	96	19.0887504204
36	85	37	5	32	27.2848019503
36	86	46	7	39	26.2887075411
36	87	127	0	127	20.1478452603
36	88	56	0	56	21.9811450783
36	89	49	0	49	21.2828398383
36	90	15	0	15	32.6504211522
36	92	53	16	37	24.7102188158
36	94	1	0	1	37.1124514986
36	95	184	65	119	10.6724598586
36	96	27	1	26	36.803338415
36	97	1	0	1	44.7129286724
36	98	2	0	2	29.7742568151
36	99	140	38	102	12.4185744595
36	100	139	5	134	7.24539045562
36	101	1	0	1	30.8623266254
36	102	101	0	101	12.3284200526
36	103	447	13	434	14.0175773979
36	104	28	1	27	12.0513440207
36	105	10	1	9	16.6268985666
36	106	2	0	2	20.2540155955
36	107	13	0	13	29.2027828514
36	108	3	0	3	38.0994687339
36	109	21	0	21	30.4497839426
36	110	70	0	70	12.4377691225
36	111	22	0	22	27.0752255631
36	112	553	54	499	11.0053689344
36	113	666	176	490	17.6792678138
36	114	198	77	121	5.55981829059
36	116	7	0	7	27.952706717
36	117	10	3	7	20.4248677189
36	118	4	0	4	29.9164691926
36	119	2	0	2	32.0514583765
36	120	23	0	23	16.5122533225
36	121	5	0	5	20.8560695375
36	122	3	0	3	31.2677374952
36	123	1	0	1	27.2286590292
36	124	16	0	16	29.3263633838
36	125	1	0	1	23.5165968276
36	126	4	1	3	38.4076014302
36	127	4	0	4	22.4327648381
36	128	4	0	4	31.330155828
36	129	161	0	161	9.43717345923
36	131	5	0	5	43.408425553
36	133	36	7	29	15.1710000868
36	134	18	0	18	19.0050731963
36	135	3	0	3	40.7786288103
36	136	4	0	4	26.9673288874
36	137	2	0	2	28.8861179136
36	138	42	6	36	14.5124295175
36	140	33	1	32	17.5311234784
36	142	443	0	443	24.207845769
36	143	1	0	1	31.1195801458
36	144	3	1	2	28.5254365508
36	145	5	0	5	21.1806420284
36	146	11	2	9	23.6059266221
36	147	7	0	7	42.0604631751
36	148	24	9	15	19.6211900898
36	151	2	1	1	36.4280513294
36	152	4	0	4	33.37656846
36	154	2	0	2	35.7117964895
36	155	3	1	2	40.0904586
36	156	1	0	1	40.5322628183
36	160	1	0	1	35.3529764393
36	164	10	3	7	32.537588816
36	166	2	0	2	48.726593516
36	168	7	0	7	34.644155983
36	169	3	1	2	41.8357740814
36	171	9	2	7	35.6211020451
36	172	10	0	10	36.2101768526
36	176	1	0	1	52.1216131342
36	177	9	0	9	40.6487089683
36	179	2	0	2	45.6387684634
36	182	1	0	1	96.2390261962
36	183	4	0	4	89.265602255
36	188	1	0	1	92.6014785732
36	190	4	0	4	86.2732774336
36	193	1	0	1	104.133188685
36	198	0	0	0	124.652145639
36	208	7	0	7	86.9528537758
36	220	3	0	3	108.28194543
36	222	0	0	0	101.175411156
36	223	1	0	1	95.8346488591
36	226	1	0	1	92.8207791825
36	229	3	0	3	92.7625028293
36	239	1	0	1	87.4457049367
36	242	0	0	0	123.898303461
36	243	1	0	1	118.076705406
36	245	11	0	11	28.2976414043
36	251	1	0	1	38.5063576543
36	254	0	0	0	36.8736456266
36	256	6	0	6	17.6761429373
36	257	17	6	11	25.1685391588
36	258	2	0	2	22.3801184825
36	260	1	0	1	23.5325364907
36	261	2	0	2	28.0797603512
36	262	2	0	2	40.7693939602
36	264	9	0	9	29.2960831328
36	265	1	0	1	55.8828661688
36	266	1	0	1	64.6813066
36	269	1	0	1	65.9406901253
36	272	7	2	5	65.4875300799
36	273	1	0	1	54.8751414123
36	274	1	0	1	44.861103997
36	275	0	0	0	53.4005899727
36	277	63	7	56	50.9300380596
36	279	2	0	2	42.2829593699
36	281	0	0	0	45.8935798068
36	282	3	0	3	50.0282057959
36	287	1	0	1	57.9768891309
36	291	1	0	1	69.2045785028
36	293	2	0	2	61.2989153036
36	297	1	0	1	70.2410979052
36	302	0	0	0	53.6075130358
36	303	29	5	24	29.0012042148
36	304	8	0	8	18.1432953143
36	305	16	2	14	35.4426354532
36	306	2	0	2	32.1594048442
36	307	32	14	18	28.267056835
36	308	0	0	0	35.8266962071
36	309	23	0	23	20.6608724224
36	310	1	0	1	64.3343587547
36	319	2	0	2	67.5903419264
36	320	1	0	1	70.42567065
36	338	0	0	0	72.3928908854
36	348	1	0	1	48.9368441577
36	349	1	0	1	65.115988987
36	351	1	0	1	62.8342697613
36	401	1	0	1	96.9149476151
36	408	2	0	2	91.4540741076
36	444	1	0	1	112.16478429
36	454	1	0	1	65.0487720171
36	465	1	0	1	68.9804422825
36	466	2	0	2	73.4437846686
36	467	1	0	1	59.9673394825
36	469	12	1	11	60.9638656312
36	471	11	7	4	56.790565468
36	472	3	0	3	51.42698002
36	474	2	0	2	78.4186773088
36	475	5	1	4	58.0902390447
36	476	3	1	2	43.4074851148
36	479	1	0	1	50.3105122829
36	480	2	0	2	58.7224079777
36	482	2	0	2	83.5523324002
36	484	2	1	1	63.3673694085
36	485	2	0	2	88.656731748
36	487	1	0	1	68.5648128929
36	488	2	0	2	71.533902187
36	489	1	0	1	78.1215101418
36	490	1	0	1	63.7952563982
36	491	4	1	3	67.0477926057
36	494	1	0	1	61.2009799974
36	496	1	0	1	67.2304333969
36	501	2	0	2	84.873008907
36	503	2	1	1	76.6551607442
36	505	1	0	1	86.1806483552
36	507	1	1	0	178.193827742
36	540	1	0	1	138.663161493
36	562	1	0	1	101.604083136
36	563	0	0	0	85.5324613039
36	573	2	0	2	69.8402866204
36	576	1	0	1	56.8540750122
36	577	1	0	1	65.8584639645
36	579	1	0	1	63.9478848668
37	0	27	12	15	19.7301181315
37	1	1170	554	616	23.090263685
37	2	68	18	50	10.3710428422
37	3	9	3	6	21.2735428425
37	4	11	9	2	13.0758334424
37	5	16	6	10	20.9952172543
37	6	7	0	7	20.7348528654
37	7	58	14	44	16.1082558489
37	8	2	0	2	35.946446796
37	9	4	0	4	22.5848535128
37	10	19	1	18	12.657020412
37	11	1	0	1	30.7363754524
37	12	19	0	19	25.4729519071
37	13	106	72	34	15.5755766815
37	14	33	1	32	11.838005043
37	15	209	65	144	14.3774028466
37	16	1	0	1	23.398590819
37	17	123	7	116	6.8997410288
37	18	28	0	28	18.081825946
37	19	6	1	5	22.6010590905
37	20	14	2	12	13.0368053846
37	21	28	4	24	16.621418864
37	22	3	0	3	28.0807811882
37	23	50	6	44	13.4633403049
37	24	83	8	75	11.848376336
37	26	80	53	27	6.81272411746
37	27	26	3	23	11.8753406614
37	28	18	4	14	25.0953866044
37	29	35	0	35	16.2141454008
37	30	156	47	109	4.88461048408
37	31	4	0	4	15.8552595235
37	32	5	0	5	30.0111346845
37	33	117	16	101	12.0978323192
37	34	110	13	97	10.1612327728
37	35	1101	60	1041	7.22821786876
37	36	173	28	145	20.172153123
37	38	25	9	16	11.2983145922
37	39	13	0	13	26.7292798047
37	40	1	0	1	32.1865148626
37	41	39	2	37	13.263457846
37	42	10	1	9	23.2589782103
37	43	1	0	1	35.7883313938
37	45	2	1	1	36.2466964072
37	46	28	0	28	21.3189215021
37	47	3	2	1	33.5063691421
37	48	51	8	43	22.468965179
37	49	123	81	42	6.17212383943
37	50	209	30	179	11.536048223
37	51	62	2	60	6.84910276818
37	52	4	2	2	19.1647324354
37	53	6	0	6	32.9560881071
37	54	13	0	13	14.2764319267
37	55	5	0	5	21.9628352397
37	56	13	0	13	16.6561319664
37	57	1	0	1	28.7603731287
37	58	1	0	1	28.3432615103
37	59	12	3	9	35.3184965181
37	60	43	3	40	15.5558449644
37	61	3	0	3	30.3326540781
37	63	1	0	1	31.5674295079
37	64	2	0	2	23.8407699377
37	65	48	0	48	27.6252159213
37	66	11	7	4	10.6452917621
37	68	20	16	4	16.0220928558
37	69	1	0	1	25.1349332368
37	70	5	0	5	44.2165082877
37	71	4	0	4	41.054431282
37	73	77	0	77	36.9021485566
37	74	6	0	6	40.0631312542
37	75	15	3	12	36.0459044895
37	76	2	0	2	44.3582834871
37	77	1	0	1	39.4930467682
37	78	11	1	10	41.6910601745
37	79	4	2	2	38.3333966339
37	81	10	0	10	40.808887668
37	82	6	0	6	42.1479757353
37	83	2	0	2	38.9302611455
37	84	10	4	6	37.5566206583
37	85	3	0	3	45.3941091852
37	86	3	0	3	43.2210510389
37	87	1	0	1	37.4068992995
37	88	3	1	2	38.7754495579
37	89	3	0	3	41.4391691339
37	90	4	0	4	51.2460209927
37	92	1	0	1	44.7267435042
37	95	3	0	3	30.4786803758
37	96	3	1	2	55.886296645
37	99	1	0	1	24.3998305504
37	100	1	0	1	27.0964373048
37	102	1	0	1	31.2307193978
37	103	21	0	21	31.5891107165
37	104	1	0	1	32.2054318822
37	109	1	0	1	49.9403130265
37	110	3	0	3	28.0220151798
37	111	1	0	1	47.244774346
37	112	15	2	13	29.3314460248
37	113	27	8	19	33.4683959007
37	117	1	0	1	36.5335241908
37	120	1	0	1	36.5234410671
37	121	0	0	0	36.2722516385
37	124	3	0	3	22.8336079442
37	125	5	0	5	18.0929421142
37	127	1	0	1	33.2564192259
37	129	1	0	1	20.3069389816
37	131	1	0	1	32.8487122704
37	133	1	0	1	20.8375539387
37	138	2	0	2	16.2128963038
37	140	2	0	2	29.7781824134
37	142	34	8	26	30.0285384421
37	145	2	0	2	21.811370837
37	147	1	0	1	42.4367546183
37	148	1	0	1	17.4379156799
37	164	1	0	1	48.1726160906
37	171	1	0	1	52.3409064328
37	172	1	0	1	48.6368425009
37	183	2	0	2	101.3600188
37	204	1	0	1	91.8677678448
37	209	1	0	1	102.647499726
37	213	1	0	1	110.186042931
37	220	0	0	0	121.308927605
37	245	1	0	1	47.4966126852
37	247	2	0	2	67.3472970667
37	260	1	0	1	41.9429729311
37	264	2	0	2	44.8111960415
37	277	7	1	6	66.0547803022
37	281	0	0	0	62.9785003898
37	282	1	0	1	67.4309768015
37	292	1	0	1	83.8118375767
37	300	1	0	1	69.4963946756
37	303	5	0	5	31.9183093504
37	304	7	0	7	25.952613625
37	305	1	0	1	49.1923517983
37	306	1	0	1	38.968216232
37	307	6	1	5	38.7549312104
37	350	1	0	1	75.9378109648
37	414	1	0	1	85.1133433421
37	464	1	0	1	41.0880769427
37	465	1	0	1	59.0671398526
37	466	1	0	1	61.5994388784
37	469	7	0	7	51.0500058242
37	470	1	0	1	43.0876026632
37	471	3	0	3	41.1333403847
37	472	1	0	1	40.2249765135
37	475	2	0	2	53.4806334052
37	476	3	0	3	30.2965721849
37	480	3	0	3	46.0951364194
37	481	1	0	1	62.9150507066
37	486	0	0	0	56.1491980696
37	488	2	0	2	55.7415837236
37	489	1	0	1	60.0351897134
37	491	1	0	1	53.335025946
37	495	0	0	0	68.3196928702
37	496	1	0	1	61.0824803843
37	505	1	0	1	73.7295734193
38	0	10	0	10	19.9008837685
38	1	382	39	343	29.0516856566
38	2	20	4	16	15.2682736334
38	3	21	2	19	19.0216664208
38	4	3	0	3	18.7844667328
38	5	4	0	4	30.31174634
38	6	5	0	5	31.729929082
38	7	17	8	9	18.4316352453
38	9	2	1	1	23.1299743659
38	10	5	1	4	15.1958395191
38	11	1	0	1	40.4413002974
38	12	2	0	2	34.2383484533
38	13	40	2	38	15.6618222389
38	14	6	0	6	12.9120655201
38	15	41	14	27	18.4337003368
38	17	13	6	7	16.1187249358
38	18	24	1	23	15.7915025183
38	19	1	0	1	22.0055901891
38	20	2	1	1	23.1708737422
38	21	8	0	8	25.3754324056
38	22	2	0	2	35.7860720411
38	23	8	0	8	21.5694957057
38	24	5	1	4	19.1919373548
38	26	3	0	3	18.1108874072
38	27	4	2	2	23.1228547614
38	28	7	2	5	29.1717854698
38	29	3	0	3	27.5054017097
38	30	61	0	61	6.43071425398
38	31	165	0	165	5.66986199054
38	32	5	0	5	27.9439175075
38	33	151	88	63	9.89798419795
38	34	496	27	469	7.34582592332
38	35	366	76	290	8.69691541054
38	36	769	3	766	13.2445697104
38	37	13	4	9	11.2983145922
38	39	13	0	13	23.1847660185
38	41	249	68	181	7.11347194784
38	42	23	2	21	18.7324360849
38	43	1	0	1	44.4689956582
38	46	4	0	4	32.0907866642
38	48	12	0	12	27.5276316951
38	49	10	4	6	16.0480222019
38	50	44	21	23	18.3536635163
38	51	4	0	4	13.0902718903
38	52	3	0	3	17.2491108383
38	53	2	0	2	44.2467423635
38	54	40	11	29	12.3839621877
38	55	1	0	1	30.2274559138
38	57	1	0	1	31.6285131771
38	60	7	3	4	21.4590889568
38	61	2	0	2	39.4980702234
38	62	2	0	2	48.7571853141
38	65	15	2	13	37.4968168693
38	66	0	0	0	20.8731496694
38	67	3	0	3	33.2026156882
38	68	17	6	11	18.2480795491
38	69	1	0	1	26.0541023549
38	70	4	0	4	34.4612014472
38	71	4	0	4	30.1522289583
38	72	1	0	1	31.6852004477
38	73	107	11	96	26.9240144714
38	74	9	0	9	29.5617516409
38	75	21	3	18	25.7209523653
38	76	4	1	3	34.2256970471
38	78	16	0	16	31.2397409651
38	79	9	0	9	28.9840987662
38	80	1	0	1	30.2416179338
38	81	11	0	11	31.1356962138
38	82	2	0	2	31.9934765529
38	83	5	0	5	28.8015627165
38	84	17	0	17	27.3636460379
38	85	5	3	2	34.8406001388
38	86	2	0	2	32.3294921038
38	87	9	0	9	26.7366782191
38	88	8	2	6	27.9364361591
38	89	6	1	5	33.5220109947
38	90	4	0	4	40.8187128417
38	92	2	0	2	35.7474820583
38	93	1	0	1	56.2665820504
38	95	17	0	17	21.6800590983
38	96	2	0	2	45.680946747
38	98	1	0	1	34.7567796518
38	99	23	0	23	13.2799953504
38	100	4	0	4	20.3914304079
38	102	3	0	3	25.5709260895
38	103	42	10	32	21.2726988756
38	104	4	1	3	24.5609021417
38	108	1	0	1	48.3474914106
38	110	4	0	4	17.3239521823
38	111	1	0	1	39.0720301209
38	112	41	1	40	19.5096403053
38	113	55	12	43	22.545524485
38	114	14	1	13	14.8175128715
38	116	3	0	3	36.6669253738
38	120	3	0	3	27.7606319435
38	121	0	0	0	25.2045098113
38	122	1	0	1	42.3731639554
38	124	18	4	14	17.3797589194
38	125	14	1	13	11.4520977913
38	127	2	0	2	21.9844535985
38	128	2	0	2	26.1978336206
38	129	21	13	8	9.46886943008
38	130	1	0	1	27.9893125874
38	131	4	1	3	30.7658268945
38	133	18	4	14	9.64721122295
38	134	13	3	10	15.5942030505
38	135	1	0	1	34.5758936501
38	136	2	1	1	17.7602248854
38	138	55	7	48	5.21618297873
38	140	6	2	4	18.5081010611
38	142	111	23	88	19.3675383048
38	143	2	0	2	23.0912907511
38	145	8	0	8	12.1587635937
38	146	1	0	1	26.6644775202
38	147	2	0	2	34.1195944347
38	148	22	11	11	8.5349675443
38	164	2	1	1	36.9897595344
38	171	1	0	1	41.2959926294
38	172	1	0	1	37.3718475672
38	183	0	0	0	101.291541057
38	220	0	0	0	120.660363965
38	232	0	0	0	94.5373148648
38	245	2	1	1	41.4464188557
38	250	1	0	1	49.2508686544
38	257	1	0	1	38.2641094188
38	258	1	0	1	34.8315111563
38	268	1	0	1	84.3974791199
38	271	1	0	1	83.3151898659
38	275	1	0	1	65.6538837294
38	277	4	1	3	63.7256585513
38	281	0	0	0	59.069863966
38	282	0	0	0	63.2459360388
38	303	8	2	6	35.8351266377
38	305	6	0	6	47.6744376826
38	307	6	0	6	38.9829115556
38	308	1	0	1	46.0644019968
38	309	1	0	1	31.4451208599
38	319	1	0	1	71.463159738
38	350	1	0	1	67.7696868092
38	406	1	0	1	79.5334713531
38	464	3	0	3	41.9557795441
38	465	2	0	2	56.8419376547
38	466	2	0	2	60.7983750311
38	469	4	1	3	48.7507654642
38	471	3	0	3	43.5465242606
38	472	1	0	1	38.7545781027
38	476	1	0	1	30.2916270059
38	483	1	0	1	79.3084338557
38	484	2	0	2	50.3664756451
38	488	1	0	1	58.2944602389
38	496	0	0	0	56.4588948144
38	505	0	0	0	73.4469983544
38	573	1	0	1	67.7275448408
39	0	90	6	84	9.1003936702
39	1	681	14	667	21.6349607742
39	2	4	3	1	18.4599271246
39	3	158	86	72	5.62207998676
39	5	9	0	9	30.3263939278
39	6	1	0	1	37.5250989513
39	7	28	2	26	13.4197729821
39	8	1	0	1	44.1028793897
39	9	25	8	17	8.98372180787
39	10	4	1	3	15.3011315646
39	12	1	0	1	31.3291733642
39	13	57	2	55	11.653017513
39	14	3	0	3	15.100917117
39	15	33	0	33	16.2489169515
39	16	19	4	15	5.06555119007
39	18	74	16	58	8.64759899072
39	19	17	0	17	6.82901424805
39	20	5	0	5	28.6149194058
39	21	5	0	5	26.2065984122
39	22	3	1	2	29.6077662308
39	23	2	0	2	23.4313000663
39	24	5	0	5	21.6181978176
39	25	1	0	1	41.8851082318
39	26	4	0	4	30.6897366836
39	27	2	0	2	33.1719231321
39	28	18	2	16	17.698122576
39	31	7	0	7	19.2088837134
39	32	449	40	409	5.47775983456
39	33	33	14	19	14.9507902577
39	34	3	0	3	30.0925669607
39	35	16	1	15	19.6332460155
39	36	283	0	283	10.9304694278
39	37	1	0	1	26.7292798047
39	38	2	0	2	23.1847660185
39	40	46	15	31	5.46561213284
39	41	20	9	11	16.1317522796
39	42	326	120	206	4.59145207583
39	43	18	0	18	62.0325055281
39	45	1	0	1	62.1315164143
39	46	4	0	4	45.4590437384
39	48	3	0	3	48.7231033743
39	49	4	0	4	32.8112045484
39	50	4	0	4	38.0484793027
39	51	12	2	10	32.766649181
39	53	0	0	0	52.4695702539
39	54	2	1	1	35.4302563427
39	55	1	0	1	48.5903706129
39	58	2	0	2	51.913568102
39	59	2	0	2	61.9836016764
39	60	4	0	4	41.935024294
39	61	1	0	1	56.3548188893
39	62	3	0	3	63.4327276675
39	64	2	0	2	45.5043893151
39	65	6	1	5	53.0312668428
39	67	2	0	2	48.3874748089
39	70	13	1	12	26.3624968352
39	71	2	1	1	29.9262491456
39	72	2	0	2	22.3923224623
39	73	171	21	150	22.0000727894
39	74	10	3	7	26.6448322935
39	75	29	1	28	23.0545984847
39	76	9	0	9	28.0320335052
39	77	3	0	3	21.2974623621
39	78	15	10	5	27.5538573902
39	79	19	2	17	20.5117461097
39	80	1	0	1	22.5988696572
39	81	15	0	15	23.4496044223
39	82	8	3	5	26.4368865762
39	83	7	1	6	24.0060816563
39	84	16	6	10	23.3809712738
39	85	3	0	3	30.9503999323
39	86	2	1	1	31.4653889479
39	87	12	2	10	25.8025394427
39	88	5	0	5	27.8344760128
39	89	14	0	14	18.7367573405
39	90	2	0	2	35.086621544
39	92	7	3	4	24.1735404453
39	95	26	0	26	14.3631919783
39	96	5	0	5	38.0680932688
39	98	2	0	2	35.4109453184
39	99	4	0	4	22.6002737967
39	100	44	0	44	7.72235928142
39	102	122	10	112	6.47640211686
39	103	44	8	36	20.5773668685
39	104	17	3	14	11.668172088
39	105	14	1	13	13.3869670969
39	106	6	0	6	14.4449994973
39	107	1	0	1	36.430886957
39	109	2	0	2	31.25587336
39	110	5	2	3	21.0395484188
39	111	4	0	4	24.2655124927
39	112	28	1	27	17.5536517727
39	113	44	15	29	25.0730160103
39	114	6	0	6	14.3975034076
39	115	1	1	0	29.2875992877
39	116	2	1	1	30.2781503152
39	117	1	0	1	27.1227385641
39	120	11	0	11	17.3795622604
39	121	1	0	1	28.0315854611
39	122	0	0	0	29.8041769926
39	123	1	0	1	22.3768000166
39	124	1	0	1	40.0257069524
39	128	1	0	1	41.6457359088
39	129	1	0	1	20.2461024478
39	134	1	0	1	29.4586333031
39	140	4	0	4	26.8912403868
39	142	33	0	33	34.6864677677
39	171	1	0	1	40.2004903084
39	172	1	0	1	43.8505457829
39	176	1	0	1	62.2800709786
39	183	2	0	2	78.4169497419
39	188	0	0	0	82.0942427787
39	196	1	0	1	103.529037872
39	208	1	0	1	78.7391883213
39	220	2	0	2	97.5753890905
39	225	1	0	1	78.6719988147
39	229	1	0	1	83.2811910671
39	232	0	0	0	71.8653275654
39	245	9	0	9	21.36227718
39	246	1	0	1	26.4334020913
39	251	1	0	1	33.9908387456
39	254	3	0	3	29.5031022045
39	256	24	3	21	9.56937278672
39	257	17	3	14	15.6334856866
39	258	5	0	5	11.655234199
39	260	4	0	4	15.3957954807
39	261	1	0	1	17.153737109
39	262	2	0	2	31.473494675
39	263	1	0	1	25.7387722232
39	264	6	0	6	18.8549893109
39	270	2	0	2	37.7238989554
39	271	2	0	2	60.1449301974
39	272	0	0	0	55.8369805819
39	275	1	0	1	42.6104505516
39	277	33	1	32	40.5545548974
39	281	2	0	2	36.4353091176
39	282	2	0	2	40.8097908757
39	283	1	0	1	28.3017813397
39	284	1	0	1	50.1660924377
39	291	1	0	1	60.0285659668
39	293	3	0	3	53.4630914242
39	294	0	0	0	60.2767832952
39	303	26	0	26	21.2407979105
39	304	9	0	9	10.2795697325
39	305	10	1	9	24.6202502261
39	306	3	0	3	22.3842564121
39	307	104	80	24	17.6159776926
39	308	1	0	1	25.2733278783
39	309	35	0	35	10.2252977966
39	393	1	0	1	105.598310602
39	464	1	0	1	65.0365230468
39	465	1	0	1	79.7114743362
39	466	1	0	1	83.9388705175
39	469	3	0	3	71.6618401312
39	470	1	0	1	62.6965204017
39	480	1	0	1	68.9979945051
39	489	1	0	1	86.5580789629
39	491	1	0	1	77.1422997057
39	492	1	0	1	87.1401481159
39	497	1	0	1	78.6452295737
39	505	0	0	0	96.6159941154
39	581	1	0	1	63.5733101915
40	0	11	2	9	13.8806381766
40	1	248	0	248	24.8715923021
40	2	7	1	6	23.6779264951
40	3	44	1	43	10.9809363479
40	4	1	0	1	23.7628745699
40	7	7	2	5	18.3149825829
40	8	1	0	1	47.2246539604
40	9	2	0	2	12.8049772629
40	10	1	0	1	20.5475094142
40	11	0	0	0	42.062086623
40	13	8	0	8	16.9701000538
40	15	17	2	15	21.1298517029
40	16	3	1	2	9.61682652199
40	17	3	1	2	29.6432640617
40	18	12	0	12	14.1060205199
40	19	3	0	3	11.1485936819
40	20	2	1	1	33.4413729717
40	23	3	0	3	28.1416039207
40	24	2	0	2	26.5245799094
40	25	0	0	0	46.0109035844
40	26	1	0	1	36.0054655645
40	28	8	2	6	20.3383598272
40	29	5	2	3	43.0936404809
40	30	1	0	1	30.3573111218
40	31	2	1	1	24.0031367903
40	32	373	31	342	4.99202769923
40	33	8	1	7	20.4043940187
40	34	2	1	1	35.3789299367
40	35	2	0	2	25.0988571228
40	36	96	22	74	15.5388567783
40	37	1	0	1	32.1865148626
40	38	2	0	2	28.3436676303
40	39	274	60	214	5.46561213284
40	41	1	0	1	21.381629252
40	42	67	24	43	9.61884258232
40	43	4	0	4	67.3927406026
40	46	1	0	1	50.6213163117
40	48	1	0	1	54.1777923841
40	49	1	1	0	38.2551157955
40	50	1	0	1	43.5138955349
40	51	2	0	2	38.2267363409
40	52	0	0	0	45.591485978
40	56	1	0	1	47.840778514
40	58	1	0	1	56.9645864291
40	60	1	0	1	47.3972744313
40	62	1	0	1	68.5742860545
40	65	5	1	4	58.2958058192
40	66	2	0	2	42.1140861098
40	70	6	0	6	25.0921862376
40	71	5	0	5	30.4942811838
40	72	3	0	3	21.2058694152
40	73	92	4	88	22.2487489157
40	74	5	2	3	26.842000413
40	75	10	0	10	23.7863619383
40	76	4	0	4	27.1652097653
40	77	2	1	1	20.4154388022
40	78	8	2	6	27.4426970616
40	79	8	3	5	19.8833842323
40	80	1	0	1	21.9204029616
40	81	7	0	7	22.6418799358
40	82	8	0	8	25.915922078
40	83	6	3	3	23.999339142
40	84	17	0	17	23.6952441432
40	85	1	0	1	30.4717986944
40	86	2	2	0	31.7388452357
40	87	4	1	3	26.6248480536
40	88	2	0	2	28.6388552422
40	89	15	0	15	16.0428824167
40	92	6	0	6	22.0112801374
40	93	1	0	1	37.3000578778
40	95	11	1	10	15.6216561485
40	96	2	0	2	36.131298951
40	98	1	0	1	35.7744353024
40	99	1	0	1	26.1152708377
40	100	11	2	9	10.1364873398
40	102	73	1	72	5.51876862956
40	103	16	6	10	22.258177009
40	104	5	0	5	11.6330137712
40	105	5	0	5	11.1673963723
40	106	1	0	1	10.4769198877
40	110	2	0	2	23.6985104872
40	111	1	1	0	20.9848197527
40	112	25	11	14	19.5600854025
40	113	35	1	34	26.8412305292
40	114	1	0	1	17.8043424709
40	115	1	0	1	25.5389488713
40	120	2	0	2	16.6724588385
40	129	1	0	1	24.3971113774
40	131	1	0	1	58.8924333813
40	133	1	0	1	30.2960868636
40	138	1	0	1	30.0503461546
40	140	1	0	1	29.6973258622
40	142	13	1	12	38.2051467553
40	144	1	0	1	41.0137836682
40	145	1	0	1	36.5295381583
40	155	1	0	1	42.9190419388
40	172	1	0	1	45.13454074
40	183	1	0	1	73.8429686694
40	209	1	0	1	70.4946847164
40	220	0	0	0	92.7533494712
40	226	1	0	1	78.3647231379
40	230	1	0	1	85.5265654831
40	232	0	0	0	66.450723342
40	245	13	0	13	16.406148509
40	251	2	1	1	29.6292326794
40	255	2	1	1	17.6811731252
40	256	76	34	42	4.90710069579
40	257	74	21	53	10.1713063719
40	258	6	5	1	7.02877387285
40	260	3	0	3	10.1983299759
40	261	1	0	1	13.240542765
40	262	2	0	2	26.0165103362
40	263	1	0	1	20.2736112358
40	264	7	1	6	13.7600665572
40	270	1	0	1	33.7681814238
40	271	2	0	2	55.0065248757
40	272	1	0	1	50.4464362823
40	275	1	0	1	37.9367849739
40	276	2	0	2	40.5356354887
40	277	21	0	21	35.4292523369
40	293	2	0	2	48.0656096736
40	303	8	0	8	22.2942389393
40	304	6	3	3	12.6049159506
40	305	6	1	5	20.0667782075
40	307	62	17	45	15.2552187562
40	308	2	0	2	22.8169131233
40	309	29	2	27	9.28225061703
40	329	1	0	1	56.0197297666
40	352	1	0	1	48.6685549567
40	406	1	0	1	104.952885352
40	408	1	0	1	106.263171098
40	466	2	0	2	88.9443080064
40	475	1	0	1	73.2076745008
41	0	26	7	19	13.2386575274
41	1	638	0	638	24.1460954844
41	2	16	2	14	11.5706437569
41	3	33	0	33	11.9371597998
41	4	2	0	2	14.7572904759
41	5	6	1	5	27.6130920744
41	6	4	0	4	31.0980367055
41	7	29	0	29	12.6976466177
41	9	3	0	3	16.416436756
41	10	11	5	6	10.1613882021
41	11	2	0	2	37.7184663451
41	12	3	0	3	30.8833091724
41	13	90	15	75	9.35776951161
41	14	10	1	9	7.74561625667
41	15	90	1	89	13.5470514775
41	16	5	0	5	14.8834847363
41	17	10	3	7	14.9947882093
41	18	47	5	42	8.78047110939
41	19	3	0	3	15.0804883564
41	21	10	1	9	22.5411368997
41	22	1	0	1	31.6003552422
41	23	12	0	12	18.6488448118
41	24	15	1	14	16.1060666506
41	25	1	0	1	37.1629466454
41	26	3	1	2	19.3402808931
41	27	3	0	3	23.6259361608
41	28	20	4	16	23.3731572061
41	30	23	0	23	9.74671671
41	31	136	0	136	5.21414403906
41	32	14	0	14	20.8304665216
41	33	377	332	45	4.02273790454
41	34	56	32	24	13.9987947198
41	35	206	13	193	6.76073106835
41	36	1637	281	1356	7.08978745182
41	37	10	2	8	13.263457846
41	38	75	15	60	7.11347194784
41	39	27	2	25	16.1317522796
41	42	27	15	12	11.7691462412
41	45	1	0	1	46.4122477185
41	46	3	0	3	34.43849164
41	47	1	0	1	45.4645531099
41	48	6	1	5	33.3862738464
41	49	4	1	3	19.2632142404
41	50	28	5	23	23.2675848577
41	51	3	0	3	17.8062516538
41	52	3	1	2	24.2952296109
41	53	0	0	0	44.9359409056
41	54	6	1	5	19.3025779679
41	55	1	0	1	34.7318474996
41	56	2	0	2	29.9070686065
41	59	4	0	4	47.0429185422
41	60	5	0	5	26.8644443271
41	61	5	0	5	43.477433811
41	65	20	4	16	40.8834980441
41	66	3	1	2	23.897562377
41	68	13	1	12	24.6443752339
41	70	9	1	8	31.0587335001
41	71	3	1	2	28.8866608982
41	72	1	0	1	27.7825419581
41	73	250	12	238	23.8865596267
41	74	22	0	22	27.3814499217
41	75	23	4	19	23.2690754484
41	76	6	0	6	31.3593567162
41	78	31	0	31	28.9420575785
41	79	7	1	6	25.1045912953
41	80	1	0	1	26.6950814175
41	81	20	1	19	27.6423412929
41	82	13	0	13	29.1786210977
41	83	7	0	7	25.9762703278
41	84	31	2	29	24.6596137601
41	85	3	1	2	32.700136758
41	86	4	1	3	30.9978906792
41	87	23	0	23	24.9577207785
41	88	7	2	5	26.5425436576
41	89	6	1	5	28.3293444151
41	90	5	0	5	38.3948026946
41	92	11	0	11	31.4635367466
41	93	1	0	1	51.6126749626
41	95	18	1	17	17.2176649758
41	96	5	0	5	42.8672625479
41	98	1	0	1	34.0554769911
41	99	20	10	10	13.5778398266
41	100	11	3	8	14.2864716205
41	102	17	0	17	19.0674097046
41	103	53	6	47	18.8991929217
41	104	7	4	3	19.1122905867
41	109	2	1	1	36.7758446034
41	110	18	7	11	15.9226378844
41	111	1	0	1	34.0916629867
41	112	74	11	63	16.3524319001
41	113	86	2	84	21.530652092
41	114	34	0	34	10.7788303778
41	115	1	0	1	39.6396973832
41	116	4	0	4	33.8711659376
41	117	1	0	1	24.5471500052
41	118	2	0	2	35.3776686194
41	120	3	0	3	23.261640811
41	121	1	0	1	24.5872035354
41	124	8	1	7	24.3700891209
41	129	20	4	16	9.3105760783
41	133	7	0	7	13.1680290808
41	134	3	0	3	18.5537241538
41	136	3	0	3	23.7322212258
41	137	1	0	1	30.7784109492
41	138	10	4	6	10.417399251
41	140	4	1	3	19.3227333293
41	142	86	0	86	23.2937471727
41	145	4	1	3	17.8519466154
41	146	1	0	1	26.7901583328
41	148	3	0	3	15.0602075656
41	151	1	0	1	31.0708002553
41	152	1	0	1	29.5806856611
41	155	1	0	1	45.1131497536
41	164	1	0	1	36.6165374837
41	171	2	0	2	40.3113981026
41	172	2	0	2	38.7490335288
41	173	1	0	1	52.9609410388
41	176	1	0	1	51.1274740241
41	177	2	0	2	43.6479897771
41	183	1	0	1	94.1828091243
41	187	0	0	0	100.713980972
41	188	0	0	0	98.1949578173
41	191	1	0	1	117.611629982
41	210	0	0	0	93.4254308728
41	220	0	0	0	113.549304601
41	229	1	0	1	99.1752058026
41	242	0	0	0	129.643144156
41	245	2	0	2	35.2450059255
41	253	1	0	1	55.5819987704
41	256	1	0	1	24.2478666656
41	257	1	0	1	31.4153960133
41	258	3	0	3	27.75668573
41	262	0	0	0	47.2038578745
41	275	1	0	1	58.5419747498
41	276	1	0	1	61.3773275944
41	277	14	0	14	56.6861731819
41	280	1	0	1	63.7741299659
41	284	1	0	1	65.8814807486
41	303	12	0	12	29.7568009467
41	304	4	0	4	20.1108388776
41	305	3	0	3	40.5653854265
41	307	11	0	11	31.9686471206
41	309	5	1	4	24.3922667664
41	324	1	0	1	74.4056160941
41	338	0	0	0	78.6054252296
41	346	1	0	1	117.819381078
41	354	0	0	0	60.9771482865
41	408	1	0	1	88.1654516592
41	464	1	0	1	48.9132979362
41	465	0	0	0	63.9314508101
41	466	1	0	1	67.9077050207
41	469	2	0	2	55.845342127
41	471	1	0	1	50.269383787
41	472	1	0	1	45.8657484836
41	475	4	0	4	54.4849741983
41	476	2	0	2	37.2881729459
41	486	1	0	1	67.0202886176
41	494	1	0	1	56.6518106931
41	502	1	0	1	79.3423450388
41	503	2	1	1	72.6574890269
41	522	1	0	1	108.679450339
41	573	3	0	3	71.0074105802
42	0	150	24	126	8.72349344752
42	1	802	18	784	22.3823984187
42	2	9	2	7	16.1756253017
42	3	232	11	221	4.41642940358
42	4	2	0	2	17.4110489446
42	5	15	0	15	29.8867520684
42	6	1	0	1	36.2146794488
42	7	33	1	32	12.2331821288
42	8	1	0	1	44.5097760804
42	9	35	0	35	10.1709937162
42	10	4	0	4	13.0651782564
42	11	2	1	1	38.9851082176
42	12	5	1	4	31.5741098882
42	13	65	40	25	9.40806300949
42	14	2	0	2	12.2144480015
42	15	40	1	39	14.8921377151
42	16	39	12	27	6.35993490684
42	17	4	0	4	21.886271885
42	18	93	24	69	5.75761355764
42	19	32	9	23	7.84050468185
42	20	8	0	8	26.9617607373
42	21	11	1	10	25.340488301
42	22	0	0	0	30.5173131198
42	23	4	1	3	22.1090946211
42	24	10	4	6	19.9776360381
42	25	1	0	1	41.1336356976
42	26	3	1	2	27.8718738035
42	27	2	0	2	30.9014256796
42	28	23	9	14	19.2360657722
42	30	3	0	3	20.9554493852
42	31	13	0	13	14.6200525565
42	32	199	154	45	9.91446520558
42	33	50	2	48	11.1932169335
42	34	7	0	7	25.7679071403
42	35	23	16	7	16.0405251715
42	36	717	159	558	6.37511706238
42	37	2	0	2	23.2589782103
42	38	7	5	2	18.7324360849
42	39	682	627	55	4.59145207583
42	40	22	11	11	9.61884258232
42	41	36	12	24	11.7691462412
42	43	2	0	2	58.9257764989
42	46	4	2	2	42.9463837792
42	48	5	0	5	44.8172107802
42	49	1	0	1	29.4194315411
42	50	16	0	16	34.3166988551
42	51	1	0	1	28.942011218
42	52	8	0	8	35.9815417145
42	54	2	0	2	31.051985805
42	55	2	1	1	45.2213259602
42	58	9	0	9	49.6100854778
42	59	2	0	2	58.2611684795
42	60	2	0	2	38.1165774865
42	62	1	0	1	60.8973065981
42	65	15	0	15	50.2325338817
42	67	2	0	2	45.5936784519
42	68	2	0	2	36.3518578084
42	69	2	0	2	44.6586138018
42	70	36	11	25	25.5788089335
42	71	4	1	3	27.5603149785
42	72	6	0	6	21.69386759
42	73	236	42	194	20.1331111112
42	74	15	6	9	24.6506422594
42	75	31	4	27	20.7582186994
42	76	11	1	10	26.8589645888
42	77	1	0	1	20.3968305517
42	78	24	1	23	25.7788306567
42	79	28	11	17	19.4409941306
42	80	2	0	2	21.4657737976
42	81	24	9	15	22.3870509127
42	82	16	0	16	25.0276558593
42	83	10	0	10	22.2634190558
42	84	39	2	37	21.4038562656
42	85	14	1	13	29.3841316395
42	86	5	0	5	29.2931410451
42	87	18	6	12	23.34522834
42	88	8	2	6	25.336935352
42	89	23	1	22	19.5247551321
42	90	7	0	7	34.0848255878
42	92	19	0	19	24.2348067142
42	95	45	8	37	12.1691336338
42	96	4	0	4	37.589579072
42	98	1	0	1	33.0994100532
42	99	9	1	8	18.3879338269
42	100	121	27	94	5.67928717972
42	102	166	9	157	8.04679351573
42	103	52	0	52	17.6401987398
42	104	18	0	18	10.9680316482
42	105	3	0	3	14.2374466634
42	106	2	0	2	16.6222873202
42	107	1	0	1	33.485185588
42	109	4	0	4	30.8839497887
42	110	12	6	6	17.3764343358
42	111	5	0	5	25.3282233811
42	112	76	0	76	14.5025193068
42	113	103	1	102	21.930745369
42	114	18	3	15	10.4389574306
42	115	2	1	1	30.6670225417
42	116	3	0	3	29.2537248725
42	117	4	1	3	24.2825428299
42	118	2	0	2	31.8574818414
42	119	1	0	1	34.4186906079
42	120	6	4	2	16.5803555924
42	121	0	0	0	25.0195568859
42	122	0	0	0	30.3793203772
42	123	1	0	1	24.3207502675
42	124	1	0	1	35.4509377343
42	128	0	0	0	37.4324103294
42	129	7	0	7	15.7693133181
42	134	4	0	4	25.1624402821
42	136	1	0	1	33.3382760448
42	137	0	0	0	33.9823282217
42	138	3	1	2	20.715575792
42	140	3	0	3	23.0250639322
42	142	44	8	36	30.3883330185
42	144	2	1	1	34.2809838234
42	146	3	0	3	28.0586723308
42	147	1	0	1	48.3743411601
42	148	1	0	1	25.7914860881
42	163	0	0	0	50.0223336704
42	164	3	0	3	35.978977879
42	171	3	0	3	38.3653324627
42	172	6	1	5	40.7810880942
42	177	1	0	1	44.8276401804
42	183	2	0	2	83.005745691
42	208	3	0	3	82.3886478736
42	213	2	0	2	87.3096783792
42	223	2	0	2	90.2736319123
42	229	2	0	2	87.4251205953
42	234	1	0	1	77.3800997759
42	239	1	0	1	81.9392331002
42	242	0	0	0	117.985524984
42	245	4	0	4	24.2467279845
42	251	1	0	1	35.9445372584
42	256	9	0	9	12.7434227222
42	257	13	0	13	19.6630656056
42	258	1	0	1	16.196570499
42	260	2	2	0	18.749450487
42	262	1	0	1	35.4822120796
42	264	5	0	5	23.3010593934
42	266	1	0	1	58.4001682357
42	270	1	0	1	42.2881716133
42	272	2	0	2	60.0279444803
42	274	1	0	1	39.1124310309
42	275	1	0	1	47.1872594416
42	277	21	0	21	45.0024981508
42	282	1	0	1	44.8102406996
42	284	1	0	1	54.1758745935
42	287	1	0	1	52.4349813154
42	293	3	0	3	56.9242724564
42	294	1	0	1	63.1993380606
42	296	1	0	1	51.4103022928
42	303	30	7	23	23.8784709454
42	304	5	1	4	12.7381084141
42	305	8	0	8	29.2012830198
42	306	1	0	1	26.1654795007
42	307	35	4	31	21.9408846967
42	308	3	0	3	29.5401496042
42	309	28	0	28	14.3765176324
42	319	3	0	3	70.551736377
42	321	1	0	1	64.7048743141
42	352	0	0	0	53.4667820917
42	386	0	0	0	89.5086633714
42	408	1	0	1	97.8249709868
42	464	1	0	1	60.661510032
42	465	1	0	1	75.1364487384
42	469	2	0	2	67.0923541658
42	475	2	0	2	64.4623712009
42	476	3	1	2	49.0152022329
42	480	1	0	1	64.529473943
42	491	2	1	1	72.727297653
42	496	1	0	1	73.5846123676
42	503	1	0	1	83.009948024
42	515	1	0	1	141.555638564
42	573	2	0	2	74.9413935489
43	0	5	0	5	53.9015334562
43	1	125	15	110	50.0524041037
43	2	2	0	2	43.8230465612
43	3	1	0	1	56.4267417176
43	4	2	0	2	44.5493255479
43	6	1	0	1	31.7702108528
43	7	3	0	3	49.5802677905
43	10	1	0	1	46.8908062407
43	13	3	1	2	50.4228477247
43	15	6	0	6	46.9734379757
43	16	1	0	1	58.032513499
43	17	1	0	1	37.878419884
43	20	4	0	4	36.1136650051
43	21	2	0	2	40.8954630396
43	23	7	0	7	41.2436560304
43	24	4	1	3	41.9089607546
43	26	4	0	4	31.4170815889
43	27	6	2	4	30.1456447988
43	28	4	0	4	54.4138660811
43	29	18	7	11	26.2676722317
43	30	2	0	2	39.1735298674
43	33	8	1	7	47.856616845
43	34	0	0	0	38.0668293968
43	35	2	0	2	42.9931817312
43	36	4	0	4	55.8566576316
43	37	2	1	1	35.7883313938
43	38	1	0	1	44.4689956582
43	39	1	0	1	62.0325055281
43	41	2	0	2	48.8088312877
43	44	2	0	2	15.5444424187
43	45	10	0	10	20.7315551929
43	46	135	124	11	18.3582613833
43	47	51	21	30	10.6740104635
43	48	76	2	74	19.9760071973
43	49	13	1	12	29.6306056669
43	50	21	4	17	26.1357716116
43	51	7	4	3	31.4101842159
43	52	2	1	1	34.9362519238
43	53	27	1	26	25.2406214561
43	55	26	1	25	14.24210313
43	56	22	0	22	19.5559775138
43	57	2	0	2	23.3946197705
43	58	52	9	43	15.4683872682
43	59	79	8	71	12.1732881974
43	60	16	0	16	23.5799730842
43	61	83	18	65	5.84692184337
43	62	73	4	69	9.83157026216
43	63	47	1	46	7.54110169415
43	64	11	1	10	22.2088974326
43	65	852	102	750	10.1156630529
43	66	3	0	3	25.3424058914
43	67	10	0	10	14.3051510916
43	68	16	4	12	29.0753801848
43	69	16	1	15	28.7543895168
43	70	1	0	1	78.9301425629
43	73	11	0	11	71.3856096587
43	75	2	0	2	70.0934067198
43	78	0	0	0	75.4875879998
43	79	1	0	1	73.3830400504
43	81	1	0	1	75.6003552146
43	84	3	0	3	71.7775941625
43	87	1	0	1	70.8376681702
43	90	1	0	1	85.0042615411
43	92	1	0	1	80.038319001
43	103	3	0	3	65.6821050533
43	107	1	0	1	73.6180469092
43	112	1	0	1	63.9693004543
43	113	3	2	1	66.3762098654
43	120	1	0	1	71.9072512978
43	124	1	0	1	41.4248468919
43	127	1	0	1	62.9706310502
43	131	6	1	5	37.0809878271
43	142	12	0	12	56.8848251705
43	147	0	0	0	59.0097753447
43	163	1	0	1	69.2555399721
43	164	1	0	1	79.4648761763
43	177	1	0	1	82.4113023294
43	190	2	0	2	123.335622671
43	208	0	0	0	140.476499498
43	220	1	0	1	150.887900176
43	229	1	0	1	143.226508263
43	245	1	0	1	83.1584303087
43	257	2	0	2	77.3258079964
43	266	2	0	2	107.142396028
43	274	1	0	1	94.6415068282
43	277	5	0	5	99.0926833324
43	303	2	0	2	59.8837059498
43	307	1	0	1	70.5917599785
43	415	1	0	1	81.3804761914
43	464	2	0	2	31.7331232432
43	465	1	0	1	52.4697352772
43	466	1	1	0	49.8687969897
43	469	3	0	3	47.0536813877
43	471	8	3	5	26.7757586785
43	472	2	0	2	38.35821019
43	476	6	2	4	31.1474979451
43	479	2	0	2	26.5980597866
43	480	2	0	2	37.8028202763
43	482	1	0	1	43.7170655575
43	484	8	1	7	19.3492509228
43	485	1	0	1	51.74910166
43	487	7	1	6	26.1325368423
43	488	2	0	2	34.8222352516
43	492	1	0	1	42.8108901924
43	586	1	0	1	134.27699533
44	1	11	2	9	40.7635808878
44	5	3	0	3	30.4262736078
44	12	2	0	2	33.2378151072
44	20	1	0	1	28.6214040013
44	24	1	0	1	35.4974020699
44	25	1	0	1	21.1959204557
44	26	1	0	1	27.6471527312
44	28	1	0	1	45.644435055
44	29	5	0	5	19.0440673202
44	36	3	0	3	53.469102486
44	43	2	0	2	15.5444424187
44	46	19	0	19	12.6570220369
44	47	1	0	1	24.6704095163
44	48	1	0	1	28.3629874008
44	49	2	0	2	28.708922365
44	50	3	0	3	28.5902290516
44	53	22	1	21	10.0792885153
44	55	1	0	1	19.4440991119
44	56	4	0	4	18.5198427396
44	58	17	10	7	5.6248141691
44	59	1	0	1	26.6944163971
44	60	2	0	2	28.1649706936
44	61	3	0	3	12.7274419425
44	62	27	12	15	8.47405491778
44	63	1	0	1	20.5055650787
44	64	4	0	4	11.6709110719
44	65	50	6	44	10.0566547561
44	67	1	0	1	12.4346267275
44	73	0	0	0	70.8041976782
44	74	1	0	1	74.0004314088
44	142	1	0	1	61.0094177759
44	144	1	0	1	68.0491885484
44	190	0	0	0	111.027936552
44	277	0	0	0	90.4341352406
44	303	1	0	1	49.9801730989
44	472	1	0	1	50.7254951021
44	487	1	0	1	41.6751989738
44	561	0	0	0	141.328488034
45	0	5	0	5	55.9381709381
45	1	164	0	164	57.1764832948
45	2	5	0	5	46.4756264622
45	3	2	0	2	57.0150191028
45	5	2	0	2	50.4112876787
45	7	7	5	2	52.3305230074
45	9	2	0	2	58.8313085474
45	12	3	0	3	55.0409851097
45	13	2	0	2	51.6720086732
45	15	11	1	10	50.3897447642
45	16	0	0	0	59.4177134213
45	20	3	0	3	43.2934081063
45	21	5	0	5	48.4617753963
45	22	2	0	2	59.2279136951
45	23	2	0	2	47.0972186802
45	24	4	0	4	46.6080219758
45	25	2	0	2	48.2575419774
45	26	4	0	4	35.6056189266
45	27	2	0	2	37.4102719423
45	28	7	0	7	60.3704686745
45	29	6	0	6	35.9732995329
45	30	3	0	3	37.214809245
45	33	4	1	3	47.20828624
45	34	4	0	4	32.6753422268
45	35	10	0	10	42.743830255
45	36	18	0	18	53.1896133534
45	37	1	0	1	36.2466964072
45	38	1	0	1	40.0202435378
45	39	2	0	2	62.1315164143
45	41	2	0	2	46.4122477185
45	42	2	0	2	58.0629948067
45	43	47	3	44	20.7315551929
45	46	59	30	29	30.457847078
45	47	172	57	115	10.1530045633
45	48	549	0	549	13.8589324447
45	49	14	4	10	31.0478943308
45	50	103	26	77	24.7942907489
45	51	2	0	2	29.5959135669
45	52	2	0	2	24.3357742784
45	53	5	0	5	42.8165527913
45	54	4	0	4	27.9838720293
45	55	27	3	24	19.2539841788
45	56	5	0	5	26.6000784285
45	57	95	40	55	8.52890225005
45	58	9	0	9	32.0795197081
45	59	1197	51	1146	8.61245325699
45	60	71	0	71	20.7477018923
45	61	5	0	5	21.9116956844
45	62	6	0	6	30.5309740406
45	63	24	0	24	14.1543440324
45	65	234	0	234	25.393917452
45	66	2	1	1	29.3363665081
45	67	3	0	3	26.3949335761
45	68	193	16	177	21.7990138682
45	69	89	14	75	15.0759176243
45	70	1	0	1	72.2958562946
45	71	3	0	3	64.9788482088
45	72	1	0	1	70.2876015764
45	73	32	0	32	64.8276099824
45	74	1	0	1	66.0190813563
45	75	6	0	6	63.0058567457
45	76	3	0	3	71.3019131981
45	78	2	0	2	67.6986602154
45	79	1	0	1	67.6952115678
45	81	1	1	0	69.288064465
45	82	2	0	2	69.1708247337
45	84	7	1	6	64.8058852063
45	85	2	0	2	70.6675986642
45	87	4	0	4	62.9318017641
45	88	2	0	2	63.3293400795
45	89	1	0	1	73.2302344626
45	90	2	0	2	76.63364293
45	92	1	0	1	74.610221144
45	94	1	0	1	86.9707429224
45	103	8	0	8	59.011326027
45	109	1	0	1	77.5999400269
45	110	1	0	1	54.6395694582
45	111	1	0	1	78.541843726
45	112	3	0	3	58.2234194264
45	113	14	1	13	58.2784264959
45	124	6	2	4	29.1782103922
45	126	1	0	1	28.7704681088
45	128	2	0	2	46.7110239192
45	130	1	0	1	43.1335717856
45	131	19	1	18	19.2048687046
45	133	1	0	1	43.6264821754
45	135	1	0	1	47.3627682074
45	138	1	0	1	40.6941474352
45	141	1	0	1	45.7183540027
45	142	27	0	27	45.3866829446
45	145	1	0	1	38.5157681849
45	147	2	0	2	42.1004006231
45	151	5	0	5	23.3100138262
45	153	2	0	2	36.3176421825
45	158	1	0	1	73.4717074201
45	188	1	0	1	143.002721891
45	190	1	0	1	131.765137012
45	206	1	0	1	131.939238049
45	208	1	0	1	140.141285564
45	213	1	0	1	145.282076729
45	229	1	0	1	145.411682015
45	236	1	0	1	128.233961653
45	245	1	0	1	81.4609751184
45	262	0	0	0	93.5393189589
45	266	1	0	1	113.077315127
45	267	1	0	1	108.60538613
45	277	2	0	2	102.195047088
45	282	0	0	0	102.871202461
45	287	1	0	1	110.305719297
45	293	1	0	1	114.468421296
45	303	1	0	1	66.8853897077
45	307	1	0	1	74.9545107094
45	334	1	0	1	125.009950375
45	394	1	0	1	68.3971625222
45	431	1	0	1	80.6483991279
45	464	84	27	57	11.001944953
45	465	2	0	2	32.0047747673
45	466	31	5	26	30.4708918073
45	468	2	0	2	24.0097295379
45	469	65	7	58	26.3223716304
45	470	1	0	1	24.6116962933
45	471	89	17	72	6.57999882148
45	472	10	1	9	18.1603906309
45	474	1	0	1	30.1404983413
45	475	4	0	4	38.7541201291
45	476	115	7	108	14.0003021995
45	477	5	2	3	22.9525909447
45	479	56	42	14	6.66740035223
45	480	46	0	46	17.1349455419
45	481	2	0	2	26.7461850569
45	482	3	0	3	31.4125788622
45	483	1	0	1	40.2665670555
45	484	304	82	222	11.1532915863
45	485	2	0	2	37.95896788
45	486	14	2	12	20.7891991957
45	487	83	1	82	15.383472136
45	488	21	5	16	19.7236083551
45	489	14	4	10	25.2587545302
45	490	6	0	6	11.6184446255
45	491	10	0	10	20.1584270336
45	492	1	0	1	27.0610517939
45	493	2	0	2	39.3966515178
45	495	0	0	0	40.2121066264
45	496	1	0	1	40.8793835736
45	497	1	0	1	45.9340111553
45	499	1	0	1	40.3273163803
45	503	3	0	3	47.3245434304
45	504	1	0	1	36.4923393377
45	505	1	0	1	40.5141447037
45	507	1	0	1	170.580015956
45	555	1	0	1	102.531447114
45	573	0	0	0	80.6634155618
46	0	10	2	8	36.8079544396
46	1	505	63	442	31.7321577255
46	3	1	0	1	39.8555550392
46	4	4	0	4	27.0706001567
46	5	20	7	13	22.44789412
46	6	61	21	40	13.7696385394
46	7	5	1	4	32.3823288013
46	8	6	0	6	29.0051032234
46	10	6	1	5	30.1641960467
46	11	1	0	1	26.3654079502
46	12	5	2	3	26.4717174772
46	13	10	1	9	33.8455394414
46	15	21	5	16	29.6320951902
46	17	11	2	9	21.0981401376
46	18	6	0	6	37.2499078383
46	20	22	1	21	18.0178721877
46	21	21	3	18	22.6121596708
46	22	2	1	1	31.0798763287
46	23	19	3	16	23.3137629778
46	24	17	0	17	24.3315641808
46	25	14	1	13	17.8366614154
46	26	20	3	17	15.2277920898
46	27	43	0	43	12.4023019688
46	28	7	3	4	36.194133777
46	29	356	8	348	7.99206102684
46	30	3	0	3	25.8200811771
46	33	2	1	1	32.4853643267
46	34	9	2	7	27.6771654578
46	35	11	1	10	27.8781479939
46	36	23	1	22	41.0706625994
46	37	2	0	2	21.3189215021
46	39	3	1	2	45.4590437384
46	41	1	0	1	34.43849164
46	43	35	7	28	18.3582613833
46	44	8	0	8	12.6570220369
46	45	1	0	1	30.457847078
46	47	10	0	10	22.3089947846
46	48	54	0	54	19.9193626995
46	49	14	2	12	16.0764785333
46	50	63	15	48	16.7431866926
46	51	16	1	15	19.9796891902
46	52	1	0	1	29.9882064241
46	53	214	61	153	14.6231360294
46	54	7	0	7	27.9848772163
46	55	39	10	29	11.43636583
46	56	121	4	117	6.5657346614
46	57	2	0	2	27.3852378823
46	58	141	3	138	7.03682831478
46	59	14	1	13	24.6172230432
46	60	21	5	16	17.3350803437
46	61	44	11	33	12.6026711739
46	62	35	4	31	17.9770334541
46	63	4	1	3	18.4043545472
46	64	148	117	31	5.96748950521
46	65	1143	207	936	8.2819469429
46	66	5	2	3	11.3115649512
46	67	138	0	138	4.41304537162
46	68	8	0	8	23.4839970089
46	70	2	0	2	65.487169789
46	71	2	1	1	62.212098501
46	73	45	21	24	58.2139822132
46	74	3	0	3	61.3598612341
46	75	3	0	3	57.3590976985
46	77	1	0	1	60.68959771
46	78	2	0	2	62.9964138136
46	79	0	0	0	59.5380271766
46	81	1	0	1	62.0733036652
46	82	1	0	1	63.4657583314
46	83	2	0	2	60.2482676566
46	84	3	0	3	58.8755039429
46	85	0	0	0	66.6864116716
46	87	1	0	1	58.6617476101
46	88	1	0	1	59.9658997589
46	90	2	0	2	72.5590568944
46	92	1	0	1	65.7774916055
46	94	1	0	1	78.1556047784
46	96	1	0	1	77.2022579347
46	97	1	0	1	85.7764072122
46	103	4	0	4	52.8985822058
46	104	1	0	1	52.9056409363
46	110	1	0	1	49.2485402972
46	111	1	0	1	67.9165126345
46	112	5	0	5	50.6434111573
46	113	4	1	3	54.6053501239
46	124	1	0	1	36.3059618623
46	131	1	0	1	38.7967947172
46	142	10	3	7	48.7654685418
46	146	1	0	1	58.6548420958
46	147	1	0	1	56.4991399721
46	152	1	0	1	43.7862387978
46	153	1	0	1	50.5296316107
46	155	1	0	1	78.4885694003
46	172	1	0	1	68.4928672433
46	177	2	1	1	73.8960532923
46	184	1	0	1	104.290937101
46	204	2	0	2	109.780444625
46	209	2	0	2	119.59877793
46	232	0	0	0	114.062672536
46	245	1	0	1	66.8172264672
46	250	0	0	0	72.4721802821
46	254	1	0	1	74.8986715111
46	257	2	0	2	60.2458652718
46	262	0	0	0	75.4127852248
46	277	8	1	7	81.0418059881
46	281	0	0	0	79.8682489961
46	282	1	0	1	84.4774370961
46	294	1	0	1	105.716123472
46	303	3	0	3	41.5354444977
46	304	1	0	1	40.905044746
46	307	2	0	2	52.485301649
46	308	1	0	1	56.4573712609
46	309	2	0	2	47.508277597
46	464	2	0	2	39.9283966093
46	465	1	0	1	61.0649274818
46	466	1	0	1	60.7243916131
46	467	1	0	1	68.588005484
46	469	5	1	4	54.0583650739
46	471	7	0	7	36.9643783809
46	474	1	0	1	60.4083527178
46	482	1	0	1	59.5355813512
46	484	3	0	3	34.7476824518
46	487	1	0	1	41.662473122
46	489	1	0	1	47.9587852964
46	490	1	0	1	41.357818634
46	491	3	1	2	50.5906249655
46	495	0	0	0	69.8666231012
46	503	1	0	1	75.1778571422
46	504	1	0	1	63.0402838269
47	0	1	0	1	52.9791957832
47	1	81	2	79	51.8853586616
47	5	1	0	1	43.9035961222
47	6	2	0	2	35.9198965239
47	8	1	0	1	51.1161107448
47	10	1	0	1	45.809752258
47	12	2	0	2	48.289789274
47	13	2	0	2	49.0113032146
47	15	10	1	9	46.660599595
47	17	1	0	1	37.4133810541
47	20	3	1	2	37.6626481451
47	21	2	0	2	42.8027154029
47	22	3	0	3	52.7383663324
47	23	2	0	2	42.1629918541
47	24	2	0	2	42.1871131549
47	25	1	0	1	40.031528159
47	26	2	1	1	31.0226740825
47	27	4	0	4	31.5277245753
47	29	8	1	7	29.011069467
47	32	1	0	1	63.4307114307
47	33	1	0	1	45.3866956304
47	34	1	0	1	32.8961608194
47	35	5	0	5	40.5986168049
47	36	7	1	6	52.5242239725
47	37	1	0	1	33.5063691421
47	39	1	0	1	60.2168535953
47	41	2	0	2	45.4645531099
47	42	1	0	1	56.5649180486
47	43	122	0	122	10.6740104635
47	45	37	9	28	10.1530045633
47	46	64	7	57	22.3089947846
47	48	219	91	128	12.6931941914
47	49	7	0	7	27.5504454122
47	50	44	4	40	22.2586917347
47	51	1	0	1	27.6870061635
47	52	1	0	1	27.2865542112
47	53	3	0	3	33.3115227869
47	54	1	0	1	29.3495614684
47	55	34	0	34	12.5335629739
47	56	7	0	7	20.1022880498
47	57	12	2	10	13.4461615803
47	58	6	0	6	22.6334830385
47	59	386	34	352	2.30839883284
47	60	20	3	17	18.6178711324
47	61	22	0	22	12.0323623215
47	62	13	0	13	20.4117009498
47	63	54	37	17	4.24197084925
47	64	9	1	8	27.7103450897
47	65	364	28	336	15.9576637567
47	66	1	0	1	24.4615808622
47	67	6	1	5	17.9488293265
47	68	56	17	39	22.492545215
47	69	27	1	26	19.6010433592
47	70	2	0	2	73.9458327047
47	71	3	1	2	67.7555770206
47	73	12	1	11	66.3660436472
47	74	2	0	2	68.2188230384
47	81	1	0	1	70.7404384381
47	84	1	0	1	66.5652359633
47	90	1	0	1	79.2448674158
47	95	1	0	1	61.6639689435
47	96	1	0	1	84.3992926332
47	102	1	0	1	64.3754924976
47	107	1	0	1	66.6016948365
47	112	1	0	1	59.250127935
47	113	6	0	6	60.5747943078
47	124	1	0	1	33.3492675149
47	129	1	0	1	48.7979722074
47	131	3	1	2	26.9525058244
47	142	8	0	8	49.4339949044
47	149	1	0	1	45.2240462851
47	190	1	0	1	126.397659429
47	212	1	0	1	126.737259006
47	220	0	0	0	152.98716613
47	245	0	0	0	80.64524836
47	250	1	0	1	87.6873675395
47	260	1	0	1	75.3134566348
47	262	0	0	0	91.6176376282
47	272	1	0	1	115.52886071
47	275	1	0	1	99.1648060931
47	277	1	0	1	99.1766548429
47	282	0	0	0	100.933024666
47	303	1	0	1	61.7857707791
47	307	2	0	2	71.1484714278
47	309	1	0	1	65.0055284204
47	408	0	0	0	75.339409762
47	464	11	2	9	21.1345198402
47	465	0	0	0	42.1130561248
47	466	0	0	0	40.1110019118
47	469	8	0	8	36.4445730494
47	471	3	0	3	16.4651653635
47	476	6	4	2	21.082778882
47	479	4	0	4	15.93948177
47	480	1	0	1	27.286880422
47	482	1	0	1	37.2661878868
47	484	28	6	22	12.6613553253
47	485	1	1	0	44.7471066426
47	486	1	0	1	23.5360609803
47	487	6	2	4	19.4519449868
47	488	4	1	3	26.8037154966
47	489	1	0	1	26.8987205274
47	490	1	0	1	19.3910290893
47	491	1	0	1	29.580413636
47	573	0	0	0	88.6252704704
48	0	4	0	4	42.1957250207
48	1	582	0	582	43.4703459642
48	2	12	1	11	32.6353587175
48	3	3	0	3	43.4727720687
48	4	4	0	4	34.7705264523
48	5	8	0	8	37.2860829178
48	6	8	1	7	31.1626539491
48	7	18	2	16	38.5111543594
48	8	1	0	1	47.8719071671
48	9	5	1	4	45.0415850397
48	10	4	0	4	35.1163170333
48	11	2	0	2	44.2354912261
48	12	6	0	6	42.0130244283
48	13	18	2	16	37.9851388635
48	15	49	1	48	36.5366311047
48	17	6	0	6	27.6301105069
48	18	3	1	2	40.1671609201
48	19	1	1	0	45.051428063
48	20	10	2	8	29.8089824345
48	21	9	2	7	34.9310380854
48	22	10	0	10	45.9956472727
48	23	17	1	16	33.3525701936
48	24	14	0	14	32.7786380326
48	25	5	0	5	36.8133420502
48	26	20	4	16	21.8687151193
48	27	9	1	8	24.1596572917
48	28	9	0	9	46.5469711237
48	29	17	2	15	23.5727472334
48	30	7	1	6	23.8617822377
48	31	4	0	4	33.1527031629
48	32	4	1	3	52.380979554
48	33	7	0	7	33.7735682718
48	34	53	3	50	20.3202141323
48	35	77	1	76	29.1643707631
48	36	59	5	54	40.3600868277
48	37	18	0	18	22.468965179
48	38	2	0	2	27.5276316951
48	39	1	0	1	48.7231033743
48	41	7	0	7	33.3862738464
48	42	3	0	3	44.8172107802
48	43	56	0	56	19.9760071973
48	44	1	0	1	28.3629874008
48	45	118	2	116	13.8589324447
48	46	122	22	100	19.9193626995
48	47	165	0	165	12.6931941914
48	49	81	44	37	17.19142611
48	50	565	332	233	10.9591273109
48	51	24	11	13	15.9728538641
48	52	20	1	19	15.0384050989
48	53	16	0	16	34.1273453704
48	54	36	6	30	16.6637034558
48	55	153	5	148	9.04054796395
48	56	49	4	45	14.4389290661
48	57	96	42	54	7.76302527955
48	58	14	2	12	24.0405357499
48	59	512	54	458	13.8885990999
48	60	532	114	418	6.91685139104
48	61	27	4	23	17.208427899
48	62	8	1	7	27.7775463179
48	63	33	15	18	12.8990442802
48	64	2	0	2	25.8603683534
48	65	699	5	694	18.3285546679
48	66	19	0	19	15.8250832218
48	67	12	1	11	16.9213506788
48	68	923	580	343	9.80207484018
48	69	150	22	128	9.62535743201
48	70	3	0	3	61.2735313918
48	71	3	0	3	55.0966520102
48	73	60	0	60	53.696924656
48	74	11	2	9	55.5261354758
48	75	13	0	13	52.1210200979
48	76	1	0	1	60.6212905812
48	78	8	0	8	57.2328204902
48	79	1	0	1	56.1877745084
48	81	7	0	7	58.0836634198
48	82	3	0	3	58.4197564792
48	83	1	0	1	55.3531282793
48	84	9	0	9	53.8809942174
48	85	2	0	2	60.5076284481
48	86	2	0	2	57.1996027585
48	87	2	0	2	52.484179293
48	88	2	1	1	53.1962886124
48	89	2	0	2	61.0495221736
48	92	1	0	1	63.0516572688
48	95	2	0	2	49.1646476706
48	96	1	0	1	71.7104996817
48	98	1	0	1	58.5959910924
48	99	1	0	1	38.8199427876
48	100	1	0	1	47.6054768561
48	102	1	0	1	52.4369814087
48	103	13	2	11	47.8687722638
48	104	1	0	1	52.0532751311
48	105	1	0	1	56.8559452244
48	107	2	0	2	54.1700192254
48	109	1	0	1	66.8023336548
48	110	1	0	1	43.5691978845
48	112	16	0	16	46.6322220471
48	113	23	7	16	47.8874649675
48	114	2	0	2	42.3150936027
48	117	2	0	2	50.6562131951
48	120	3	0	3	55.2056119422
48	124	31	9	22	21.4593813233
48	125	1	0	1	22.5876012233
48	126	1	0	1	25.8250636819
48	128	2	0	2	40.3944255194
48	129	1	0	1	36.1616254574
48	131	32	18	14	19.2808861809
48	134	1	0	1	37.0039309832
48	138	3	0	3	29.2398246491
48	140	1	0	1	42.3491536933
48	142	82	0	82	37.1602794363
48	143	1	0	1	33.4705314601
48	145	2	0	2	29.009800154
48	147	8	0	8	39.558482062
48	148	2	0	2	25.9131869556
48	149	2	0	2	37.7499447698
48	151	6	2	4	18.7683473068
48	152	2	0	2	27.7358362778
48	160	1	0	1	50.939342188
48	166	1	0	1	78.1690447004
48	172	4	0	4	57.1482807022
48	183	1	0	1	123.506325754
48	208	1	0	1	127.161821658
48	214	1	0	1	120.538153823
48	242	0	0	0	160.807596118
48	251	1	0	1	78.3527074182
48	257	1	0	1	64.3480006029
48	262	0	0	0	80.1942725126
48	264	3	0	3	67.1638886768
48	267	1	0	1	94.746559574
48	275	1	0	1	89.1008733387
48	277	11	7	4	88.5083331987
48	282	0	0	0	89.5313642637
48	287	1	0	1	96.7784996982
48	288	1	0	1	95.9337794481
48	303	12	0	12	53.1082040266
48	304	1	0	1	48.3454742362
48	305	1	0	1	71.6613157071
48	307	3	0	3	61.1155874352
48	309	1	0	1	54.4767949389
48	319	1	0	1	91.4948955696
48	323	2	0	2	81.8723178703
48	345	1	0	1	130.557899339
48	347	0	0	0	85.0837388699
48	464	49	0	49	20.8383205302
48	465	6	1	5	41.4767751994
48	466	20	2	18	41.9880891694
48	467	1	0	1	49.4505796393
48	468	7	4	3	25.2629826168
48	469	72	0	72	34.2377346891
48	470	3	0	3	28.8409532587
48	471	11	5	6	19.3384774235
48	472	10	3	7	23.557245588
48	474	3	0	3	43.3018547477
48	475	12	2	10	42.45318736
48	476	63	9	54	13.7617153939
48	477	2	0	2	33.5714077232
48	478	1	0	1	48.7960171664
48	479	24	0	24	14.3351415761
48	480	10	2	8	26.8234396956
48	481	1	0	1	40.4477633099
48	482	1	0	1	45.2711504988
48	484	36	1	35	23.0736884972
48	486	3	2	1	33.8020669793
48	487	14	0	14	28.7383294739
48	488	6	0	6	33.5384027383
48	489	1	0	1	37.867060321
48	490	2	0	2	25.4255721291
48	491	8	1	7	32.5140735228
48	493	1	0	1	52.8409163545
48	494	3	0	3	38.5337290146
48	495	2	1	1	50.4666371683
48	499	1	0	1	49.4281221429
48	500	1	0	1	45.6551641916
48	501	1	0	1	54.8752755474
48	503	3	0	3	55.2829306242
48	504	1	0	1	43.1223208615
48	505	1	0	1	53.1950416219
48	507	1	0	1	175.505337505
48	573	0	0	0	78.9310291023
49	0	6	0	6	25.4427576213
49	1	656	369	287	26.5768007476
49	2	9	0	9	15.5816435655
49	3	5	1	4	27.3003600974
49	4	2	1	1	17.5794094519
49	5	10	2	8	22.0112842711
49	6	10	7	3	19.0081766159
49	7	15	0	15	21.5185024033
49	9	2	1	1	28.1195486149
49	10	3	1	2	18.2768708533
49	11	1	0	1	30.7824907422
49	12	4	1	3	26.7692458935
49	13	26	0	26	21.4696665018
49	14	4	1	3	17.7886638323
49	15	74	11	63	19.4023403429
49	16	2	0	2	29.2855262586
49	17	40	9	31	10.4487349952
49	18	3	0	3	24.1691515265
49	19	7	1	6	28.365356332
49	20	13	2	11	13.8815436532
49	21	16	0	16	18.6254855615
49	22	2	0	2	30.1532688145
49	23	17	13	4	16.4466284163
49	24	23	0	23	15.637047289
49	26	115	39	76	5.44933541208
49	27	18	3	15	9.90275656201
49	28	7	0	7	29.3984424947
49	29	38	10	28	12.746248724
49	30	32	1	31	9.93506686979
49	32	3	0	3	35.8806221174
49	33	18	0	18	18.2692415526
49	34	46	0	46	12.0324249122
49	35	158	0	158	13.3992147908
49	36	41	2	39	26.2599374147
49	37	102	50	52	6.17212383943
49	38	2	1	1	16.0480222019
49	39	1	0	1	32.8112045484
49	41	8	1	7	19.2632142404
49	42	3	1	2	29.4194315411
49	43	2	0	2	29.6306056669
49	45	2	1	1	31.0478943308
49	46	27	23	4	16.0764785333
49	47	2	0	2	27.5504454122
49	48	68	0	68	17.19142611
49	50	476	35	441	6.42381726822
49	51	64	26	38	4.74529542147
49	52	8	4	4	17.827684825
49	53	4	1	3	29.0452701339
49	54	8	0	8	13.9756901389
49	55	11	0	11	15.8060959154
49	56	19	0	19	10.7351876091
49	57	1	1	0	24.129660094
49	58	1	0	1	23.0850492413
49	59	18	1	17	29.4396636614
49	60	46	11	35	10.3804100059
49	61	3	0	3	24.2218711719
49	62	1	0	1	32.8943836701
49	63	2	1	1	25.4541823741
49	64	5	0	5	19.6004438534
49	65	82	4	78	21.7035311293
49	66	56	23	33	4.828847819
49	67	2	0	2	17.2665501727
49	68	51	24	27	12.8791009889
49	69	2	0	2	21.6241536728
49	70	1	0	1	49.9757206788
49	72	1	0	1	46.8908071682
49	73	45	1	44	42.5637114412
49	74	6	3	3	45.493976053
49	75	4	0	4	41.5592664154
49	76	1	0	1	49.9780506444
49	78	4	0	4	47.1526799277
49	81	3	0	3	46.5851293942
49	84	8	5	3	43.1342460962
49	85	1	0	1	50.8022006193
49	87	2	0	2	42.7295140247
49	88	1	0	1	43.9742444921
49	89	3	0	3	47.5420534583
49	90	1	0	1	56.7342251462
49	95	1	0	1	36.4195347343
49	103	7	0	7	37.0915512565
49	106	1	0	1	45.9063589614
49	107	1	0	1	47.6757084516
49	112	5	1	4	35.0133213107
49	113	12	11	1	38.5911681018
49	124	1	0	1	22.9598688841
49	125	1	0	1	19.4745396927
49	131	4	1	3	30.4095988575
49	138	3	0	3	20.3015919106
49	142	22	1	21	33.182137593
49	151	2	0	2	25.7942391671
49	172	1	0	1	52.6068514343
49	183	2	0	2	106.315793864
49	220	0	0	0	126.40250017
49	242	0	0	0	143.735140408
49	245	0	0	0	53.6621251587
49	262	1	0	1	64.1103640928
49	263	1	0	1	58.4663832654
49	270	1	0	1	64.9067311998
49	277	4	1	3	71.7201922546
49	303	4	0	4	36.0352394807
49	304	3	0	3	31.2944387903
49	305	2	0	2	54.7699520957
49	306	1	0	1	43.5765348833
49	307	1	0	1	44.010163176
49	309	3	0	3	37.5684148816
49	319	1	0	1	87.0648339428
49	338	0	0	0	97.2162834856
49	408	2	0	2	85.3198246479
49	464	7	0	7	36.9477173891
49	465	2	0	2	56.0365557075
49	466	5	0	5	57.8689525381
49	469	6	0	6	48.1814735681
49	471	5	0	5	36.3522983232
49	472	2	1	1	37.197403237
49	476	5	0	5	26.9327311376
49	477	1	0	1	49.1976459214
49	480	1	0	1	42.3597003609
49	481	1	0	1	57.5075486692
49	482	1	0	1	62.4564521029
49	484	3	0	3	39.5614355976
49	488	2	0	2	50.7225313201
49	489	1	0	1	54.2537968444
49	494	2	0	2	51.1043876754
49	498	0	0	0	69.7078413587
50	0	13	1	12	31.2644415088
50	1	778	0	778	32.9954638302
50	2	12	2	10	21.681890393
50	3	7	0	7	32.694820231
50	4	1	0	1	23.9065688076
50	5	15	0	15	27.9606351
50	6	2	0	2	23.6465183882
50	7	25	2	23	27.5520270505
50	8	2	0	2	40.5192581704
50	9	5	0	5	34.0874161488
50	10	3	1	2	24.165305654
50	11	2	0	2	36.1510552902
50	12	6	0	6	32.7432907089
50	13	21	0	21	27.0969247659
50	14	3	1	2	23.3498118527
50	15	93	42	51	25.600405238
50	17	16	1	15	16.8342503889
50	18	6	0	6	29.4319796599
50	19	3	1	2	34.1366942077
50	20	13	3	10	19.9873732601
50	21	10	1	9	24.8983551805
50	22	2	0	2	36.3341320257
50	23	19	8	11	22.8602637484
50	24	30	1	29	22.0447744373
50	25	2	0	2	30.0900784375
50	26	71	3	68	11.6129903156
50	27	9	0	9	15.1463061235
50	28	11	0	11	35.7929494615
50	29	37	14	23	16.4432242093
50	30	47	22	25	13.5280160567
50	31	8	0	8	23.9872748178
50	32	2	0	2	41.5223705958
50	33	34	4	30	23.1552350448
50	34	128	0	128	12.0910880418
50	35	209	4	205	18.4171600618
50	36	85	35	50	30.3510634571
50	37	65	11	54	11.536048223
50	38	4	0	4	18.3536635163
50	39	5	3	2	38.0484793027
50	41	1	0	1	23.2675848577
50	42	1	0	1	34.3166988551
50	43	10	0	10	26.1357716116
50	45	13	5	8	24.7942907489
50	46	72	1	71	16.7431866926
50	47	9	0	9	22.2586917347
50	48	324	2	322	10.9591273109
50	49	301	182	119	6.42381726822
50	51	124	14	110	5.46300191489
50	52	26	2	24	13.5213022902
50	53	11	0	11	31.0855781133
50	54	49	27	22	11.2844151125
50	55	81	23	58	11.8987756402
50	56	76	0	76	10.2286864822
50	57	7	0	7	17.708206423
50	58	11	0	11	23.1670005598
50	59	55	0	55	23.9502613317
50	60	437	52	385	4.0468958405
50	61	12	1	11	21.3492936843
50	62	1	0	1	31.1459862752
50	63	4	0	4	20.8171010446
50	64	9	0	9	21.6810314553
50	65	340	7	333	19.9603451489
50	66	60	16	44	7.10039014107
50	67	3	1	2	16.2291529846
50	68	345	205	140	7.42502548184
50	69	22	0	22	15.4872267747
50	70	10	2	8	52.8059686015
50	71	4	0	4	47.8714453566
50	73	96	5	91	45.2539933774
50	74	11	1	10	47.6848457564
50	75	15	1	14	43.9620039969
50	76	2	0	2	52.4957489562
50	78	4	0	4	49.3816681903
50	79	1	0	1	47.3218670855
50	80	1	0	1	48.5952253416
50	81	12	4	8	49.4881603319
50	82	6	3	3	50.2646879568
50	83	4	0	4	47.0929237591
50	84	7	0	7	45.6424012582
50	85	1	0	1	52.8884762182
50	87	4	0	4	44.7608613618
50	88	1	0	1	45.771325856
50	89	2	0	2	51.4646229875
50	90	2	1	1	58.9209080679
50	92	3	0	3	54.042996589
50	95	1	0	1	39.8669447475
50	98	1	0	1	52.0099673483
50	99	1	0	1	31.0103543737
50	100	1	0	1	37.5485822037
50	102	2	2	0	42.1179398145
50	103	5	3	2	39.5466878856
50	104	1	0	1	42.3046164849
50	105	1	0	1	46.9754509408
50	110	7	2	5	35.4521332933
50	111	1	0	1	57.1442837449
50	112	14	0	14	37.8632997208
50	113	25	1	24	40.354105841
50	114	1	0	1	33.0256062103
50	117	1	0	1	43.3119127535
50	120	1	0	1	45.9762205094
50	124	31	0	31	19.6212935465
50	127	1	0	1	37.7104024669
50	129	1	0	1	27.6696286407
50	131	8	1	7	24.7146584401
50	133	1	0	1	25.7677838156
50	136	2	1	1	26.1082605843
50	137	1	0	1	44.2669866382
50	138	7	0	7	21.4045777021
50	140	1	0	1	35.4505231984
50	142	49	11	38	32.468540979
50	143	1	0	1	31.3420783025
50	144	2	0	2	39.4965693442
50	145	1	0	1	23.6843904386
50	147	3	0	3	39.955537677
50	148	5	0	5	19.6291886662
50	155	1	0	1	63.8515178319
50	166	1	0	1	72.0073475929
50	169	1	0	1	69.0774092666
50	177	0	0	0	57.9203494171
50	183	2	0	2	112.612187666
50	188	1	0	1	118.228863414
50	207	1	0	1	111.498234357
50	208	1	0	1	116.697817465
50	211	1	0	1	124.240972839
50	220	0	0	0	132.650561502
50	240	1	0	1	151.7086874
50	242	1	0	1	149.848497918
50	245	1	0	1	58.3915912461
50	249	0	0	0	73.1241090765
50	257	2	0	2	53.6798513755
50	258	1	0	1	48.9539070848
50	262	1	0	1	69.5067584459
50	263	0	0	0	63.7872091765
50	271	1	0	1	96.9815570463
50	274	1	0	1	72.354349272
50	277	17	1	16	77.5907429246
50	282	1	0	1	78.837537597
50	293	1	0	1	91.2312612377
50	303	5	0	5	42.4517713896
50	304	2	0	2	37.3871634856
50	305	1	0	1	60.7182335947
50	306	1	0	1	49.9398165521
50	307	8	1	7	50.1619287541
50	309	2	0	2	43.5270891285
50	319	1	0	1	87.1211206073
50	377	0	0	0	105.117637582
50	379	0	0	0	75.9685048157
50	396	1	0	1	71.593118369
50	416	1	0	1	82.3410096453
50	464	34	5	29	30.5425668752
50	465	4	0	4	49.891322108
50	466	7	1	6	51.5128942649
50	468	1	0	1	30.212980038
50	469	26	1	25	42.125002498
50	471	12	0	12	29.9598818979
50	472	7	1	6	31.1242407436
50	475	1	0	1	47.28517493
50	476	11	1	10	20.7932317327
50	479	4	0	4	24.3117414197
50	480	4	1	3	36.0220095455
50	484	3	0	3	33.7722962402
50	486	2	0	2	44.6213901096
50	487	2	0	2	39.6513095889
50	488	8	0	8	44.4055179317
50	489	1	0	1	48.5479697317
50	491	4	0	4	42.649572845
50	494	1	0	1	45.3539146562
50	501	1	0	1	64.253244211
50	503	2	0	2	62.3740168308
50	504	1	0	1	49.8024898356
50	505	2	0	2	63.2539468484
50	507	1	0	1	179.176769466
50	552	1	0	1	119.429280591
51	0	2	0	2	26.358232068
51	1	328	0	328	29.6389528579
51	2	11	1	10	17.2183335672
51	4	4	1	3	19.8646431225
51	5	11	4	7	26.1913615429
51	6	3	0	3	23.7322944379
51	7	6	1	5	22.9023758353
51	8	2	0	2	40.1177176839
51	10	4	1	3	19.3975938914
51	11	1	0	1	35.2860254557
51	12	5	1	4	30.8881795994
51	13	8	0	8	22.0760953593
51	14	7	1	6	18.3272004671
51	15	53	0	53	21.226468928
51	17	12	0	12	13.2275924564
51	18	5	0	5	24.1953274425
51	19	4	1	3	29.169503363
51	20	1	0	1	18.0005373835
51	21	11	0	11	22.3897336913
51	22	1	0	1	33.9827361877
51	23	13	3	10	19.7056731086
51	24	13	12	1	18.4120895969
51	26	29	0	29	9.80021941836
51	27	6	0	6	14.586302928
51	28	4	0	4	31.8879513522
51	29	16	7	9	17.440894562
51	30	79	16	63	8.07334616982
51	31	5	0	5	18.6611623765
51	33	44	1	43	17.8273366375
51	34	128	36	92	7.69750260889
51	35	259	0	259	13.1926980354
51	36	51	2	49	24.8884197219
51	37	106	0	106	6.84910276818
51	38	13	0	13	13.0902718903
51	39	3	0	3	32.766649181
51	41	17	1	16	17.8062516538
51	42	5	0	5	28.942011218
51	43	2	0	2	31.4101842159
51	44	1	0	1	32.4247786183
51	45	1	0	1	29.5959135669
51	46	17	1	16	19.9796891902
51	47	3	0	3	27.6870061635
51	48	63	0	63	15.9728538641
51	49	131	58	73	4.74529542147
51	50	443	152	291	5.46300191489
51	52	5	1	4	13.3456721986
51	53	4	1	3	33.512754132
51	54	25	1	24	9.24495295066
51	55	13	0	13	17.1810870351
51	56	14	3	11	13.9587240995
51	57	1	0	1	21.9483326428
51	58	1	1	0	26.8434642986
51	59	9	1	8	29.3298278777
51	60	56	8	48	9.17790478679
51	61	5	0	5	26.4100622059
51	64	1	0	1	24.023552835
51	65	69	2	67	24.5542706761
51	66	25	8	17	8.77919952266
51	68	74	11	63	9.26095990158
51	69	3	1	2	18.3552950419
51	70	0	0	0	47.53665732
51	72	1	0	1	44.6823453806
51	73	21	7	14	40.0106958704
51	74	2	2	0	42.5996525981
51	75	1	0	1	38.8001165
51	76	1	0	1	47.3132661563
51	78	1	0	1	44.2865953225
51	81	1	0	1	44.1964656925
51	83	3	1	2	41.8912895182
51	84	5	0	5	40.4517041304
51	85	0	0	0	47.8489350335
51	86	2	1	1	45.1558182314
51	87	3	0	3	39.7257628451
51	90	1	0	1	53.8543808786
51	92	3	0	3	48.6606747106
51	96	3	0	3	58.7549213985
51	99	3	2	1	26.0571262061
51	103	4	0	4	34.3586232155
51	104	1	0	1	36.8449051142
51	109	1	0	1	53.2222994899
51	110	4	1	3	30.3506302494
51	111	1	0	1	51.7021992773
51	112	7	0	7	32.5642939557
51	113	10	1	9	35.4089871781
51	124	8	0	8	18.2340192788
51	125	2	0	2	14.7973093106
51	126	1	0	1	27.4080308033
51	128	1	0	1	34.3790880692
51	129	3	0	3	22.5148646519
51	131	1	0	1	26.4829036971
51	133	4	0	4	21.1774708639
51	135	1	0	1	40.8655252302
51	136	2	1	1	23.482506705
51	138	1	0	1	16.6309255895
51	142	19	0	19	28.833608058
51	145	1	0	1	20.0726923587
51	146	1	0	1	38.98407301
51	148	1	0	1	15.7443402436
51	151	1	0	1	21.419208906
51	164	1	0	1	49.3595576311
51	183	1	0	1	108.18727256
51	208	0	0	0	111.330258896
51	213	0	0	0	116.216599326
51	220	1	0	1	128.10766124
51	257	1	0	1	48.3980211678
51	277	0	0	0	72.6019522661
51	303	2	0	2	38.6846799597
51	307	1	0	1	45.5415738943
51	464	14	1	13	34.2452847138
51	465	2	1	1	52.5027820689
51	469	3	1	2	44.5390851097
51	471	1	0	1	34.328042294
51	472	1	0	1	33.6331420158
51	476	2	0	2	23.5706791277
51	484	0	0	0	38.9984910122
51	489	1	0	1	53.7923438948
52	0	2	0	2	36.2074912631
52	1	239	79	160	42.1862727786
52	2	5	0	5	28.7581080268
52	3	1	0	1	36.0211272491
52	4	2	0	2	31.9171706766
52	5	6	0	6	39.5214230087
52	6	2	0	2	36.683362175
52	7	8	3	5	33.6893410229
52	10	0	0	0	30.1101053019
52	11	2	0	2	48.5923104622
52	12	3	0	3	44.1950742519
52	13	6	0	6	31.7807544478
52	14	1	0	1	28.3407898174
52	15	50	10	40	32.6898561954
52	18	3	2	1	32.694857486
52	19	2	0	2	38.6511037792
52	20	1	0	1	31.3319650852
52	21	5	1	4	35.5712744362
52	22	0	0	0	47.1362707055
52	23	4	1	3	32.6106627241
52	24	5	0	5	30.9838898437
52	25	1	0	1	43.2931499921
52	26	9	0	9	23.1233749233
52	27	1	0	1	27.7038144123
52	28	5	3	2	43.7472175601
52	29	5	0	5	29.794641717
52	30	17	4	13	17.1898327537
52	31	11	0	11	22.0387241932
52	32	1	0	1	45.0539978112
52	33	33	0	33	26.3303061758
52	34	167	109	58	10.6207236465
52	35	126	5	121	22.9941798061
52	36	62	1	61	30.3360032528
52	37	8	0	8	19.1647324354
52	38	13	4	9	17.2491108383
52	39	3	0	3	40.4189685167
52	41	16	0	16	24.2952296109
52	42	7	0	7	35.9815417145
52	43	0	0	0	34.9362519238
52	45	2	0	2	24.3357742784
52	46	8	0	8	29.9882064241
52	47	3	0	3	27.2865542112
52	48	215	100	115	15.0384050989
52	49	33	5	28	17.827684825
52	50	196	19	177	13.5213022902
52	51	9	0	9	13.3456721986
52	53	1	0	1	44.5052418155
52	54	107	53	54	5.22464444457
52	55	12	0	12	22.1775339315
52	56	2	1	1	23.424867338
52	57	5	0	5	15.8400064673
52	58	3	1	2	35.9457246441
52	59	21	4	17	27.9968719502
52	60	85	0	85	12.9174927458
52	62	1	0	1	42.078137229
52	63	2	0	2	27.9348356504
52	64	1	0	1	35.1640465563
52	65	59	0	59	31.570009045
52	66	4	2	2	20.4431721456
52	67	2	1	1	28.6868789355
52	68	341	26	315	6.57295733786
52	69	27	11	16	9.37639096093
52	70	5	2	3	47.9606420141
52	71	6	2	4	40.8478640184
52	73	105	2	103	40.5037441871
52	74	9	0	9	41.7206914472
52	75	9	2	7	38.6700829501
52	76	7	3	4	46.9829618345
52	78	9	0	9	43.4078525307
52	79	0	0	0	43.4392864074
52	81	6	1	5	44.9674889164
52	82	5	1	4	44.843107402
52	83	3	0	3	41.93371657
52	84	15	2	13	40.4702191282
52	85	2	0	2	46.4574514693
52	86	7	0	7	42.886002873
52	87	7	1	6	38.6360718438
52	88	3	0	3	39.1091632851
52	89	2	0	2	49.2818360744
52	90	1	0	1	52.4644619532
52	92	4	0	4	50.3511580278
52	95	5	0	5	37.2500924388
52	96	3	0	3	57.6989650135
52	99	23	0	23	25.4659461931
52	102	1	0	1	42.6283526708
52	103	18	6	12	34.6980629779
52	104	2	1	1	40.8530436135
52	106	1	0	1	50.0494809192
52	107	1	0	1	39.3186565972
52	110	7	2	5	30.325458756
52	111	2	1	1	54.4340508705
52	112	22	0	22	34.0382185109
52	113	28	0	28	33.9834522636
52	114	1	0	1	30.6976194772
52	116	1	0	1	49.1545867609
52	117	1	0	1	36.5554606101
52	124	402	396	6	6.62067524278
52	125	33	24	9	8.21534719089
52	128	3	0	3	25.4877322694
52	129	8	1	7	23.7525626197
52	130	1	0	1	23.7552458969
52	131	56	7	49	13.9857585054
52	133	8	0	8	19.2977291012
52	134	10	2	8	22.4792390877
52	135	1	0	1	29.8379143572
52	136	12	2	10	14.2682306677
52	137	1	0	1	34.3823427298
52	138	8	3	5	16.6716891885
52	140	8	2	6	28.1268148527
52	141	1	0	1	34.8762781326
52	142	289	82	207	22.1701091432
52	143	8	0	8	18.7748518882
52	144	3	2	1	28.7841594519
52	145	28	7	21	14.3795959756
52	147	18	5	13	26.5131558286
52	148	19	2	17	12.1759479828
52	151	42	12	30	8.11712976398
52	152	5	0	5	13.821082725
52	154	1	0	1	31.2940544903
52	171	2	0	2	50.4221719453
52	177	2	0	2	47.5363496707
52	188	2	0	2	122.487675156
52	208	2	0	2	116.76002517
52	220	1	0	1	137.765202443
52	221	0	0	0	131.516619368
52	230	0	0	0	130.890968443
52	257	3	1	2	55.4715703481
52	258	2	0	2	52.0519092985
52	272	1	0	1	95.8217902222
52	275	1	0	1	82.7618472477
52	277	1	0	1	80.9696283106
52	281	0	0	0	76.2295764098
52	282	1	0	1	80.3454682028
52	303	1	1	0	50.6105823702
52	304	4	0	4	43.0821321737
52	306	1	0	1	57.0444611441
52	307	1	0	1	55.6409795947
52	415	2	0	2	60.0157591964
52	416	1	0	1	71.2857214342
52	464	4	2	2	24.7649819396
52	465	1	0	1	40.3594795356
52	466	7	2	5	43.7444306974
52	468	2	0	2	18.3260751011
52	469	16	0	16	32.2679341477
52	470	1	0	1	23.9903321792
52	471	6	1	5	26.8335996406
52	472	6	0	6	21.790338619
52	475	5	0	5	34.6080093953
52	476	25	3	22	13.0714850074
52	477	1	0	1	35.0838287203
52	478	1	0	1	50.1191443971
52	480	1	0	1	28.5997031063
52	482	1	0	1	53.399051604
52	484	3	0	3	35.3343003225
52	487	1	0	1	39.483400677
52	488	2	0	2	41.4154297735
52	489	3	0	3	49.567863533
52	492	2	0	2	46.956588428
52	495	1	0	1	49.5727608494
52	503	1	0	1	51.0081265945
52	573	1	0	1	65.286888901
53	0	2	0	2	43.3712285189
53	1	439	21	418	33.8555041764
53	2	1	0	1	35.0558558724
53	4	1	0	1	33.6925993652
53	5	48	0	48	23.3601555379
53	6	85	0	85	14.9508044834
53	7	5	0	5	39.0976686084
53	8	13	7	6	20.6664800013
53	11	18	0	18	20.9841768093
53	12	14	0	14	25.173284882
53	13	7	0	7	41.6389316103
53	14	1	0	1	39.3903478661
53	15	10	8	2	36.2957244873
53	17	6	0	6	30.0598683848
53	19	1	0	1	45.9010596679
53	20	14	0	14	24.0857849187
53	21	69	0	69	26.4374162672
53	22	6	0	6	29.6164332019
53	23	10	1	9	29.0560910132
53	24	19	9	10	31.0659454791
53	25	79	5	74	12.4432722582
53	26	7	0	7	26.1545767182
53	27	42	0	42	21.3629503848
53	28	10	0	10	38.8948170797
53	29	130	44	86	16.7421241651
53	30	1	0	1	37.8169920408
53	31	3	0	3	48.5754598906
53	33	4	0	4	42.0892830244
53	34	3	0	3	41.0706251922
53	35	5	0	5	38.1817069223
53	36	17	0	17	50.740466003
53	37	2	0	2	32.9560881071
53	38	1	0	1	44.2467423635
53	40	0	0	0	57.0138064967
53	41	0	0	0	44.9359409056
53	42	1	1	0	51.040317995
53	43	5	0	5	25.2406214561
53	44	9	1	8	10.0792885153
53	45	2	0	2	42.8165527913
53	46	119	3	116	14.6231360294
53	48	14	0	14	34.1273453704
53	49	3	0	3	29.0452701339
53	50	9	6	3	31.0855781133
53	52	2	0	2	44.5052418155
53	55	4	1	3	25.1916688867
53	56	13	1	12	21.122798515
53	57	1	0	1	41.2290318479
53	58	87	18	69	10.7374735815
53	59	7	0	7	35.4943608406
53	60	2	0	2	31.9539301517
53	61	11	3	8	21.3618381134
53	62	18	0	18	18.4098286832
53	64	143	14	129	9.49735637282
53	65	238	12	226	17.4342714628
53	66	0	0	0	24.7871817657
53	67	7	1	6	17.2381931138
53	68	5	2	3	38.0513926806
53	69	1	0	1	43.3911400516
53	70	0	0	0	75.5327095777
53	71	3	0	3	73.7012856017
53	73	13	1	12	68.682552636
53	74	2	0	2	72.3157830296
53	75	2	0	2	68.1954327754
53	76	1	0	1	76.122478788
53	78	1	0	1	73.8650371602
53	79	0	0	0	69.383630468
53	81	1	0	1	72.1333039365
53	83	3	0	3	70.8135192228
53	84	2	0	2	69.5401365862
53	87	3	0	3	69.8653060749
53	88	2	0	2	71.379283181
53	92	1	0	1	75.049389425
53	95	1	0	1	61.3953714321
53	99	1	0	1	57.3015063759
53	102	1	0	1	58.6352095036
53	103	5	1	4	63.8345944341
53	107	1	0	1	76.1549181157
53	110	1	0	1	60.6378190666
53	112	2	0	2	61.2327574919
53	113	3	0	3	66.1891022498
53	119	1	0	1	82.0560297705
53	120	1	0	1	67.0063805706
53	130	1	0	1	67.5365213689
53	135	1	0	1	73.9760751904
53	138	1	0	1	49.0085326729
53	142	27	0	27	62.2263346783
53	147	1	0	1	71.010738551
53	171	1	0	1	85.0832146532
53	177	2	0	2	86.7878741927
53	183	1	0	1	109.803228742
53	186	0	0	0	112.498900271
53	208	0	0	0	126.601522862
53	209	2	0	2	122.481528193
53	216	1	0	1	126.156662459
53	220	0	0	0	130.270464347
53	242	0	0	0	149.427313626
53	245	0	0	0	73.3961792714
53	277	12	0	12	82.9461660296
53	281	0	0	0	83.5158131158
53	282	2	0	2	88.1407313597
53	303	4	1	3	42.3273009973
53	304	1	0	1	45.4432369608
53	305	1	0	1	66.6370959458
53	307	1	0	1	54.9226945196
53	424	1	0	1	148.461184949
53	438	1	0	1	132.580362579
53	444	1	0	1	119.251302587
53	447	1	0	1	114.809819557
53	465	0	0	0	74.4287646375
53	466	0	0	0	73.2624146148
53	469	2	0	2	67.7968695304
53	471	1	0	1	49.3888460117
53	477	0	0	0	65.6706991746
53	482	1	0	1	68.9538067444
53	484	2	0	2	44.3938448644
53	487	1	1	0	51.2808058658
53	491	1	0	1	62.8170825568
53	492	0	0	0	67.6756497461
53	495	1	0	1	82.9485459596
53	505	2	0	2	82.5169936636
53	559	1	0	1	140.540702388
53	573	1	0	1	109.272617079
54	0	3	0	3	30.9980351245
54	1	223	48	175	37.1414129247
54	2	3	1	2	23.5967921455
54	4	1	0	1	26.8072832758
54	5	7	1	6	35.0150038656
54	6	1	0	1	32.9767826891
54	7	4	0	4	28.46829541
54	10	1	0	1	24.8915022666
54	12	1	0	1	39.6122643617
54	13	5	2	3	26.5685771706
54	14	3	0	3	23.1167049222
54	15	54	14	40	27.5055159409
54	16	1	0	1	33.6767323043
54	17	6	1	5	21.1758562415
54	18	3	0	3	27.5648279919
54	20	3	1	2	26.8652158428
54	21	3	0	3	30.8528383325
54	22	2	0	2	42.3537711516
54	23	2	0	2	27.7326953805
54	24	5	1	4	25.9942521469
54	26	7	0	7	18.9470220802
54	27	2	0	2	23.8274986922
54	28	2	0	2	38.5761572557
54	29	4	1	3	26.5381755861
54	30	28	17	11	11.9797549751
54	31	15	15	0	17.5382459867
54	32	2	0	2	39.9631966674
54	33	27	0	27	21.1591689087
54	34	428	259	169	5.42793122659
54	35	175	0	175	17.7704023257
54	36	94	0	94	25.610602598
54	37	18	1	17	14.2764319267
54	38	35	26	9	12.3839621877
54	39	2	1	1	35.4302563427
54	41	27	10	17	19.3025779679
54	42	5	1	4	31.051985805
54	44	1	0	1	39.8408767365
54	46	9	2	7	27.9848772163
54	47	1	0	1	29.3495614684
54	48	64	34	30	16.6637034558
54	49	23	13	10	13.9756901389
54	50	121	34	87	11.2844151125
54	51	10	1	9	9.24495295066
54	52	49	14	35	5.22464444457
54	53	1	0	1	42.1365963687
54	55	4	1	3	22.0110789333
54	56	2	1	1	21.5063849363
54	57	1	0	1	19.4870374686
54	58	1	0	1	34.4471885524
54	59	7	3	4	30.4098748133
54	60	29	0	29	12.3058396906
54	65	28	4	24	30.903782253
54	66	2	0	2	17.4404217356
54	68	150	111	39	6.86387640249
54	69	8	3	5	13.6757405385
54	70	3	0	3	44.7434080702
54	71	3	0	3	38.4487627252
54	73	52	3	49	37.1886819612
54	74	1	0	1	38.8771981206
54	75	8	2	6	35.5341594597
54	76	1	0	1	44.0051163981
54	78	4	0	4	40.5828639522
54	79	1	0	1	39.8582300554
54	81	2	0	2	41.6129543714
54	82	5	1	4	41.8140100974
54	83	3	1	2	38.7809547919
54	84	3	1	2	37.3081643474
54	86	4	0	4	40.5612685623
54	87	3	0	3	35.8283529166
54	88	1	0	1	36.5339682438
54	89	1	0	1	45.2465364331
54	94	1	0	1	59.2303329315
54	95	2	0	2	33.2234234264
54	98	1	0	1	42.0779132977
54	99	4	1	3	22.2164080312
54	100	1	0	1	32.6918115525
54	102	1	0	1	37.9385420829
54	103	12	2	10	31.3501650853
54	105	1	0	1	41.469560991
54	110	2	0	2	27.0127811803
54	112	22	0	22	30.331437208
54	113	16	0	16	31.225289635
54	120	2	0	2	39.1312484754
54	124	126	55	71	8.9893277433
54	125	20	2	18	6.50721295712
54	127	1	0	1	27.2475309915
54	128	1	0	1	26.079800751
54	129	7	2	5	19.8657045333
54	130	1	0	1	25.4000320923
54	131	11	1	10	19.2079859646
54	133	7	0	7	16.2634707233
54	134	4	0	4	20.5294983851
54	136	4	0	4	14.8300758617
54	138	11	0	11	12.7859800607
54	140	2	0	2	25.7166085336
54	142	92	2	90	21.4376771464
54	143	2	0	2	20.139667572
54	145	7	2	5	12.7890859847
54	147	4	1	3	29.3498889399
54	148	16	0	16	9.28076968639
54	151	2	1	1	13.0833837732
54	152	4	0	4	16.5924366107
54	154	1	0	1	32.0724171181
54	163	1	0	1	37.3566031352
54	183	0	0	0	113.08132755
54	225	1	0	1	113.592285189
54	232	0	0	0	106.921255048
54	245	1	0	1	53.6858913058
54	251	1	0	1	62.425116506
54	262	0	0	0	66.3495845337
54	277	2	0	2	75.9804786876
54	309	1	0	1	43.0900672249
54	464	5	0	5	29.611511342
54	465	0	0	0	45.5797290379
54	466	4	0	4	48.9262157455
54	469	8	0	8	37.4853762273
54	470	1	0	1	29.1322584269
54	471	1	0	1	31.1986993845
54	472	1	1	0	27.004690689
54	475	0	0	0	39.2122284486
54	476	1	0	1	17.9967056469
54	480	1	0	1	33.7056419718
54	482	2	0	2	57.9428289675
54	484	2	1	1	38.665106861
54	485	1	0	1	63.1310403062
54	491	1	0	1	41.7203463063
54	493	1	0	1	62.9841398864
54	503	1	0	1	56.014873746
55	0	4	0	4	40.9294685373
55	1	366	108	258	39.3542733436
55	2	2	0	2	30.8659692638
55	3	3	0	3	43.0478267679
55	4	4	1	3	32.1777279426
55	5	6	1	5	31.5951222275
55	6	15	2	13	24.1409553834
55	7	10	0	10	36.7844392516
55	8	2	0	2	40.2511047058
55	10	4	1	3	33.7819925588
55	11	2	0	2	37.1794790222
55	12	12	0	12	36.0990844439
55	13	10	3	7	37.1412845244
55	14	5	0	5	33.5188909016
55	15	14	2	12	34.3807470778
55	17	6	0	6	25.1155827518
55	18	1	0	1	39.9580098706
55	19	2	0	2	43.8766894348
55	20	4	1	3	25.1375982672
55	21	19	0	19	30.2881948643
55	22	1	0	1	40.447175165
55	23	4	1	3	29.6469216151
55	24	11	3	8	29.7508612589
55	25	6	0	6	29.0707967003
55	26	17	3	14	18.6458398234
55	27	10	1	9	19.0131472843
55	28	4	0	4	43.1366122414
55	29	69	0	69	16.8518789053
55	30	4	0	4	25.0316615231
55	32	1	0	1	51.4600522553
55	33	3	0	3	34.0540498182
55	34	17	4	13	23.897828952
55	35	29	3	26	29.1879333165
55	36	43	3	40	41.8095978919
55	37	10	1	9	21.9628352397
55	38	2	0	2	30.2274559138
55	39	3	0	3	48.5903706129
55	41	6	0	6	34.7318474996
55	43	63	30	33	14.24210313
55	44	3	2	1	19.4440991119
55	45	3	0	3	19.2539841788
55	46	223	0	223	11.43636583
55	47	50	32	18	12.5335629739
55	48	360	8	352	9.04054796395
55	49	57	1	56	15.8060959154
55	50	390	10	380	11.8987756402
55	51	13	7	6	17.1810870351
55	52	2	0	2	22.1775339315
55	53	24	0	24	25.1916688867
55	54	5	0	5	22.0110789333
55	56	175	18	157	7.6361583189
55	57	19	2	17	16.0811025337
55	58	35	5	30	15.000023562
55	59	92	18	74	14.7097157943
55	60	197	66	131	9.70568054254
55	61	46	16	30	9.64394360594
55	62	36	1	35	19.9624398417
55	63	43	4	39	9.75192710345
55	64	15	1	14	17.3842374392
55	65	1422	0	1422	9.52731877808
55	66	31	0	31	12.1209793161
55	67	30	1	29	7.95387218399
55	68	156	0	156	15.7849072979
55	69	21	2	19	18.5903202638
55	70	3	0	3	64.6883841189
55	71	2	0	2	59.6961184788
55	72	2	0	2	61.8630039094
55	73	40	3	37	57.143639778
55	74	2	1	1	59.5754462477
55	75	9	0	9	55.8607696329
55	78	0	0	0	61.2737093843
55	79	0	0	0	59.1569603927
55	81	3	2	1	61.3605819011
55	82	7	2	5	62.163184922
55	83	1	0	1	58.9900225891
55	84	4	0	4	57.5403444381
55	85	3	0	3	64.7668843093
55	87	4	0	4	56.6410334428
55	89	2	0	2	63.0532961954
55	92	1	0	1	65.8351807219
55	95	1	0	1	51.6133684559
55	96	1	0	1	75.7811124494
55	102	4	1	3	53.1871999215
55	103	4	3	1	51.444446149
55	105	1	0	1	58.4086502629
55	109	1	0	1	70.3604023947
55	110	1	0	1	47.3478818216
55	112	2	0	2	49.7303827486
55	113	10	0	10	52.208673779
55	116	1	0	1	66.807055651
55	117	1	0	1	55.1463855337
55	124	3	1	2	28.7979671497
55	128	2	0	2	47.5524764345
55	131	8	0	8	28.3197178186
55	139	1	0	1	39.3509749867
55	140	1	0	1	47.1791230443
55	142	27	11	16	43.4250452074
55	145	2	0	2	34.7958757372
55	148	1	0	1	31.0356809936
55	151	2	0	2	27.3344078641
55	155	2	1	1	75.5805703687
55	168	1	0	1	65.0178476535
55	245	1	0	1	69.4585902035
55	257	1	0	1	64.0944978773
55	264	1	0	1	66.1789164939
55	277	5	1	4	86.9172662916
55	303	4	1	3	49.252619197
55	304	2	0	2	46.3064626505
55	307	6	0	6	58.7438883314
55	360	1	0	1	127.030082071
55	408	0	0	0	81.7935362221
55	454	0	0	0	65.9731528858
55	464	5	0	5	28.4920349919
55	465	1	0	1	49.651678573
55	466	7	0	7	49.330920639
55	469	13	1	12	42.7409902892
55	471	5	0	5	25.6690467193
55	472	5	1	4	32.312345034
55	475	2	0	2	51.489251071
55	476	7	1	6	22.7689081978
55	477	1	0	1	41.2581056547
55	479	1	0	1	22.0433424328
55	480	5	2	3	34.7249252215
55	484	5	1	4	25.1481482619
55	486	0	0	0	36.0629188397
55	487	1	0	1	31.8026544191
55	488	1	0	1	38.4036408288
55	489	1	0	1	39.3923054439
55	494	2	0	2	47.3354422864
55	495	1	0	1	58.4315183601
55	504	1	0	1	51.9313471182
56	0	13	0	13	34.3666727432
56	1	516	67	449	31.8185021556
56	2	7	0	7	24.2777005719
56	3	1	0	1	36.8811590416
56	4	4	1	3	25.175524457
56	5	11	0	11	23.974471621
56	6	25	0	25	16.8763866282
56	7	12	3	9	30.0760580621
56	8	1	0	1	33.4477367457
56	9	4	0	4	36.6213652102
56	10	2	0	2	27.3357124036
56	11	5	1	4	29.9808447357
56	12	6	0	6	28.5144045405
56	13	9	0	9	30.8707746689
56	14	2	1	1	27.4202242779
56	15	31	4	27	27.5231737629
56	17	28	7	21	18.350991073
56	18	2	1	1	33.9750144707
56	19	2	0	2	37.3123883756
56	20	10	0	10	17.5848133303
56	21	34	0	34	22.7061880496
56	22	5	0	5	32.8261137735
56	23	16	2	14	22.2838489427
56	24	26	0	26	22.6215661773
56	25	6	0	6	22.3744565147
56	26	67	2	65	11.8667454559
56	27	42	0	42	11.4377388191
56	28	5	0	5	35.7380492111
56	29	206	22	184	9.38053070015
56	30	5	2	3	20.6657535488
56	31	2	0	2	31.9524415195
56	32	5	0	5	44.923698998
56	33	4	0	4	28.5406763812
56	34	9	0	9	21.5927300987
56	35	35	7	28	23.7218019354
56	36	24	0	24	36.8212979331
56	37	17	3	14	16.6561319664
56	39	5	0	5	42.4926382829
56	40	1	0	1	47.840778514
56	41	2	0	2	29.9070686065
56	42	1	0	1	39.4868277302
56	43	13	2	11	19.5559775138
56	44	1	0	1	18.5198427396
56	45	4	1	3	26.6000784285
56	46	352	108	244	6.5657346614
56	47	7	0	7	20.1022880498
56	48	116	2	114	14.4389290661
56	49	65	19	46	10.7351876091
56	50	383	265	118	10.2286864822
56	51	23	4	19	13.9587240995
56	52	3	0	3	23.424867338
56	53	54	1	53	21.122798515
56	54	6	0	6	21.5063849363
56	55	96	30	66	7.6361583189
56	57	4	0	4	22.1696517622
56	58	29	1	28	13.0018440972
56	59	19	0	19	22.3144009661
56	60	80	0	80	10.8693151379
56	61	18	0	18	13.867934567
56	62	21	0	21	22.160902183
56	63	4	0	4	16.9383254657
56	64	25	1	24	11.9886932508
56	65	827	735	92	10.981411512
56	66	47	9	38	6.01100237773
56	67	43	0	43	6.54964870517
56	68	54	14	40	16.9344400366
56	69	6	0	6	22.8290538502
56	70	1	0	1	60.7100849434
56	71	3	0	3	56.7788602301
56	73	32	15	17	53.2969953304
56	74	1	0	1	56.1828741819
56	75	6	1	5	52.2717024401
56	76	1	0	1	60.7056763444
56	78	3	0	3	57.8488374241
56	79	2	0	2	54.9104615398
56	80	0	0	0	56.3885659563
56	82	1	0	1	58.4799554968
56	83	2	1	1	55.2664780218
56	84	3	0	3	53.8577288752
56	85	1	0	1	61.4797052059
56	86	1	0	1	58.9563679898
56	87	1	0	1	53.3871952292
56	88	1	0	1	54.5825367752
56	89	2	0	2	58.0682231782
56	90	1	0	1	67.4319868728
56	92	1	0	1	61.3657807663
56	95	2	0	2	47.1063829976
56	98	1	0	1	61.2230003515
56	102	2	0	2	47.5296174351
56	103	6	2	4	47.8049710278
56	104	1	0	1	48.8383618043
56	110	1	0	1	43.9674785582
56	112	4	0	4	45.7483254505
56	113	11	3	8	49.1798923759
56	124	3	1	2	29.7454584605
56	125	2	0	2	27.8775812294
56	131	5	1	4	32.6900730539
56	135	1	0	1	53.0919858917
56	138	1	0	1	30.564277242
56	140	2	0	2	44.7225099412
56	142	29	1	28	42.5059239182
56	145	1	0	1	33.7045606116
56	147	3	0	3	49.9372596501
56	183	1	0	1	112.651268639
56	188	1	0	1	119.360426951
56	190	0	0	0	106.296608203
56	199	1	0	1	133.854242795
56	242	0	0	0	150.910611056
56	245	2	0	2	63.6795885365
56	246	1	0	1	68.0396900792
56	247	1	0	1	83.9035717935
56	260	1	0	1	57.8821409116
56	262	1	0	1	73.3000358206
56	264	1	0	1	59.4991345688
56	270	1	0	1	71.7175140992
56	274	1	0	1	75.2756996003
56	277	6	2	4	79.9158192493
56	281	0	0	0	77.9554922098
56	282	0	0	0	82.5135568086
56	303	6	1	5	41.731118421
56	307	1	0	1	51.5700782533
56	308	1	0	1	56.3056464015
56	408	1	0	1	87.3158014387
56	464	6	0	6	35.1223992326
56	465	1	0	1	55.9153250256
56	466	2	0	2	56.1995046829
56	469	7	2	5	48.6370246122
56	471	4	0	4	32.8553748502
56	472	2	0	2	37.8493552269
56	475	1	0	1	55.8445685983
56	476	4	1	3	27.7284045556
56	479	2	0	2	28.5999258425
56	483	1	0	1	65.5331679023
56	484	2	0	2	32.7505417157
56	486	1	0	1	43.6354037743
56	488	2	0	2	45.965940489
56	491	2	0	2	46.395002238
56	493	1	0	1	65.9568784366
56	503	1	0	1	69.5829879986
56	548	1	0	1	194.524955429
56	555	1	0	1	112.193571761
57	0	1	0	1	48.2462042175
57	1	130	4	126	50.6773273947
57	5	3	2	1	44.9192174959
57	6	2	0	2	38.9255551283
57	7	1	0	1	44.849765907
57	8	1	0	1	55.6159756494
57	9	1	0	1	51.2341641126
57	12	6	0	6	49.6667626955
57	13	3	0	3	43.9038094712
57	14	1	0	1	40.1775715858
57	15	8	0	8	43.1015937148
57	16	1	0	1	51.557622597
57	17	2	0	2	34.52972898
57	18	1	0	1	45.6932189693
57	21	3	1	2	42.3585335095
57	22	1	0	1	53.5687793886
57	23	5	0	5	40.5370030766
57	24	5	2	3	39.7491490863
57	26	8	0	8	29.1445323459
57	27	5	0	5	31.7921286387
57	28	2	0	2	53.4832957658
57	29	9	0	9	31.3357501231
57	30	2	0	2	29.206967631
57	32	2	0	2	58.0969704008
57	33	3	0	3	39.1918839909
57	34	5	1	4	24.2983094457
57	35	14	1	13	34.8893082322
57	36	16	3	13	44.8431061651
57	37	1	0	1	28.7603731287
57	41	2	0	2	38.161982099
57	43	14	0	14	23.3946197705
57	45	72	32	40	8.52890225005
57	46	23	4	19	27.3852378823
57	47	50	3	47	13.4461615803
57	48	513	228	285	7.76302527955
57	49	17	2	15	24.129660094
57	50	110	35	75	17.708206423
57	51	4	0	4	21.9483326428
57	52	3	1	2	15.8400064673
57	53	3	0	3	41.2290318479
57	54	6	1	5	19.4870374686
57	55	15	5	10	16.0811025337
57	56	2	0	2	22.1696517622
57	58	3	0	3	30.8017822097
57	59	263	0	263	13.3396804743
57	60	72	0	72	13.8087287485
57	61	3	0	3	22.3553084346
57	62	1	0	1	32.4725767989
57	63	6	1	5	15.8640509669
57	64	2	0	2	33.3520754004
57	65	118	0	118	24.5635399298
57	66	1	0	1	23.3898044381
57	67	1	0	1	24.015227347
57	68	206	4	202	13.5275865855
57	69	98	9	89	6.75844814768
57	70	0	0	0	63.7877285928
57	71	1	0	1	56.5977735596
57	72	1	0	1	61.7601867691
57	73	8	1	7	56.3092615162
57	74	1	0	1	57.5550044289
57	75	3	1	2	54.501757025
57	78	2	0	2	59.2396158392
57	79	0	0	0	59.1664980464
57	80	0	0	0	59.9895363533
57	81	1	0	1	60.7679948262
57	84	1	0	1	56.3001708499
57	86	1	0	1	58.6061587953
57	87	1	0	1	54.4692029249
57	99	1	0	1	41.2628637068
57	102	1	0	1	57.1390856945
57	103	1	0	1	50.489664152
57	107	1	0	1	54.5820485481
57	110	1	0	1	46.118614859
57	112	2	0	2	49.695481659
57	113	2	0	2	49.8158197913
57	124	5	0	5	20.9939462624
57	131	26	0	26	13.6870340714
57	132	0	0	0	26.2280722972
57	133	2	0	2	35.1136757659
57	137	0	0	0	49.3174495667
57	140	2	0	2	43.9195167082
57	141	1	0	1	41.1349213101
57	142	13	5	8	37.26671019
57	145	1	0	1	30.1081596349
57	147	1	0	1	35.9739311837
57	148	1	0	1	27.9673338748
57	151	9	2	7	15.8607167189
57	177	1	0	1	61.8774626862
57	187	1	0	1	138.347459137
57	208	0	0	0	131.766815746
57	220	0	0	0	150.055982077
57	242	0	0	0	166.965532364
57	277	3	0	3	94.322056352
57	282	1	0	1	94.6773532717
57	294	1	0	1	110.887309721
57	303	1	0	1	60.1590459618
57	304	1	0	1	54.6826398112
57	305	1	0	1	77.6604146453
57	307	1	0	1	67.4896890946
57	321	1	0	1	88.9456723605
57	463	1	0	1	37.9808988981
57	464	34	0	34	13.1123720421
57	465	1	0	1	33.7660340868
57	466	7	1	6	34.2660261444
57	469	33	0	33	26.6770641907
57	470	4	0	4	22.0537392873
57	471	7	6	1	12.3803876226
57	472	6	0	6	16.2845127989
57	474	1	1	0	36.0139973656
57	475	6	0	6	36.0912230804
57	476	132	1	131	7.75288079116
57	477	1	0	1	25.8133126672
57	479	58	0	58	6.66827081158
57	480	9	2	7	19.0606295176
57	481	1	0	1	34.9042634174
57	482	1	0	1	39.0567306827
57	484	18	0	18	19.5031893158
57	485	0	0	0	44.977110186
57	486	1	0	1	29.3020038608
57	487	7	0	7	23.8484031758
57	488	4	0	4	27.0879153678
57	489	2	0	2	33.7875605343
57	491	9	0	9	24.9989759229
57	494	2	1	1	31.3051397246
57	495	2	0	2	42.7183750681
57	499	1	0	1	41.7821517306
57	501	0	0	0	47.1397113294
57	503	1	0	1	47.843532959
57	505	1	0	1	45.6589230954
58	0	1	0	1	43.0907384847
58	1	140	16	124	36.603433112
58	2	3	0	3	33.5200996692
58	3	0	0	0	46.3478584373
58	5	10	3	7	26.5635670054
58	6	26	1	25	17.2410638287
58	7	4	1	3	38.6531009132
58	8	4	1	3	29.3936057064
58	9	1	0	1	44.6962627928
58	11	5	0	5	28.0548534688
58	12	1	0	1	29.9024112636
58	13	4	0	4	40.3847383816
58	15	12	0	12	35.8513502696
58	17	5	2	3	27.7249703689
58	18	3	0	3	43.8769762982
58	20	1	0	1	23.7519060386
58	21	11	0	11	27.7959487137
58	22	1	0	1	34.6000861551
58	23	3	0	3	29.1404311258
58	24	1	0	1	30.4709608021
58	25	11	2	9	18.9090203289
58	26	9	0	9	22.128222479
58	27	14	0	14	18.7510050671
58	28	1	0	1	41.3459713845
58	29	59	4	55	13.8709957766
58	30	1	0	1	32.8565002648
58	31	1	0	1	44.138648646
58	34	0	0	0	34.5262869019
58	35	4	0	4	34.8100965651
58	36	4	0	4	47.9787221138
58	41	0	0	0	41.4175911574
58	42	1	0	1	49.6100854778
58	43	26	0	26	15.4683872682
58	44	15	6	9	5.6248141691
58	46	237	26	211	7.03682831478
58	47	3	0	3	22.6334830385
58	48	27	9	18	24.0405357499
58	50	16	1	15	23.1670005598
58	51	1	0	1	26.8434642986
58	52	1	0	1	35.9457246441
58	53	212	38	174	10.7374735815
58	54	3	1	2	34.4471885524
58	55	7	0	7	15.000023562
58	56	24	1	23	13.0018440972
58	57	1	0	1	30.8017822097
58	59	6	0	6	24.8473100391
58	60	6	0	6	23.0437618703
58	61	14	3	11	10.832032768
58	62	35	0	35	11.8884783949
58	63	3	0	3	18.3976322929
58	64	109	81	28	7.33930681373
58	65	638	204	434	6.70255161072
58	66	2	1	1	18.2889786385
58	67	30	3	27	7.32150737417
58	68	7	0	7	29.3735394757
58	69	1	0	1	33.5517309478
58	71	1	0	1	69.245861182
58	73	9	0	9	65.2258210918
58	74	1	0	1	68.3934878625
58	75	1	0	1	64.3879857755
58	76	2	0	2	72.6897321531
58	78	1	1	0	70.0282562251
58	81	1	0	1	69.0594637693
58	82	1	0	1	70.4837470163
58	84	2	0	2	65.898142429
58	88	2	0	2	67.001528212
58	90	0	0	0	79.5881955368
58	95	2	1	1	58.5561965127
58	103	3	0	3	59.9289236853
58	110	1	0	1	56.2853619607
58	111	1	0	1	74.7153094472
58	112	1	0	1	57.6562424562
58	113	3	1	2	61.6386851473
58	114	1	0	1	52.1807303323
58	128	1	0	1	60.5267930383
58	137	1	0	1	67.0599690312
58	142	13	0	13	55.5057823153
58	146	1	0	1	65.6501611191
58	147	2	0	2	62.3262008162
58	190	0	0	0	108.428149118
58	235	1	0	1	109.439366693
58	257	1	0	1	66.3915268191
58	261	1	0	1	62.0568705791
58	277	0	0	0	86.2721455788
58	303	1	0	1	46.1159503391
58	307	1	0	1	57.7375472147
58	375	1	0	1	132.347520295
58	465	1	0	1	63.7495158369
58	466	2	0	2	62.5262107641
58	469	2	0	2	57.2262035617
58	476	1	0	1	37.7508778838
58	482	1	0	1	58.8357544626
58	484	1	0	1	34.0804083025
58	488	1	0	1	49.1873798155
58	495	0	0	0	72.2267424127
58	573	2	0	2	101.217618183
59	0	7	1	6	54.8824191461
59	1	408	27	381	54.0578394145
59	2	3	0	3	44.9613967734
59	3	1	0	1	56.5839444428
59	5	10	0	10	46.1642608817
59	6	4	0	4	38.220197449
59	7	4	0	4	50.9099937266
59	9	2	0	2	57.5267116128
59	10	2	0	2	47.7159748639
59	11	1	0	1	50.9825141614
59	12	2	0	2	50.567334754
59	13	11	1	10	50.8647054867
59	15	34	4	30	48.6524578153
59	16	0	0	0	58.6909857586
59	17	2	1	1	39.4241953846
59	18	3	0	3	53.3523531252
59	19	2	0	2	57.803273561
59	20	6	1	5	39.8466893317
59	21	11	0	11	44.9975251763
59	22	5	1	4	55.0037784611
59	23	5	1	4	44.2861754432
59	24	10	1	9	44.2533191126
59	25	4	1	3	42.3366680034
59	26	14	1	13	33.0752025427
59	27	4	1	3	33.7220294281
59	28	6	0	6	57.7735164242
59	29	12	0	12	31.2833072792
59	30	5	0	5	37.379529513
59	31	2	0	2	47.0231459257
59	33	1	0	1	47.1054874292
59	34	5	0	5	34.2063494039
59	35	26	2	24	42.3512265975
59	36	29	2	27	54.0761593827
59	37	8	0	8	35.3184965181
59	38	1	0	1	41.383313934
59	39	4	0	4	61.9836016764
59	41	1	0	1	47.0429185422
59	42	1	0	1	58.2611684795
59	43	86	27	59	12.1732881974
59	45	554	48	506	8.61245325699
59	46	107	19	88	24.6172230432
59	47	550	42	508	2.30839883284
59	48	1054	107	947	13.8885990999
59	49	36	4	32	29.4396636614
59	50	210	6	204	23.9502613317
59	51	7	2	5	29.3298278777
59	52	4	1	3	27.9968719502
59	53	9	3	6	35.4943608406
59	54	11	1	10	30.4098748133
59	55	85	22	63	14.7097157943
59	56	9	0	9	22.3144009661
59	57	92	5	87	13.3396804743
59	58	18	1	17	24.8473100391
59	60	143	57	86	20.1838969297
59	61	32	0	32	14.1581983431
59	62	10	0	10	22.0010383511
59	63	48	4	44	6.45921929693
59	64	6	1	5	30.0102497962
59	65	608	39	569	18.1929212779
59	66	8	1	7	26.5178711593
59	67	9	1	8	20.2567655158
59	68	281	106	175	23.5973887795
59	69	93	1	92	19.8279947465
59	70	8	0	8	75.1204461592
59	71	2	0	2	68.6915359273
59	73	70	7	63	67.5498890362
59	74	7	6	1	69.2748566238
59	75	8	3	5	65.9374923085
59	76	3	0	3	74.4149886462
59	77	2	0	2	71.2248220897
59	78	6	0	6	70.9788906904
59	79	1	0	1	70.0727593919
59	81	3	0	3	71.9484176812
59	82	4	0	4	72.2229168608
59	83	6	0	6	69.1790409912
59	84	11	1	10	67.7062715426
59	86	1	0	1	70.7659431144
59	87	8	0	8	66.2168853825
59	88	2	0	2	66.8546160128
59	89	2	0	2	74.899847224
59	95	2	0	2	63.0411139308
59	103	4	0	4	61.7163857765
59	105	1	0	1	70.6362569175
59	109	2	0	2	80.6226813772
59	111	1	0	1	80.4481468134
59	112	5	0	5	60.5172092124
59	113	23	2	21	61.5959107401
59	120	2	0	2	69.089369694
59	124	8	0	8	33.8490634259
59	126	2	0	2	35.4604510035
59	128	1	0	1	52.3612423683
59	131	19	0	19	26.479061397
59	132	2	0	2	38.0907059665
59	133	1	0	1	46.6518166283
59	136	1	0	1	41.7660290929
59	137	0	0	0	62.2102542421
59	138	1	0	1	43.090776747
59	140	5	0	5	55.933067891
59	141	3	2	1	53.6505263934
59	142	51	2	49	50.0451393561
59	146	0	0	0	63.5044888452
59	147	3	0	3	49.1799775895
59	148	1	0	1	39.5616252059
59	151	4	1	3	29.1891609507
59	160	1	0	1	63.0213800655
59	166	1	0	1	91.2497947429
59	169	1	0	1	90.5467056219
59	171	1	1	0	78.4190173249
59	172	1	0	1	69.6650020374
59	177	0	0	0	75.0131341209
59	183	1	0	1	134.847500119
59	208	1	0	1	140.646864405
59	216	1	0	1	151.47604878
59	218	1	0	1	148.596475021
59	220	0	0	0	155.120328822
59	221	1	0	1	149.222252706
59	229	2	0	2	144.883794248
59	245	2	0	2	82.268360552
59	251	2	0	2	92.2113188912
59	254	1	0	1	90.8060300182
59	257	2	0	2	77.6085120988
59	261	1	0	1	76.2417516201
59	262	1	0	1	93.4200683451
59	277	7	0	7	101.133126628
59	282	0	0	0	102.743903409
59	286	1	0	1	100.226418045
59	287	1	0	1	109.71885881
59	303	9	1	8	63.94947732
59	307	2	0	2	73.1826426721
59	319	1	0	1	103.514825269
59	455	1	0	1	63.3848144345
59	463	1	0	1	39.1915619222
59	464	45	8	37	19.5920822664
59	465	7	0	7	40.3292338568
59	466	22	1	21	38.072920338
59	468	6	0	6	31.8071697963
59	469	69	15	54	34.9071353117
59	470	1	0	1	33.0049303688
59	471	46	1	45	14.6300233452
59	472	13	0	13	26.5955708184
59	475	4	0	4	47.2095806534
59	476	72	2	70	20.7211541539
59	477	5	0	5	31.1051738362
59	479	19	0	19	14.8472854853
59	480	16	0	16	25.6301067883
59	481	1	0	1	29.1150203605
59	482	1	0	1	34.9673341132
59	483	1	0	1	43.2818068601
59	484	284	94	190	10.4387955852
59	486	23	1	22	21.3646033339
59	487	103	26	77	17.1731130404
59	488	12	0	12	24.5078005914
59	489	13	1	12	24.8584962355
59	490	3	2	1	17.1602361994
59	491	26	0	26	27.5096679528
59	492	2	0	2	32.4346805457
59	494	1	0	1	40.6757865295
59	495	1	0	1	48.2299760904
59	503	3	0	3	55.8140019026
59	505	1	0	1	47.0346534397
59	558	1	0	1	97.2782960151
59	573	0	0	0	88.2277583645
60	0	2	0	2	35.2852127838
60	1	243	0	243	36.8746343027
60	2	2	0	2	25.7287825293
60	3	1	0	1	36.6311639793
60	4	4	0	4	27.9280404975
60	5	7	0	7	31.3618862144
60	6	8	5	3	26.2532241795
60	7	8	0	8	31.5963843557
60	10	1	0	1	28.199872526
60	12	7	2	5	36.1379324289
60	13	9	0	9	31.0913307307
60	15	33	6	27	29.644601787
60	16	2	0	2	38.8933877484
60	17	9	1	8	20.826020203
60	18	1	0	1	33.3449173027
60	19	1	0	1	38.14744857
60	20	3	0	3	23.565587497
60	21	10	2	8	28.5852612516
60	22	2	1	1	39.895628481
60	23	7	2	5	26.7345440449
60	24	8	0	8	26.0161997587
60	26	24	6	18	15.3408569904
60	27	6	1	5	18.3165972098
60	28	8	0	8	39.7788458122
60	29	16	5	11	18.767061739
60	30	7	1	6	17.1992336577
60	31	2	0	2	27.1289463316
60	32	2	0	2	45.5026491078
60	33	13	1	12	27.0029793052
60	34	50	0	50	14.6143657604
60	35	57	0	57	22.3283915079
60	36	31	1	30	33.9122451038
60	37	30	3	27	15.5558449644
60	38	4	1	3	21.4590889568
60	39	1	0	1	41.935024294
60	41	2	0	2	26.8644443271
60	42	2	1	1	38.1165774865
60	43	5	1	4	23.5799730842
60	45	4	1	3	20.7477018923
60	46	42	14	28	17.3350803437
60	47	11	7	4	18.6178711324
60	48	360	93	267	6.91685139104
60	49	67	13	54	10.3804100059
60	50	688	334	354	4.0468958405
60	51	31	2	29	9.17790478679
60	52	8	5	3	12.9174927458
60	53	4	0	4	31.9539301517
60	54	21	6	15	12.3058396906
60	55	64	26	38	9.70568054254
60	56	25	2	23	10.8693151379
60	57	4	0	4	13.8087287485
60	58	4	0	4	23.0437618703
60	59	42	12	30	20.1838969297
60	61	4	0	4	19.3440229292
60	62	2	0	2	29.6201241219
60	63	1	0	1	17.6148755125
60	64	4	0	4	22.8475789637
60	65	179	8	171	18.7880358319
60	66	11	3	8	9.90724193915
60	67	5	0	5	15.7704443139
60	68	337	109	228	6.34885098013
60	69	19	0	19	12.4362821689
60	70	1	0	1	55.7306876799
60	71	1	0	1	50.2637054101
60	72	1	0	1	53.0997546425
60	73	23	1	22	48.1522055048
60	74	1	0	1	50.3342049146
60	75	2	0	2	46.7355262478
60	76	2	0	2	55.2759261863
60	78	3	0	3	52.0396070875
60	79	0	0	0	50.4060107655
60	82	2	0	2	53.0524783268
60	83	1	0	1	49.917778436
60	84	2	0	2	48.4544142781
60	85	1	0	1	55.4581463673
60	86	2	0	2	52.4099292927
60	87	3	1	2	47.35197495
60	92	1	0	1	57.1993100146
60	101	1	0	1	64.5644818977
60	103	3	0	3	42.3766171194
60	110	1	0	1	38.1775624625
60	112	4	0	4	40.88251823
60	113	2	1	1	42.8491043814
60	114	1	0	1	36.2620286569
60	124	8	0	8	19.4659615398
60	125	2	0	2	18.7803207459
60	129	1	0	1	30.5218662491
60	131	3	0	3	22.1127929798
60	134	1	0	1	32.7184515747
60	136	1	0	1	26.6570451621
60	138	2	0	2	23.902543396
60	142	20	1	19	33.7234200897
60	144	1	0	1	40.6617499666
60	145	2	0	2	25.0926496084
60	148	1	0	1	21.3870865415
60	151	4	0	4	19.2867727612
60	154	1	0	1	43.9156690713
60	164	1	0	1	55.9267959328
60	169	1	0	1	71.7441638033
60	177	0	0	0	59.3050880747
60	183	0	0	0	116.647755703
60	188	1	0	1	122.27357869
60	207	1	0	1	115.366507724
60	208	0	0	0	120.502827454
60	220	0	0	0	136.694128165
60	260	1	0	1	56.854618132
60	262	1	0	1	73.4068082204
60	275	1	0	1	82.1869290601
60	277	4	0	4	81.6046811037
60	282	1	0	1	82.7415926041
60	303	5	2	3	46.4045633419
60	306	1	0	1	53.9491991526
60	307	1	0	1	54.208806785
60	309	3	1	2	47.560818359
60	338	1	0	1	101.878097113
60	408	1	0	1	77.076746524
60	464	13	4	9	26.7830972569
60	465	2	0	2	46.5680032979
60	466	1	0	1	47.8534805052
60	468	1	0	1	27.8585870949
60	469	11	0	11	38.9392791714
60	471	5	0	5	25.9733919156
60	472	9	0	9	27.9667837501
60	475	2	0	2	45.1183327215
60	476	9	0	9	17.6323138949
60	477	1	0	1	39.2565591158
60	479	4	0	4	20.4569978237
60	480	5	0	5	32.4216024272
60	484	5	0	5	29.8339445116
60	486	2	0	2	40.643927884
60	488	2	0	2	40.3710183536
60	491	2	0	2	38.8018717218
60	494	1	0	1	42.5196436332
60	495	2	0	2	55.7256463038
60	503	1	0	1	59.5062475808
60	505	1	0	1	59.4459383052
61	0	1	0	1	48.1372258359
61	1	191	6	185	44.2353738319
61	3	1	0	1	50.7402499798
61	5	10	0	10	35.0452864993
61	6	8	0	8	26.1921414622
61	7	6	0	6	43.797608626
61	8	1	0	1	40.0201063606
61	11	1	0	1	38.2046982889
61	12	5	0	5	38.9879937094
61	13	5	0	5	44.7233351322
61	15	7	4	3	41.1717812812
61	17	1	0	1	32.1180134765
61	18	1	0	1	47.8427635478
61	20	7	2	5	30.2693302462
61	21	9	4	5	35.0698978589
61	23	12	0	12	35.3975564341
61	24	6	0	6	36.080925719
61	25	5	1	4	29.2103852701
61	26	11	0	11	25.6876379406
61	27	11	5	6	24.2998743363
61	28	4	0	4	48.5739253033
61	29	35	1	34	20.4539971413
61	30	2	0	2	33.9503856597
61	32	1	0	1	58.6794216988
61	33	2	0	2	42.3400190793
61	34	4	1	3	33.4288765824
61	35	7	0	7	37.4935022416
61	36	12	3	9	50.4807196296
61	37	3	0	3	30.3326540781
61	39	1	0	1	56.3548188893
61	41	3	0	3	43.477433811
61	42	2	0	2	53.3411098504
61	43	141	2	139	5.84692184337
61	44	9	1	8	12.7274419425
61	45	5	0	5	21.9116956844
61	46	220	0	220	12.6026711739
61	47	37	0	37	12.0323623215
61	48	69	33	36	17.208427899
61	49	17	4	13	24.2218711719
61	50	39	0	39	21.3492936843
61	51	5	1	4	26.4100622059
61	53	44	1	43	21.3618381134
61	54	1	0	1	31.6493882341
61	55	48	1	47	9.64394360594
61	56	32	4	28	13.867934567
61	57	6	0	6	22.3553084346
61	58	37	1	36	10.832032768
61	59	47	11	36	14.1581983431
61	60	7	3	4	19.3440229292
61	62	108	2	106	10.5821523946
61	63	16	14	2	7.81483720635
61	64	14	1	13	16.8976794275
61	65	1869	174	1695	4.55092306444
61	66	1	0	1	19.767320792
61	67	40	14	26	8.46556896749
61	68	19	0	19	25.3137926654
61	69	7	1	6	26.66516038
61	70	0	0	0	73.9127592791
61	71	1	0	1	69.2206151906
61	73	28	3	25	66.4067549959
61	74	2	0	2	68.9878815573
61	75	7	0	7	65.2092632011
61	76	1	0	1	73.7230755747
61	78	3	0	3	70.6794197732
61	79	0	0	0	68.260672252
61	81	2	1	1	70.5548304917
61	82	3	1	2	71.4907849863
61	83	1	0	1	68.2994859257
61	84	2	0	2	66.86130258
61	86	1	0	1	71.3858562634
61	87	2	0	2	66.0860684288
61	95	1	0	1	60.5790536929
61	103	1	0	1	60.7686400131
61	110	1	0	1	56.7418386067
61	112	1	0	1	58.9278992545
61	113	6	0	6	61.6998517948
61	124	1	0	1	38.1681782569
61	128	1	0	1	57.029710815
61	133	2	0	2	47.0788391058
61	137	0	0	0	65.1192772339
61	138	0	0	0	42.7533355231
61	142	8	0	8	53.0476208722
61	146	1	0	1	64.8631007414
61	175	1	0	1	80.5280993153
61	220	2	0	2	145.150614009
61	241	1	0	1	170.40452176
61	242	0	0	0	163.472887543
61	244	1	0	1	165.931828768
61	245	0	0	0	77.545394136
61	257	1	0	1	71.5842179394
61	277	5	0	5	93.2469082603
61	281	1	0	1	91.6359800315
61	284	1	0	1	105.384200482
61	303	1	0	1	54.0824531401
61	304	2	0	2	52.8218993369
61	309	1	0	1	59.4092050001
61	338	0	0	0	120.724021056
61	359	0	0	0	128.42570934
61	408	1	0	1	86.925873286
61	464	1	0	1	32.6679458415
61	465	2	0	2	53.8902196512
61	466	2	0	2	52.136377749
61	469	1	0	1	47.8211460522
61	471	5	0	5	28.3950416842
61	475	1	0	1	58.4367581479
61	476	1	0	1	29.9240627349
61	477	1	0	1	44.8596377923
61	482	1	0	1	48.0609421085
61	484	10	4	6	23.2645634707
61	487	2	0	2	30.2155086971
61	489	1	0	1	35.628267104
61	491	1	0	1	41.6127095588
61	503	2	0	2	69.0161943516
61	505	0	0	0	61.1569973059
61	566	1	0	1	92.8375986771
61	569	0	0	0	100.061050169
61	573	0	0	0	96.1361425042
62	1	95	18	77	48.4662154638
62	2	1	0	1	44.976527921
62	3	0	0	0	57.8316858843
62	5	6	1	5	38.3260165956
62	6	7	1	6	28.9780644414
62	7	5	1	4	50.2999440484
62	8	2	0	2	39.0250404623
62	9	2	0	2	56.4559727301
62	11	1	0	1	38.7112194834
62	13	5	1	4	51.8225570844
62	15	6	0	6	47.5244029449
62	16	1	0	1	58.9855071853
62	17	6	0	6	39.0729611092
62	19	1	0	1	57.5906372519
62	20	1	0	1	35.571163858
62	21	7	1	6	39.6842736081
62	23	14	1	13	40.9521117704
62	24	2	0	2	42.1753060982
62	26	3	0	3	33.0737097699
62	27	8	0	8	30.3082743369
62	28	6	3	3	53.2300608444
62	29	23	8	15	25.581287116
62	30	2	0	2	42.8266412508
62	33	2	0	2	50.2936137848
62	35	11	0	11	45.5829940246
62	36	6	1	5	58.7739139606
62	38	2	1	1	48.7571853141
62	41	1	0	1	51.9664267379
62	42	2	0	2	60.8973065981
62	43	94	26	68	9.83157026216
62	44	49	25	24	8.47405491778
62	46	106	12	94	17.9770334541
62	47	6	2	4	20.4117009498
62	48	33	0	33	27.7775463179
62	49	8	1	7	32.8943836701
62	50	30	2	28	31.1459862752
62	51	4	1	3	35.8223083339
62	53	58	1	57	18.4098286832
62	55	27	3	24	19.9624398417
62	56	13	1	12	22.160902183
62	57	1	0	1	32.4725767989
62	58	92	1	91	11.8884783949
62	59	21	0	21	22.0010383511
62	60	1	0	1	29.6201241219
62	61	72	7	65	10.5821523946
62	63	10	4	6	16.8170554043
62	64	14	6	8	19.1402310686
62	65	839	107	732	11.2694213164
62	66	0	0	0	28.1213607297
62	67	24	1	23	15.6360689434
62	68	5	2	3	35.7441902177
62	69	2	0	2	37.1656956162
62	73	13	1	12	75.4577102218
62	74	0	0	0	78.3133855934
62	78	2	0	2	79.9852703738
62	83	1	0	1	77.4262044276
62	84	2	0	2	76.0154691846
62	87	1	0	1	75.4904869848
62	89	1	0	1	79.9077397613
62	112	3	0	3	67.9071689403
62	124	3	1	2	48.6938493298
62	142	12	0	12	63.3247598141
62	153	0	0	0	61.173764042
62	163	1	0	1	77.2375010865
62	171	1	1	0	89.6945399272
62	177	1	0	1	88.8926781429
62	183	2	0	2	127.268640065
62	184	1	0	1	119.409560663
62	208	0	0	0	140.74003379
62	235	1	0	1	121.257871972
62	242	0	0	0	166.615965636
62	245	1	0	1	84.7926202341
62	267	1	0	1	99.9296992531
62	270	1	0	1	87.9891892245
62	277	2	0	2	98.1493158491
62	303	2	0	2	57.9066289615
62	307	2	0	2	69.6221500737
62	308	1	0	1	72.903933993
62	309	1	0	1	65.1141859174
62	442	1	0	1	109.476684711
62	464	1	0	1	41.5310777533
62	465	1	0	1	62.2983180841
62	469	3	0	3	56.8489023299
62	471	2	0	2	36.6067907379
62	476	2	0	2	40.1658986045
62	477	1	0	1	53.0182456893
62	480	1	1	0	47.6263214052
62	482	1	0	1	51.9902839468
62	484	2	0	2	28.4902046192
62	573	1	0	1	106.708518453
62	576	1	0	1	103.154413098
63	0	1	0	1	50.6784218361
63	1	113	7	106	48.723700283
63	2	5	0	5	40.6178255618
63	4	1	0	1	41.8928023597
63	5	6	0	6	40.3694133097
63	6	7	1	6	32.1251756169
63	7	3	0	3	46.5356762729
63	11	2	0	2	44.7361608698
63	12	1	0	1	44.6521622275
63	13	4	0	4	46.8642685004
63	15	10	2	8	44.1209994512
63	17	6	0	6	34.8576293014
63	18	2	0	2	49.6226228176
63	19	2	0	2	53.6248777086
63	20	3	1	2	34.4947960467
63	21	1	0	1	39.5742174046
63	23	1	0	1	39.2090074735
63	24	1	0	1	39.42869581
63	25	2	0	2	35.9941018672
63	26	3	0	3	28.3740345871
63	27	9	0	9	28.3451478328
63	28	4	1	3	52.6746762624
63	29	8	2	6	25.4511496639
63	32	1	0	1	61.2039215355
63	33	1	0	1	43.6167559089
63	34	2	0	2	32.2154880919
63	35	8	0	8	38.7674053823
63	36	11	0	11	51.1377705236
63	39	1	0	1	58.2653863372
63	41	0	0	0	44.0482729265
63	42	1	0	1	54.8062593532
63	43	246	66	180	7.54110169415
63	44	1	0	1	20.5055650787
63	45	24	14	10	14.1543440324
63	46	110	19	91	18.4043545472
63	47	237	23	214	4.24197084925
63	48	172	10	162	12.8990442802
63	49	19	0	19	25.4541823741
63	50	41	5	36	20.8171010446
63	51	4	1	3	26.2723672675
63	52	1	0	1	27.9348356504
63	53	21	7	14	29.0696828992
63	55	59	0	59	9.75192710345
63	56	25	7	18	16.9383254657
63	57	5	0	5	15.8640509669
63	58	18	1	17	18.3976322929
63	59	204	165	39	6.45921929693
63	60	23	2	21	17.6148755125
63	61	69	3	66	7.81483720635
63	62	19	5	14	16.8170554043
63	64	12	1	11	23.6367098144
63	65	697	0	697	11.734111436
63	66	6	0	6	21.8685221196
63	67	12	2	10	14.0007441975
63	68	61	6	55	22.4488582014
63	69	15	0	15	21.2811451592
63	70	2	0	2	73.3445344646
63	71	1	0	1	67.6670262338
63	73	13	5	8	65.7651117004
63	74	2	0	2	67.8825482418
63	78	0	0	0	69.5896376226
63	79	0	0	0	68.0062159658
63	83	1	0	1	67.5203651932
63	84	2	0	2	66.0551203003
63	87	1	0	1	64.8784148437
63	88	2	0	2	65.6988144324
63	95	1	0	1	60.6516271658
63	103	2	0	2	59.9832414026
63	111	1	0	1	77.9571873199
63	112	1	0	1	58.4917896538
63	113	4	1	3	60.3355704517
63	120	1	0	1	66.7552622421
63	122	1	0	1	81.4061047246
63	124	5	0	5	34.3030155095
63	125	1	0	1	35.3960236547
63	126	1	0	1	37.6488098
63	131	5	1	4	29.5508342485
63	137	1	0	1	62.2635077371
63	142	7	0	7	50.0536578232
63	151	1	0	1	30.8627452606
63	153	1	0	1	45.3821568081
63	171	1	0	1	77.8831973748
63	183	1	0	1	129.551708539
63	186	1	0	1	129.755840975
63	190	1	0	1	123.035448715
63	196	1	0	1	161.190279264
63	220	1	0	1	149.89595031
63	242	0	0	0	167.846784693
63	245	0	0	0	79.0109484214
63	261	1	0	1	71.7709355734
63	272	1	0	1	113.183559247
63	277	2	0	2	96.6497212195
63	280	1	0	1	102.84590225
63	282	0	0	0	98.8004670121
63	303	1	0	1	58.6403783634
63	304	4	0	4	56.036335101
63	307	3	1	2	68.4223722124
63	309	2	0	2	62.515204328
63	464	6	1	5	25.0256651063
63	465	0	0	0	46.1586470298
63	466	0	0	0	44.322870467
63	469	8	0	8	40.275408312
63	471	5	3	2	20.5949836172
63	475	1	0	1	51.5568012513
63	476	9	1	8	23.6157135014
63	480	1	0	1	31.251131675
63	484	13	3	10	16.3435161381
63	487	3	0	3	23.2632854797
63	488	1	0	1	30.9313503188
63	491	2	0	2	33.8072256478
63	501	1	0	1	56.9612903694
63	503	1	1	0	61.4033811505
63	573	1	0	1	90.8637354295
64	0	3	0	3	36.5341245186
64	1	351	0	351	29.3310004883
64	2	1	0	1	27.3542426512
64	3	2	0	2	40.0196129648
64	5	23	5	18	19.2265525043
64	6	129	2	127	9.90253971446
64	7	8	2	6	32.1180815637
64	8	6	0	6	23.4058695301
64	10	2	0	2	30.4771123277
64	11	7	0	7	21.3071718241
64	12	4	0	4	22.6119717359
64	13	5	3	2	34.1694760085
64	15	12	0	12	29.2900126806
64	17	10	3	7	21.8458211442
64	18	1	0	1	37.7720659645
64	20	12	3	9	16.9718765898
64	21	47	0	47	20.6596101982
64	22	5	0	5	27.3084319853
64	23	19	9	10	22.3286643886
64	24	9	1	8	23.8980021008
64	25	26	5	21	12.3751298452
64	26	20	2	18	17.1296120632
64	27	39	0	39	12.7959525985
64	28	3	0	3	34.1286632484
64	29	281	85	196	7.83712299254
64	30	2	1	1	28.6438308459
64	31	2	0	2	39.6331995252
64	33	1	0	1	33.8130106736
64	34	1	0	1	31.6074526607
64	35	9	3	6	29.5804402649
64	36	13	2	11	42.5128147166
64	37	3	0	3	23.8407699377
64	39	1	0	1	45.5043893151
64	41	2	1	1	36.3267773258
64	43	4	0	4	22.2088974326
64	44	2	0	2	11.6709110719
64	46	240	45	195	5.96748950521
64	47	2	0	2	27.7103450897
64	48	26	3	23	25.8603683534
64	49	6	0	6	19.6004438534
64	50	14	1	13	21.6810314553
64	51	2	0	2	24.023552835
64	53	501	105	396	9.49735637282
64	55	7	4	3	17.3842374392
64	56	23	2	21	11.9886932508
64	58	94	19	75	7.33930681373
64	59	4	0	4	30.0102497962
64	60	2	1	1	22.8475789637
64	61	10	0	10	16.8976794275
64	62	11	0	11	19.1402310686
64	63	2	1	1	23.6367098144
64	65	250	42	208	12.3492171885
64	66	8	0	8	15.2898419674
64	67	19	2	17	9.87871244766
64	68	4	1	3	28.7843647388
64	69	2	0	2	34.7216856528
64	70	2	0	2	67.2544807588
64	73	11	0	11	60.2046623738
64	74	4	2	2	63.6511005172
64	75	4	0	4	59.5668626143
64	76	1	0	1	67.6742828562
64	78	1	0	1	65.2389421107
64	81	0	0	0	63.8387939313
64	84	2	0	2	60.9845442916
64	89	1	0	1	62.9762651131
64	92	0	0	0	67.1147744506
64	96	1	0	1	79.1631035578
64	102	3	0	3	51.383912429
64	103	2	1	1	55.1530842098
64	110	1	0	1	51.7747687858
64	112	2	0	2	52.6791596925
64	113	4	0	4	57.27181168
64	120	1	0	1	58.9693406728
64	130	1	0	1	58.055861851
64	131	1	0	1	44.6048935336
64	135	1	0	1	64.5134246282
64	136	1	0	1	47.3781859587
64	140	2	0	2	53.5743117536
64	142	8	0	8	52.7770223157
64	147	1	0	1	61.6361276166
64	183	0	0	0	108.631452645
64	188	0	0	0	116.520987192
64	208	1	0	1	121.823013625
64	220	1	0	1	129.110192109
64	229	1	0	1	123.128999678
64	277	3	0	3	79.0228672325
64	303	4	0	4	38.7887193719
64	304	2	0	2	39.7188207445
64	306	1	0	1	47.2242657274
64	307	1	1	0	50.5171671948
64	408	2	0	2	98.94906646
64	464	1	0	1	45.8702954111
64	465	0	0	0	67.0274598995
64	469	2	0	2	60.0237139793
64	476	1	0	1	39.4802829196
64	484	1	0	1	39.879706991
64	485	0	0	0	72.3912186401
65	0	9	1	8	44.5962688626
65	1	777	75	702	40.0138642581
65	2	9	0	9	34.6187153723
65	3	1	0	1	47.409379352
65	4	1	0	1	35.0098408856
65	5	41	4	37	30.6360670822
65	6	25	6	19	21.6908845846
65	7	14	1	13	40.2060593776
65	8	3	0	3	35.5412961129
65	9	1	0	1	46.590606701
65	11	2	0	2	33.6563040756
65	12	3	0	3	34.5030673724
65	13	19	4	15	41.3783045229
65	15	23	5	18	37.5145923133
65	16	1	0	1	48.7979371875
65	17	11	0	11	28.6525572469
65	18	1	0	1	44.6321858685
65	19	3	0	3	47.5113092179
65	20	13	2	11	26.2197134785
65	21	20	8	12	30.8867247668
65	22	5	1	4	39.157255343
65	23	34	6	28	31.4523623632
65	24	19	1	18	32.3086995213
65	25	11	2	9	24.6784612868
65	26	33	0	33	22.3764942571
65	27	59	9	50	20.4045011722
65	28	16	0	16	44.4552878857
65	29	158	64	94	16.2536464302
65	30	10	0	10	31.6184718436
65	31	1	0	1	42.8749541256
65	32	1	0	1	55.0896975724
65	33	8	0	8	39.414474744
65	34	6	1	5	31.9601849892
65	35	52	0	52	34.6320434568
65	36	41	10	31	47.7739473934
65	37	1	0	1	27.6252159213
65	38	1	0	1	37.4968168693
65	39	4	0	4	53.0312668428
65	41	3	0	3	40.8834980441
65	42	4	0	4	50.2325338817
65	43	174	87	87	10.1156630529
65	44	31	5	26	10.0566547561
65	45	9	3	6	25.393917452
65	46	757	504	253	8.2819469429
65	47	42	9	33	15.9576637567
65	48	228	77	151	18.3285546679
65	49	33	3	30	21.7035311293
65	50	168	75	93	19.9603451489
65	51	15	0	15	24.5542706761
65	52	2	0	2	31.570009045
65	53	172	69	103	17.4342714628
65	54	2	0	2	30.903782253
65	55	142	120	22	9.52731877808
65	56	110	79	31	10.981411512
65	57	2	0	2	24.5635399298
65	58	178	130	48	6.70255161072
65	59	87	0	87	18.1929212779
65	60	34	0	34	18.7880358319
65	61	233	157	76	4.55092306444
65	62	233	26	207	11.2694213164
65	63	26	2	24	11.734111436
65	64	63	3	60	12.3492171885
65	66	6	0	6	16.9865032733
65	67	145	43	102	4.64498049568
65	68	47	0	47	25.074716108
65	69	8	1	7	27.9531923539
65	70	9	1	8	71.6757744723
65	73	112	5	107	64.244574043
65	74	8	0	8	67.0569486435
65	75	17	0	17	63.1794739914
65	76	2	0	2	71.6373569462
65	77	1	0	1	67.0543481515
65	78	10	1	9	68.7314729799
65	79	6	0	6	65.8899775154
65	80	1	0	1	67.3598837515
65	81	4	1	3	68.2875115016
65	82	5	0	5	69.4091379188
65	83	4	0	4	66.1990309779
65	84	11	0	11	64.782795911
65	86	1	0	1	69.7079685244
65	87	8	0	8	64.2263124642
65	88	0	0	0	65.3677164677
65	90	2	0	2	78.3128771092
65	92	1	0	1	72.3448637138
65	95	1	1	0	58.0869157513
65	96	1	0	1	83.134449353
65	98	2	0	2	71.8439344456
65	100	1	0	1	54.5581367984
65	102	2	0	2	58.2784166251
65	103	9	0	9	58.7161244465
65	104	3	0	3	59.771407889
65	110	3	0	3	54.8202712717
65	112	11	0	11	56.7051634928
65	113	19	1	18	59.9528983947
65	119	1	0	1	76.1163103018
65	120	1	0	1	64.1450651656
65	122	0	0	0	78.959222236
65	124	4	0	4	38.1772338127
65	128	2	0	2	56.7806420938
65	129	1	0	1	46.9655715053
65	131	6	1	5	37.5155233114
65	140	5	0	5	55.2938959441
65	141	2	0	2	64.4270047802
65	142	51	1	50	52.3146382085
65	143	1	0	1	50.3085892186
65	145	1	1	0	43.5716932236
65	147	3	0	3	57.5080562971
65	148	1	0	1	39.5837525611
65	151	4	0	4	36.8514267408
65	153	2	0	2	51.3789357548
65	154	1	0	1	62.7033094423
65	156	1	0	1	85.5773453357
65	171	1	0	1	78.4393467256
65	172	2	0	2	72.3840985707
65	182	1	0	1	125.170642955
65	183	7	0	7	120.326984721
65	188	2	0	2	127.775334863
65	190	1	0	1	113.247755082
65	196	0	0	0	154.177653701
65	208	3	0	3	131.066006214
65	212	1	0	1	118.402573895
65	217	1	0	1	140.45077356
65	220	1	0	1	140.773506702
65	222	0	0	0	131.861102515
65	242	0	0	0	159.17427763
65	245	5	0	5	74.3290171629
65	247	1	0	1	94.7621905416
65	262	2	0	2	83.3883462079
65	275	0	0	0	88.2505641805
65	276	1	0	1	98.2269526651
65	277	15	0	15	89.2597885326
65	280	2	1	1	95.0225754839
65	282	1	0	1	92.5070579506
65	294	0	0	0	113.295909782
65	303	6	1	5	49.8137068462
65	304	4	0	4	48.9918642583
65	305	1	0	1	72.2799097481
65	306	0	0	0	58.2008942203
65	307	4	1	3	60.7155746794
65	308	1	0	1	64.7393171523
65	309	1	0	1	55.5935602523
65	319	1	0	1	107.033378959
65	338	0	0	0	118.819588374
65	375	1	0	1	133.41352252
65	442	1	0	1	105.174441061
65	464	6	0	6	35.8337769584
65	465	3	0	3	57.1491110434
65	466	5	0	5	55.8285669667
65	469	13	0	13	50.7500008351
65	470	1	0	1	46.60299024
65	471	14	2	12	31.960635819
65	472	1	0	1	40.7951742864
65	474	1	1	0	54.4649116799
65	475	3	0	3	60.5267315595
65	476	5	0	5	31.7922145099
65	477	1	0	1	48.2915496035
65	479	1	0	1	29.7206775382
65	480	2	1	1	42.1363106619
65	484	10	0	10	27.67872999
65	486	1	0	1	37.8017607683
65	487	3	1	2	34.6381170958
65	488	4	1	3	42.616265455
65	489	1	0	1	40.1787542078
65	491	5	0	5	45.3878445536
65	496	1	0	1	64.6789708143
65	499	1	0	1	65.4133216587
65	501	1	0	1	68.5549932519
65	503	1	0	1	71.9972089011
65	505	0	0	0	65.2111247404
65	506	1	0	1	89.5753989281
65	555	1	0	1	120.073009252
65	573	1	0	1	96.7165017056
65	587	1	0	1	123.385355146
66	0	5	0	5	28.8479848343
66	1	302	7	295	27.8755991014
66	2	7	0	7	18.7648741795
66	3	0	0	0	31.134606832
66	4	1	0	1	20.0905296789
66	5	15	0	15	21.5381169167
66	6	11	4	7	16.5637011399
66	7	8	2	6	24.669999888
66	9	1	0	1	31.2779066184
66	10	1	0	1	21.7257691796
66	12	6	1	5	26.2984957968
66	13	14	1	13	25.1644929495
66	14	1	1	0	21.623213538
66	15	16	2	14	22.261919003
66	17	15	1	14	12.996510383
66	18	2	0	2	28.1471293343
66	19	3	0	3	31.7977536527
66	20	8	0	8	13.9947505712
66	21	10	1	9	19.1414930606
66	22	2	1	1	30.1868667698
66	23	19	1	18	17.8813257784
66	24	11	4	7	17.7354903246
66	25	2	0	2	22.9908416669
66	26	81	29	52	6.56112024401
66	27	31	1	30	8.43166591911
66	28	7	0	7	31.3235569917
66	29	42	0	42	9.36768850216
66	30	15	0	15	14.7429907561
66	32	2	0	2	39.3957663481
66	33	6	0	6	22.5753588799
66	34	17	1	16	16.4489301763
66	35	99	32	67	17.738211834
66	36	12	1	11	30.8129742329
66	37	35	8	27	10.6452917621
66	38	1	0	1	20.8731496694
66	40	1	1	0	42.1140861098
66	41	1	0	1	23.897562377
66	42	1	0	1	33.5893409156
66	43	6	0	6	25.3424058914
66	45	1	0	1	29.3363665081
66	46	32	6	26	11.3115649512
66	48	64	25	39	15.8250832218
66	49	169	79	90	4.828847819
66	50	340	2	338	7.10039014107
66	51	26	0	26	8.77919952266
66	52	5	1	4	20.4431721456
66	53	11	0	11	24.7871817657
66	54	5	0	5	17.4404217356
66	55	22	1	21	12.1209793161
66	56	86	52	34	6.01100237773
66	57	5	2	3	23.3898044381
66	58	2	0	2	18.2889786385
66	59	10	1	9	26.5178711593
66	60	42	21	21	9.90724193915
66	61	2	0	2	19.767320792
66	62	3	0	3	28.1213607297
66	63	2	0	2	21.8685221196
66	64	4	0	4	15.2898419674
66	65	159	0	159	16.9865032733
66	67	9	1	8	12.4852973163
66	68	36	14	22	14.5236336731
66	69	4	0	4	22.2602918878
66	73	34	3	31	47.35355022
66	74	1	1	0	50.3169212026
66	75	3	0	3	46.3734926904
66	76	1	0	1	54.7783577955
66	78	0	0	0	51.9734410677
66	82	1	0	1	52.5560514174
66	84	2	0	2	47.9400354173
66	87	3	0	3	47.5574228811
66	95	1	0	1	41.1012039801
66	96	1	0	1	66.2964036342
66	99	1	0	1	34.1374657911
66	102	3	0	3	41.6217668297
66	103	6	0	6	41.9057047542
66	111	1	0	1	57.880064466
66	112	0	0	0	39.7953806502
66	113	8	3	5	43.4178712966
66	124	3	1	2	26.230772891
66	129	1	0	1	30.2956101453
66	131	3	0	3	31.7201814303
66	140	1	0	1	39.1560006578
66	142	6	0	6	37.6098929762
66	151	1	0	1	27.9872547277
66	185	1	0	1	116.873738614
66	208	0	0	0	115.329480614
66	225	1	0	1	114.398743422
66	260	1	0	1	52.0879506421
66	277	4	1	3	74.8011844125
66	282	1	0	1	77.0102612662
66	303	4	0	4	37.6660927069
66	307	3	0	3	46.6878765228
66	464	4	0	4	36.4858929285
66	465	0	0	0	56.4746003464
66	467	1	0	1	60.204707143
66	469	2	0	2	48.8359501741
66	472	4	0	4	37.8531091818
66	476	1	0	1	27.5085064938
66	477	0	0	0	49.0742561824
66	484	2	0	2	36.8729709902
66	503	1	0	1	69.3011914191
67	0	4	1	3	39.9731448181
67	1	239	33	206	35.7792457034
67	2	2	0	2	29.9811133752
67	3	1	0	1	42.7654999837
67	4	1	0	1	30.4272995613
67	5	7	0	7	26.7439284964
67	6	10	4	6	18.1777541783
67	7	5	1	4	35.5912038106
67	8	1	0	1	33.2277972629
67	9	1	0	1	42.0017568045
67	10	3	0	3	33.1111103329
67	11	3	0	3	30.7436399052
67	12	4	0	4	30.8444049355
67	13	8	0	8	36.7344604842
67	15	7	4	3	32.9141713016
67	16	1	0	1	44.1678904248
67	17	5	0	5	24.0137724705
67	18	3	0	3	39.9883162785
67	20	6	1	5	21.8100274402
67	21	10	3	7	26.6084526853
67	22	1	0	1	35.4318117628
67	23	4	0	4	26.9705008534
67	24	7	1	6	27.7422847866
67	25	2	0	2	22.1008212469
67	26	8	0	8	17.7327950785
67	27	15	0	15	15.8836564253
67	28	5	0	5	40.1092803282
67	29	107	0	107	12.0108937014
67	30	4	0	4	27.2015093474
67	32	1	0	1	50.4785393943
67	33	1	0	1	34.8033706057
67	34	2	0	2	27.9888862338
67	35	11	0	11	30.0383300574
67	36	14	1	13	43.2022690937
67	37	1	0	1	23.0867087619
67	38	1	0	1	33.2026156882
67	39	1	0	1	48.3874748089
67	41	1	0	1	36.3500540379
67	42	2	0	2	45.5936784519
67	43	19	3	16	14.3051510916
67	44	4	1	3	12.4346267275
67	45	3	0	3	26.3949335761
67	46	542	454	88	4.41304537162
67	47	10	5	5	17.9488293265
67	48	54	12	42	16.9213506788
67	49	6	3	3	17.2665501727
67	50	30	16	14	16.2291529846
67	51	5	0	5	20.4274725978
67	52	1	1	0	28.6868789355
67	53	61	30	31	17.2381931138
67	54	4	0	4	27.4346011369
67	55	32	26	6	7.95387218399
67	56	63	0	63	6.54964870517
67	57	2	0	2	24.015227347
67	58	53	1	52	7.32150737417
67	59	16	0	16	20.2567655158
67	60	13	5	8	15.7704443139
67	61	34	1	33	8.46556896749
67	62	22	0	22	15.6360689434
67	63	3	1	2	14.0007441975
67	64	26	16	10	9.87871244766
67	65	1272	621	651	4.64498049568
67	66	2	0	2	12.4852973163
67	68	17	0	17	22.115000835
67	69	5	0	5	26.3282009639
67	70	1	0	1	67.2265021148
67	73	15	1	14	59.828907083
67	74	3	1	2	62.7321509872
67	76	1	0	1	67.2444105262
67	78	3	1	2	64.3975499593
67	81	4	0	4	63.8300851549
67	84	1	0	1	60.3991654858
67	87	2	0	2	59.936375097
67	88	1	0	1	61.1267319599
67	90	1	0	1	73.9806435529
67	102	1	0	1	53.6389366053
67	103	7	2	5	54.3502984497
67	112	6	0	6	52.2749273918
67	113	5	0	5	55.7218804235
67	124	0	0	0	35.2093823878
67	128	1	0	1	53.4875989087
67	129	1	0	1	42.6641313725
67	137	1	0	1	60.4353151466
67	142	6	1	5	48.6959650358
67	144	1	0	1	55.7255982675
67	147	3	0	3	55.0200730315
67	154	1	0	1	59.4595231073
67	164	1	0	1	69.7868149622
67	176	1	0	1	68.6636284391
67	183	0	0	0	116.345512901
67	184	2	0	2	108.530649447
67	208	0	0	0	126.473480428
67	245	0	0	0	69.6840941992
67	251	1	0	1	81.401611682
67	277	7	0	7	84.8154007872
67	281	0	0	0	83.3411690111
67	282	1	0	1	87.9321357222
67	303	1	0	1	45.6390525955
67	305	1	0	1	67.8147912433
67	307	1	0	1	56.2975911519
67	308	2	0	2	60.5002210284
67	408	0	0	0	89.7285597886
67	460	1	0	1	73.0679360937
67	465	1	0	1	57.4480275501
67	466	0	0	0	56.7907017869
67	469	5	0	5	50.6444470312
67	471	1	0	1	32.946393518
67	475	0	0	0	59.3579887968
67	480	3	1	2	42.4704653244
67	482	2	0	2	55.1425727932
67	484	1	0	1	30.3419856132
68	0	4	1	3	34.9865533821
68	1	502	43	459	38.891157784
68	2	9	0	9	26.32113435
68	3	5	1	4	35.5874953664
68	4	4	2	2	29.0915110872
68	5	10	0	10	34.8861257294
68	6	6	1	5	31.0485577199
68	7	12	4	8	31.8315727217
68	9	5	0	5	38.0505065363
68	10	3	1	2	28.2647529973
68	11	3	1	2	43.4213625284
68	12	3	0	3	39.6477013675
68	13	11	0	11	30.5946959802
68	14	5	0	5	26.9105721196
68	15	82	6	76	30.339731701
68	16	2	0	2	38.1520305839
68	17	10	1	9	22.4767645187
68	20	3	0	3	26.758593648
68	21	9	2	7	31.4138183793
68	22	1	0	1	42.9849152689
68	23	14	6	8	28.9099223895
68	24	9	0	9	27.6719145262
68	25	1	0	1	37.5143810618
68	26	33	10	23	18.3280198711
68	27	9	2	7	22.3832637696
68	28	8	0	8	41.1148039768
68	29	13	0	13	23.8656656135
68	30	22	4	18	15.7689365965
68	31	11	0	11	23.7499581376
68	32	6	0	6	44.6531199527
68	33	37	4	33	25.7144473799
68	34	208	58	150	10.9063100888
68	35	185	0	185	21.5514563558
68	36	60	2	58	31.3907608008
68	37	24	0	24	16.0220928558
68	38	3	1	2	18.2480795491
68	39	4	0	4	40.522146391
68	41	8	3	5	24.6443752339
68	42	2	0	2	36.3518578084
68	43	4	0	4	29.0753801848
68	45	5	0	5	21.7990138682
68	46	31	0	31	23.4839970089
68	47	17	1	16	22.492545215
68	48	821	596	225	9.80207484018
68	49	111	35	76	12.8791009889
68	50	833	156	677	7.42502548184
68	51	35	1	34	9.26095990158
68	52	118	11	107	6.57295733786
68	53	3	0	3	38.0513926806
68	54	235	124	111	6.86387640249
68	55	28	2	26	15.7849072979
68	56	19	12	7	16.9344400366
68	57	23	1	22	13.5275865855
68	58	6	1	5	29.3735394757
68	59	72	19	53	23.5973887795
68	60	501	181	320	6.34885098013
68	61	8	3	5	25.3137926654
68	62	3	0	3	35.7441902177
68	63	3	0	3	22.4488582014
68	64	1	0	1	28.7843647388
68	65	205	30	175	25.074716108
68	66	21	10	11	14.5236336731
68	67	6	4	2	22.115000835
68	69	79	42	37	9.11284040243
68	70	3	0	3	51.5234156433
68	71	3	0	3	45.3095568882
68	73	53	2	51	43.9545647753
68	74	8	0	8	45.726806696
68	75	12	0	12	42.34484851
68	76	1	0	1	50.8341792947
68	77	1	0	1	47.6738449127
68	78	1	0	1	47.4332210121
68	79	1	0	1	46.527414198
68	81	5	0	5	48.3594391005
68	82	3	0	3	48.6366776975
68	83	1	0	1	45.5836077512
68	84	5	0	5	44.1109358317
68	85	0	0	0	50.7063153019
68	87	3	0	3	42.6829238203
68	88	4	0	4	43.3977965479
68	92	3	0	3	53.4144482746
68	95	4	1	3	39.677028267
68	96	3	0	3	61.9084697902
68	98	2	0	2	48.8867555783
68	99	3	0	3	29.0345878603
68	102	3	0	3	43.655582221
68	103	8	1	7	38.119901508
68	104	2	1	1	42.7852804427
68	107	1	0	1	44.5927964762
68	110	2	0	2	33.8031792975
68	112	8	4	4	36.9772458931
68	113	17	5	12	38.0854387115
68	117	1	0	1	40.859441794
68	122	1	0	1	59.9640215652
68	124	86	15	71	13.1229479372
68	125	7	1	6	12.9853435656
68	126	1	0	1	20.2827809477
68	127	1	0	1	33.9587189669
68	128	7	0	7	31.7683206077
68	129	2	1	1	26.4934410827
68	131	27	12	15	17.5366291166
68	133	2	0	2	23.1226666991
68	134	1	0	1	27.3070353196
68	135	1	0	1	36.4089502608
68	136	5	1	4	20.4445389496
68	137	1	0	1	39.9849751402
68	138	2	1	1	19.4984242738
68	139	1	0	1	25.6974234619
68	140	2	0	2	32.5710942013
68	142	128	5	123	27.8255169081
68	143	1	0	1	25.2349414405
68	144	4	1	3	34.669262029
68	145	10	3	7	19.4093354437
68	146	4	1	3	40.3884041996
68	147	3	1	2	33.0302153023
68	148	8	2	6	16.1311088183
68	149	1	0	1	33.8591628421
68	151	22	9	13	13.4885685563
68	152	12	1	11	20.3865035635
68	163	1	0	1	42.0819765636
68	169	1	0	1	67.0599266059
68	172	2	0	2	47.935845908
68	208	1	0	1	118.343140811
68	216	0	0	0	133.59098838
68	220	1	0	1	136.903024451
68	242	0	0	0	153.61192045
68	245	0	0	0	59.6688262403
68	246	1	0	1	62.6502858302
68	257	2	1	1	56.0131510298
68	262	3	0	3	71.8306763037
68	271	4	0	4	100.414933095
68	277	7	0	7	80.8696705798
68	281	0	0	0	76.8745972208
68	282	0	0	0	81.1531355171
68	283	1	0	1	65.9171984957
68	304	4	0	4	41.5892872871
68	305	4	0	4	64.2908895
68	307	4	2	2	54.3701991752
68	309	2	0	2	47.303090567
68	319	1	0	1	82.4776699354
68	338	1	0	1	96.8894268181
68	408	1	0	1	72.5243036552
68	415	1	0	1	65.1736483538
68	442	1	0	1	90.2653429299
68	460	0	0	0	53.2445503231
68	464	28	2	26	25.1550373308
68	465	5	0	5	43.293491055
68	466	10	0	10	45.581897861
68	468	3	1	2	22.8716829579
68	469	30	3	27	35.3723269889
68	470	1	0	1	27.9637300911
68	471	6	0	6	25.7641134522
68	472	14	1	13	24.4237015588
68	474	4	1	3	48.7307756011
68	475	6	0	6	39.8738130381
68	476	31	0	31	14.3098529041
68	477	1	0	1	36.8586478557
68	478	1	0	1	52.2160842237
68	479	4	0	4	19.4951156409
68	480	2	0	2	30.0734278816
68	482	1	0	1	52.5396497425
68	484	6	2	4	32.15823111
68	487	3	0	3	37.1752012998
68	488	1	0	1	40.5407311585
68	489	1	0	1	46.827588168
68	491	4	0	4	37.4167929576
68	499	2	0	2	50.5471522119
68	501	1	0	1	58.1178486706
68	503	1	0	1	55.2420662579
68	573	2	0	2	71.8583863607
68	577	1	0	1	75.6769035874
69	1	227	0	227	47.9438147728
69	2	3	1	2	35.4219936626
69	3	1	0	1	44.2540861237
69	5	8	0	8	43.4466827778
69	6	3	0	3	38.6892602803
69	9	1	0	1	47.0132940765
69	11	0	0	0	51.4736105181
69	12	1	0	1	48.2288789632
69	13	1	0	1	39.4902299692
69	15	23	5	18	39.440172725
69	16	1	0	1	46.9158578065
69	17	4	1	3	31.5361234264
69	18	2	1	1	40.889520309
69	20	1	1	0	35.4354455801
69	21	1	0	1	40.2496365594
69	22	3	1	2	51.7609483788
69	23	5	0	5	37.9092734361
69	24	4	0	4	36.7487268829
69	25	1	0	1	44.8296510495
69	26	5	1	4	27.0117984189
69	27	6	0	6	30.5749476018
69	28	3	1	2	50.2268932128
69	29	3	0	3	31.1940707309
69	30	5	0	5	24.608155182
69	31	1	0	1	31.1596402753
69	32	1	0	1	53.3359464417
69	33	15	0	15	34.3964142726
69	34	34	0	34	18.8922039868
69	35	37	0	37	30.4624952634
69	36	19	1	18	39.2863074543
69	37	2	0	2	25.1349332368
69	38	1	0	1	26.0541023549
69	39	1	0	1	48.976026654
69	43	3	2	1	28.7543895168
69	45	35	0	35	15.0759176243
69	46	20	3	17	28.9093711257
69	47	22	0	22	19.6010433592
69	48	773	523	250	9.62535743201
69	49	29	0	29	21.6241536728
69	50	175	23	152	15.4872267747
69	51	5	2	3	18.3552950419
69	52	31	12	19	9.37639096093
69	53	2	0	2	43.3911400516
69	54	37	2	35	13.6757405385
69	55	24	16	8	18.5903202638
69	56	4	1	3	22.8290538502
69	57	78	3	75	6.75844814768
69	58	4	0	4	33.5517309478
69	59	125	47	78	19.8279947465
69	60	128	0	128	12.4362821689
69	61	2	0	2	26.66516038
69	62	1	0	1	37.1656956162
69	63	3	0	3	21.2811451592
69	64	2	0	2	34.7216856528
69	65	121	14	107	27.9531923539
69	66	5	0	5	22.2602918878
69	67	3	0	3	26.3282009639
69	68	557	422	135	9.11284040243
69	70	2	0	2	57.2846604725
69	71	1	0	1	49.9094729766
69	72	3	0	3	55.3747453463
69	73	38	0	38	49.8530584508
69	74	3	0	3	50.953735229
69	75	9	0	9	47.988796478
69	76	2	0	2	56.2469025961
69	77	1	0	1	53.9200412688
69	78	6	2	4	52.6305008639
69	79	2	1	1	52.8136848701
69	81	2	0	2	54.319025893
69	82	1	0	1	54.1253757656
69	83	1	0	1	51.2510687146
69	84	8	1	7	49.7916905004
69	85	1	0	1	55.591960095
69	86	1	0	1	51.9032961696
69	87	4	0	4	47.8660423919
69	88	2	0	2	48.2534240316
69	89	1	1	0	58.6232252393
69	92	1	0	1	59.7246216331
69	96	2	0	2	66.8213404725
69	99	3	1	2	34.8263837888
69	103	8	1	7	44.0574779949
69	110	1	0	1	39.6856426684
69	112	6	2	4	43.4128657575
69	113	18	3	15	43.2134115582
69	114	3	0	3	39.9779148825
69	116	1	0	1	58.3797961469
69	119	1	0	1	58.0150986034
69	122	1	0	1	66.1122663456
69	124	78	0	78	14.2355278075
69	125	1	0	1	17.5318641467
69	126	4	0	4	16.4279005564
69	127	2	0	2	37.5371948047
69	128	0	0	0	32.5332477676
69	131	106	15	91	9.88769220446
69	132	1	0	1	22.8291050371
69	133	3	1	2	28.6497970441
69	134	3	1	2	31.4971898186
69	135	1	0	1	34.7871154572
69	136	1	0	1	22.0778241339
69	141	1	0	1	36.4993926353
69	142	84	18	66	30.50858981
69	143	2	0	2	25.3749148141
69	144	3	0	3	36.6449880174
69	145	5	0	5	23.439864186
69	146	0	0	0	44.398401683
69	147	11	5	6	30.269444198
69	148	1	0	1	21.5473688254
69	149	0	0	0	28.1506781084
69	151	38	11	27	9.58760122312
69	152	2	1	1	19.1307076565
69	153	1	0	1	24.1277304846
69	177	0	0	0	55.2094696009
69	183	3	0	3	126.075726432
69	188	1	0	1	130.812725423
69	208	0	0	0	125.988774836
69	220	1	0	1	145.8136776
69	230	1	0	1	139.752245238
69	242	0	0	0	162.346090455
69	243	1	0	1	156.419986826
69	245	1	1	0	67.3148300603
69	248	1	0	1	74.1992872277
69	253	1	0	1	87.3576463572
69	257	1	0	1	64.281874701
69	258	1	0	1	60.5162500269
69	276	1	0	1	93.9503325852
69	277	2	0	2	89.4814367857
69	281	0	0	0	85.1119677705
69	282	0	0	0	89.2999221045
69	303	1	0	1	57.0358442814
69	304	2	0	2	50.5905190382
69	305	2	0	2	73.0539687218
69	307	1	0	1	63.3422393387
69	464	53	0	53	16.171707782
69	465	3	1	2	34.424281468
69	466	26	8	18	36.473403225
69	468	4	0	4	15.8204704331
69	469	52	2	50	26.6385957072
69	470	5	0	5	19.9955456881
69	471	15	0	15	17.5519085532
69	472	29	3	26	15.6379692094
69	474	2	0	2	39.7754677979
69	475	6	1	5	33.1127157891
69	476	305	185	120	5.3128692501
69	477	1	0	1	27.7531110485
69	479	72	7	65	11.0356269323
69	480	8	1	7	20.9610586046
69	482	1	0	1	44.2677044353
69	484	14	0	14	26.1796718039
69	486	1	0	1	35.6519092221
69	487	3	0	3	30.1155781327
69	488	8	2	6	32.2520097023
69	489	3	0	3	40.2387895929
69	491	6	0	6	28.4152948414
69	492	1	0	1	38.1668864626
69	495	1	0	1	43.6480051635
69	499	1	0	1	41.9081552919
69	500	1	0	1	37.7847865659
69	503	2	0	2	47.0709291672
69	505	3	2	1	48.6261118149
69	506	1	0	1	68.3712095556
69	555	1	0	1	92.6046969856
70	0	2	0	2	34.2719400413
70	1	64	3	61	47.7634039198
70	3	3	0	3	29.9585824585
70	5	1	0	1	55.3920544955
70	7	2	1	1	37.696620965
70	9	1	0	1	35.1569056614
70	12	1	0	1	57.1401351313
70	13	9	1	8	34.4618307137
70	17	2	0	2	45.5135571198
70	18	1	0	1	30.794484051
70	19	2	0	2	32.8461942634
70	21	2	0	2	50.7014196713
70	23	1	0	1	47.2316953073
70	31	1	0	1	28.8866816839
70	32	6	0	6	29.8424370106
70	34	2	0	2	41.1375323468
70	35	4	0	4	37.7256138938
70	36	25	4	21	24.7953677274
70	39	1	0	1	26.3624968352
70	40	1	1	0	25.0921862376
70	41	5	0	5	31.0587335001
70	42	17	1	16	25.5788089335
70	48	2	0	2	61.2735313918
70	50	1	0	1	52.8059686015
70	56	0	0	0	60.7100849434
70	59	2	1	1	75.1204461592
70	62	0	0	0	82.8621695664
70	68	1	0	1	51.5234156433
70	71	217	56	161	10.4203505713
70	72	162	43	119	3.97087000232
70	73	4231	2266	1965	7.58304460069
70	74	369	316	53	7.15046040762
70	75	360	185	175	9.29706493328
70	76	582	134	448	2.7494328292
70	77	102	1	101	5.18295285759
70	78	947	206	741	5.95866913789
70	79	238	0	238	6.19662813109
70	80	104	6	98	4.37168065322
70	81	805	258	547	3.41816348935
70	82	597	415	182	3.63451739192
70	83	233	6	227	6.03917921682
70	84	525	299	226	7.49311129927
70	85	548	368	180	6.48688238004
70	86	137	43	94	10.011817452
70	87	426	264	162	9.96346054639
70	88	190	163	27	10.5464800318
70	89	106	4	102	10.2707121938
70	90	85	34	51	8.76052447019
70	92	144	63	81	4.95652629253
70	94	4	2	2	14.8553696259
70	95	27	0	27	14.1408155308
70	96	86	2	84	12.0740700266
70	97	1	0	1	21.5460297216
70	98	4	1	3	13.4350246027
70	99	2	0	2	22.5555019585
70	100	0	0	0	19.9046349812
70	101	2	0	2	14.6411120016
70	102	13	0	13	20.2344733166
70	103	146	8	138	13.4049892202
70	104	4	1	3	14.7860522299
70	105	7	0	7	13.9788391906
70	107	15	0	15	18.0395462005
70	108	1	0	1	13.9017936439
70	109	204	0	204	5.7239752718
70	110	10	3	7	17.7311893445
70	111	44	1	43	10.2776820836
70	112	136	0	136	14.9865549727
70	113	311	24	287	14.3842786358
70	114	8	0	8	20.299953323
70	115	1	0	1	13.7738611671
70	116	143	15	128	4.08772449963
70	117	13	3	10	12.6637136686
70	118	10	1	9	7.73086843663
70	119	32	0	32	10.9793560745
70	120	23	8	15	9.04361662155
70	121	6	1	5	14.1036048187
70	122	6	1	5	9.25092859214
70	123	1	0	1	14.99058496
70	126	1	0	1	49.4755303955
70	127	1	0	1	22.4207635426
70	129	4	0	4	25.2090871518
70	130	1	0	1	38.6298587912
70	131	4	0	4	57.7093336421
70	134	2	0	2	26.4299637858
70	137	1	0	1	22.8369794444
70	140	10	0	10	20.5183904106
70	142	24	0	24	29.5880130765
70	144	5	0	5	27.6934313878
70	145	2	0	2	34.0662847354
70	146	5	1	4	16.2795298624
70	147	2	1	1	45.6319560577
70	154	3	1	2	33.6729655468
70	155	89	35	54	17.8545095732
70	156	16	0	16	16.6202793771
70	157	4	0	4	32.1168640161
70	158	4	1	3	29.452592934
70	159	4	0	4	26.9159348199
70	160	1	0	1	29.1887356533
70	161	2	1	1	37.2834172438
70	162	3	0	3	20.8923488026
70	163	2	0	2	41.4396745944
70	164	18	0	18	15.8884631431
70	165	1	0	1	31.5477698661
70	166	43	12	31	25.9530868549
70	167	1	0	1	41.140860837
70	168	24	7	17	20.3094724939
70	169	43	0	43	17.0429460953
70	171	49	0	49	15.3732595086
70	172	38	12	26	24.583007544
70	173	2	0	2	35.3784068789
70	175	4	0	4	20.1715156122
70	177	42	0	42	25.992605605
70	179	1	0	1	20.9252718888
70	181	1	0	1	75.9171140275
70	183	3	0	3	88.0846035144
70	190	1	0	1	88.4664871606
70	194	1	0	1	93.1012607334
70	208	1	1	0	72.3492009774
70	209	2	0	2	71.8198622429
70	211	1	0	1	80.1221183648
70	220	1	0	1	104.56498693
70	222	0	0	0	99.3578905953
70	236	1	0	1	68.0840369921
70	242	0	0	0	117.058335887
70	243	1	0	1	111.745217359
70	245	11	0	11	20.3301960426
70	247	0	0	0	27.8838519947
70	248	1	0	1	21.9381234213
70	250	1	0	1	28.7496529612
70	251	16	1	15	20.2481904208
70	254	2	1	1	26.0525114793
70	255	2	0	2	31.8632219828
70	257	2	0	2	26.2550140331
70	262	1	0	1	34.897510615
70	264	1	0	1	32.0562279941
70	272	2	0	2	57.3416272336
70	277	27	0	27	48.2310695768
70	280	1	0	1	55.6864095938
70	282	1	0	1	41.9751735384
70	284	1	0	1	49.994423525
70	287	2	0	2	51.1443489158
70	291	1	0	1	58.8130838044
70	294	2	0	2	48.9945352579
70	297	1	0	1	53.9147247174
70	303	3	0	3	47.1818340797
70	305	5	1	4	39.2367744173
70	307	1	0	1	39.5141483769
70	309	4	1	3	34.3735247682
70	310	8	0	8	42.2523589005
70	312	1	0	1	57.7922386292
70	318	1	0	1	40.7653222281
70	319	51	4	47	46.4602316241
70	320	2	0	2	50.6881284232
70	323	6	0	6	41.8791575186
70	324	2	0	2	46.9426374314
70	326	4	1	3	37.517724483
70	329	23	1	22	31.3326857036
70	331	1	0	1	35.2318059193
70	332	1	0	1	56.657537984
70	334	4	0	4	56.6422293167
70	338	28	2	26	47.6093634797
70	341	1	0	1	51.4628847104
70	342	1	0	1	56.718423035
70	345	1	0	1	73.992819513
70	347	4	0	4	25.932768843
70	348	7	3	4	25.0125054018
70	349	16	5	11	40.6935895416
70	350	1	0	1	34.84745682
70	351	4	0	4	38.1231931798
70	353	3	0	3	34.2995357303
70	357	5	0	5	47.4565985843
70	361	0	0	0	52.7546079432
70	367	2	0	2	42.5802972572
70	373	0	0	0	61.2388795647
70	375	9	0	9	66.6604313585
70	382	0	0	0	104.788043222
70	385	1	0	1	74.6372724049
70	396	1	0	1	86.8917424357
70	406	2	0	2	93.8750404674
70	408	12	4	8	93.9406286865
70	411	2	0	2	90.1639196153
70	414	1	0	1	98.5736325963
70	419	1	0	1	103.786138707
70	421	1	0	1	110.550441248
70	436	1	0	1	130.169323278
70	438	0	0	0	117.889116279
70	441	0	0	0	113.178938437
70	442	0	0	0	114.130783772
70	450	1	0	1	64.8169049994
70	455	1	0	1	57.8202766833
70	465	1	1	0	79.455842928
70	466	2	0	2	85.7071934085
70	467	1	0	1	62.4721242945
70	469	3	0	3	72.2197528296
70	475	3	0	3	63.9752820918
70	480	6	0	6	73.0221985561
70	487	0	0	0	87.3777243286
70	488	1	0	1	88.3534563658
70	495	0	0	0	87.2519599012
70	496	2	0	2	73.6854179197
70	499	0	0	0	82.8665979841
70	503	8	0	8	82.5866548404
70	504	1	0	1	72.3945915521
70	507	1	0	1	166.916716557
70	520	0	0	0	99.1724087909
70	524	1	0	1	101.347838931
70	528	1	0	1	113.900905404
70	530	0	0	0	126.871753526
70	535	1	0	1	135.587481806
70	537	1	0	1	115.336058589
70	548	0	0	0	166.927532325
70	551	0	0	0	67.4856843616
70	554	2	0	2	85.4941201508
70	555	0	0	0	79.1680674061
70	556	2	0	2	103.407794604
70	557	0	0	0	81.0510571315
70	560	1	0	1	73.1269735142
70	561	0	0	0	97.1165091346
70	571	0	0	0	70.1653932191
70	573	18	0	18	57.8919877553
70	576	1	0	1	40.0876617855
70	577	1	0	1	48.4228646564
70	579	1	0	1	48.0513246476
70	581	5	0	5	42.3437300283
70	583	0	0	0	88.9924951709
70	585	2	0	2	68.3009246446
71	0	3	1	2	36.0039692854
71	1	27	0	27	49.6818467917
71	7	1	0	1	38.5018128934
71	13	2	1	1	34.8845761774
71	15	2	0	2	40.5730057433
71	18	1	0	1	31.5789461057
71	24	1	0	1	44.4775143707
71	28	2	0	2	46.7951468476
71	32	2	0	2	34.5593105952
71	34	1	0	1	35.8009774527
71	36	15	1	14	24.3211340715
71	38	1	0	1	30.1522289583
71	42	5	0	5	27.5603149785
71	50	1	0	1	47.8714453566
71	59	2	0	2	68.6915359273
71	60	1	0	1	50.2637054101
71	68	2	0	2	45.3095568882
71	70	204	4	200	10.4203505713
71	72	18	4	14	11.8159562685
71	73	2168	0	2168	8.27102509311
71	74	416	382	34	3.98352562343
71	75	232	116	116	6.87240527086
71	76	64	0	64	8.02409958703
71	77	12	0	12	11.5286735367
71	78	706	189	517	4.50241476196
71	79	43	12	31	11.4332551942
71	80	13	7	6	9.94451416081
71	81	112	3	109	9.79849342385
71	82	153	63	90	6.91516675327
71	83	108	6	102	6.8536729535
71	84	314	136	178	6.82126849575
71	85	226	128	98	5.85465590703
71	86	355	52	303	2.17762592146
71	87	457	5	452	4.22658969175
71	88	212	36	176	2.3557110443
71	89	9	0	9	19.0147286979
71	90	6	0	6	11.6624817516
71	92	15	0	15	15.1411343189
71	95	13	0	13	15.5814391698
71	96	4	0	4	16.9438609399
71	98	6	0	6	5.53971509101
71	99	2	1	1	16.9286410393
71	100	0	0	0	22.3112132607
71	102	4	0	4	25.0206865848
71	103	83	23	60	10.3037874023
71	104	2	1	1	18.8739444452
71	105	1	0	1	20.6513745334
71	107	27	1	26	7.92868847993
71	109	11	3	8	13.8274937085
71	110	8	0	8	13.0671870017
71	111	6	1	5	20.5574040279
71	112	33	2	31	13.3649253245
71	113	217	15	202	7.60796670794
71	114	1	0	1	18.8245244582
71	116	15	7	8	9.26727897512
71	117	19	13	6	4.57175250169
71	118	3	0	3	8.0330157056
71	119	9	5	4	8.58434346418
71	120	9	1	8	14.2952564516
71	121	6	1	5	5.28727021165
71	122	0	0	0	19.2979369502
71	124	2	0	2	35.9187628773
71	127	2	1	1	12.9927073069
71	129	2	1	1	20.7704952895
71	134	1	1	0	18.4123572186
71	137	1	0	1	12.4179653802
71	140	8	0	8	12.7590794595
71	142	20	2	18	20.4330755325
71	146	11	0	11	6.18820431183
71	155	51	32	19	16.3136694109
71	156	5	1	4	18.1162623971
71	157	1	0	1	22.4152506227
71	158	4	1	3	22.2210191078
71	159	1	0	1	22.2801083915
71	160	2	1	1	18.8618835817
71	163	3	0	3	31.0513557973
71	164	26	5	21	8.4255982601
71	165	1	0	1	23.2198560952
71	166	26	0	26	24.8575020075
71	168	35	1	34	11.6805339009
71	169	8	0	8	21.953722815
71	171	49	10	39	11.4271073596
71	172	50	2	48	15.1271532762
71	173	3	0	3	27.7992336173
71	175	7	2	5	14.3067098718
71	177	90	5	85	17.8972478173
71	179	2	1	1	26.5984234122
71	180	2	0	2	26.9969700208
71	183	2	0	2	97.9352437686
71	192	0	0	0	109.630366415
71	208	0	0	0	82.5097066555
71	225	0	0	0	87.409681681
71	242	0	0	0	127.448775659
71	243	1	0	1	122.112239643
71	245	6	1	5	29.9437430059
71	257	1	0	1	34.3430432363
71	258	1	0	1	36.3970457577
71	260	1	0	1	30.2202118652
71	277	8	6	2	57.9584336764
71	282	1	0	1	52.2330916066
71	293	1	0	1	57.6140419809
71	303	2	0	2	51.1247616838
71	309	2	0	2	39.4421158094
71	310	1	0	1	50.5508598381
71	311	1	0	1	61.1955329532
71	319	45	1	44	43.2756114224
71	320	1	0	1	46.3180850692
71	323	4	1	3	36.7090959039
71	329	12	4	8	31.6711078763
71	332	1	0	1	62.0197033008
71	338	8	0	8	51.6218641641
71	341	1	0	1	57.5304998628
71	347	1	0	1	29.9874419561
71	348	2	0	2	32.2866573355
71	349	7	0	7	42.387255157
71	352	1	0	1	38.2193638992
71	353	3	1	2	39.1202292945
71	357	1	0	1	48.3025375615
71	361	1	0	1	52.4005465627
71	364	1	0	1	54.7890476631
71	367	1	0	1	42.6136811934
71	373	1	0	1	69.0885838765
71	375	1	0	1	75.6983276169
71	379	1	0	1	67.8690546073
71	385	0	0	0	64.7189305996
71	394	1	0	1	72.6335802704
71	402	1	0	1	88.4191813137
71	406	2	0	2	83.4618266241
71	408	9	0	9	83.52394988
71	411	2	0	2	79.7915668854
71	415	1	0	1	73.0442012698
71	416	1	0	1	90.6968497827
71	426	0	0	0	120.90080813
71	445	0	0	0	113.899035209
71	455	0	0	0	47.479244582
71	460	1	0	1	59.7250469063
71	466	2	1	1	76.1735753358
71	469	1	0	1	62.6324376645
71	471	1	0	1	66.373177917
71	475	1	0	1	53.7460626562
71	477	0	0	0	68.8590775542
71	482	1	0	1	91.4140359414
71	495	0	0	0	77.2442010396
71	496	2	0	2	63.4444706443
71	503	2	0	2	72.2708136479
71	507	1	0	1	158.847706976
71	510	1	0	1	143.866417527
71	516	0	0	0	118.647526558
71	524	2	0	2	92.5593562486
71	535	1	0	1	127.948956561
71	538	0	0	0	98.9383276896
71	548	1	0	1	159.713049423
71	554	1	1	0	77.1701227905
71	555	1	0	1	71.8589024928
71	563	1	0	1	64.5641618138
71	567	1	0	1	62.2212920671
71	569	1	0	1	47.3662555112
71	571	0	0	0	61.1872128394
71	573	26	0	26	49.5135738962
71	576	1	0	1	33.5909073476
71	577	1	0	1	42.4493886327
71	579	1	0	1	41.2068413669
71	581	9	2	7	34.2625247488
71	585	2	0	2	63.36758532
72	0	1	0	1	30.3635858576
72	1	18	3	15	43.817167086
72	13	1	0	1	30.6856716875
72	14	1	0	1	32.561469813
72	32	1	0	1	25.9124212749
72	36	8	3	5	21.2771544245
72	39	5	0	5	22.3923224623
72	46	1	0	1	62.2079138367
72	59	1	0	1	72.7387235706
72	60	2	0	2	53.0997546425
72	70	352	65	287	3.97087000232
72	71	52	1	51	11.8159562685
72	73	1366	911	455	5.79707873149
72	74	104	49	55	7.90099405531
72	75	97	5	92	8.10326551253
72	76	105	49	56	6.01447555246
72	77	94	16	78	1.53783614979
72	78	242	126	116	7.51086016122
72	79	146	13	133	2.70678262747
72	80	77	50	27	2.12859855446
72	81	363	100	263	2.01763223013
72	82	133	42	91	5.29877096718
72	83	85	25	60	5.44005870185
72	84	182	35	147	6.480807499
72	85	122	7	115	9.58066897726
72	86	33	15	18	12.1088642839
72	87	134	1	133	9.84948307679
72	88	53	26	27	11.1221388871
72	89	52	21	31	7.26558896193
72	90	22	4	18	12.7208193531
72	92	80	63	17	4.403867223
72	94	2	0	2	16.7487599366
72	95	13	0	13	10.6189036829
72	96	14	4	10	15.8963380423
72	99	1	0	1	20.5588909059
72	102	2	0	2	16.2769398911
72	103	41	4	37	11.3541086332
72	104	3	1	2	10.8377334206
72	105	4	3	1	10.1767953623
72	106	0	0	0	13.4610344715
72	107	3	1	2	19.74178507
72	109	25	18	7	9.25296296761
72	110	3	1	2	15.7081510381
72	111	23	2	21	9.39176721971
72	112	42	2	40	12.2302561996
72	113	101	21	80	13.5411951866
72	114	3	0	3	17.1421132769
72	116	16	0	16	7.97086141049
72	117	2	0	2	12.6418331544
72	118	4	0	4	11.3567815728
72	119	6	2	4	14.4958695044
72	120	15	5	10	5.11633233282
72	121	3	1	2	14.153004934
72	122	3	0	3	10.7859023381
72	123	1	0	1	13.2531033701
72	124	1	0	1	42.3290350758
72	127	1	0	1	22.2104465779
72	142	13	0	13	28.9800758255
72	143	1	0	1	37.5805527811
72	145	2	0	2	32.5001512097
72	146	3	0	3	16.8817584954
72	154	2	1	1	34.5142382093
72	155	14	2	12	21.7137103604
72	156	4	0	4	20.5904202501
72	158	3	1	2	32.5474842896
72	159	2	0	2	30.5278539906
72	160	4	0	4	30.573375712
72	162	1	0	1	24.8453889776
72	163	0	0	0	42.6088869604
72	164	4	0	4	18.6663896561
72	165	3	0	3	34.3052536403
72	166	14	0	14	29.8979182793
72	168	10	1	9	22.8353182845
72	169	1	0	1	20.7304885993
72	171	11	5	6	18.877477747
72	172	13	0	13	26.7760302382
72	175	0	0	0	23.4633029535
72	176	1	0	1	50.9330313064
72	177	12	0	12	28.7881968146
72	179	1	0	1	24.3742691335
72	183	2	0	2	86.1226054316
72	208	1	0	1	72.6706659224
72	222	1	0	1	97.5363477276
72	229	1	0	1	81.7880145111
72	239	1	0	1	77.5802054346
72	242	0	0	0	116.083106251
72	245	7	0	7	18.1297559322
72	251	2	0	2	20.7503703376
72	256	1	0	1	17.6724558644
72	257	1	0	1	23.0516818233
72	262	0	0	0	33.0238678904
72	274	1	0	1	39.3878486127
72	277	4	1	3	46.1425726474
72	282	0	0	0	40.6585514032
72	284	0	0	0	49.0562546918
72	292	1	0	1	53.8552686167
72	293	2	0	2	47.2606796646
72	296	1	0	1	38.3733195546
72	305	0	0	0	36.1488920924
72	307	1	0	1	35.8067703302
72	309	1	0	1	30.4869634406
72	310	1	0	1	44.4093839999
72	314	1	0	1	48.534186869
72	319	10	2	8	50.3313456842
72	320	1	0	1	54.444327922
72	321	1	0	1	43.7473762354
72	328	0	0	0	39.5031883527
72	329	5	1	4	35.2988842876
72	331	0	0	0	39.0060884382
72	338	8	2	6	51.1614812941
72	339	1	0	1	56.5366891116
72	348	0	0	0	27.8779076934
72	349	3	0	3	44.5744501898
72	350	1	0	1	36.5559527367
72	353	3	0	3	37.7682266673
72	356	0	0	0	70.7192847616
72	357	1	0	1	51.3820133952
72	367	1	0	1	46.5432378333
72	375	2	0	2	68.20823502
72	377	1	0	1	55.4719235026
72	389	0	0	0	94.9246317716
72	406	1	0	1	94.5524321752
72	408	4	0	4	94.8500754229
72	431	1	0	1	119.04301779
72	433	1	0	1	132.334490349
72	438	1	0	1	119.185236747
72	466	0	0	0	84.9888443627
72	490	0	0	0	79.716974051
72	503	2	0	2	82.8918534461
72	507	0	0	0	169.921806108
72	554	1	0	1	88.3681798412
72	563	0	0	0	75.4012658468
72	573	4	0	4	60.7140175167
72	581	0	0	0	45.2427038631
73	0	7	1	6	28.7999930624
73	1	198	9	189	42.5017504359
73	2	2	0	2	34.0216648383
73	3	2	0	2	24.533723743
73	4	0	0	0	36.281755374
73	7	8	3	5	31.7595841005
73	9	1	0	1	30.2046058199
73	13	9	0	9	28.3038433147
73	14	1	0	1	29.6019593785
73	15	3	1	2	34.0758563364
73	18	3	0	3	24.7672154618
73	19	2	0	2	27.8545041689
73	21	2	1	1	44.4964641364
73	23	1	0	1	40.8756976607
73	24	4	0	4	38.4548037082
73	25	1	0	1	60.0449018862
73	27	1	0	1	47.4666585053
73	28	9	1	8	39.2729436128
73	29	1	0	1	52.3703230325
73	32	9	0	9	26.4205726021
73	33	6	2	4	26.6126560415
73	34	2	0	2	33.5556490486
73	35	5	2	3	30.6242249599
73	36	70	0	70	18.0876947943
73	39	7	0	7	22.0000727894
73	41	15	5	10	23.8865596267
73	42	11	0	11	20.1331111112
73	45	0	0	0	64.8276099824
73	46	2	0	2	58.2139822132
73	47	1	0	1	66.3660436472
73	48	5	0	5	53.696924656
73	50	3	0	3	45.2539933774
73	53	1	0	1	68.682552636
73	56	1	0	1	53.2969953304
73	59	2	0	2	67.5498890362
73	60	3	0	3	48.1522055048
73	64	2	0	2	60.2046623738
73	65	2	0	2	64.244574043
73	68	3	0	3	43.9545647753
73	70	1191	414	777	7.58304460069
73	71	366	311	55	8.27102509311
73	72	190	114	76	5.79707873149
73	74	820	238	582	4.65404726288
73	75	806	6	800	2.40510366275
73	76	432	206	226	7.47319852772
73	77	127	42	85	4.6312145791
73	78	1864	0	1864	5.64573747915
73	79	532	17	515	3.91091027004
73	80	105	57	48	3.76980575802
73	81	816	0	816	4.46750552086
73	82	610	256	354	5.30307816841
73	83	489	346	143	2.17682665049
73	84	1292	845	447	1.45008519904
73	85	584	0	584	9.30498673741
73	86	257	86	171	9.52939070541
73	87	820	567	253	4.83604381991
73	88	333	75	258	6.65764227289
73	89	102	11	91	11.8567665741
73	90	57	5	52	14.581920608
73	92	116	2	114	10.1797176503
73	93	1	0	1	30.3296619628
73	94	3	0	3	22.1556438114
73	95	250	0	250	7.97142742729
73	96	46	0	46	18.9930490826
73	98	15	8	7	13.5453036652
73	99	7	0	7	15.0466962988
73	100	7	2	5	14.6039440333
73	101	2	0	2	19.8329386213
73	102	22	0	22	16.8024768452
73	103	472	8	464	5.83863131694
73	104	29	0	29	10.6619322932
73	105	15	8	7	12.521441078
73	106	2	0	2	16.8896259082
73	107	30	1	29	15.8207793016
73	108	2	1	1	21.4806631277
73	109	60	18	42	13.2169513549
73	110	25	6	19	10.1958490387
73	111	60	1	59	15.1174274827
73	112	359	84	275	7.57080211905
73	113	708	610	98	7.79987300618
73	114	16	8	8	13.1243265246
73	115	2	0	2	19.9174073759
73	116	55	3	52	9.98465207836
73	117	31	2	29	7.39871612006
73	118	8	2	6	11.8767254034
73	119	19	6	13	14.2897788026
73	120	84	7	77	6.16878449596
73	121	14	6	8	8.87230131466
73	122	6	0	6	16.2875797144
73	124	4	2	2	36.6348280098
73	128	3	0	3	27.9301104386
73	129	4	0	4	17.6305541615
73	130	1	0	1	33.0836395427
73	131	1	0	1	50.6785710519
73	133	2	0	2	21.2062358546
73	134	3	0	3	19.4789099949
73	135	1	0	1	36.7045101905
73	137	1	0	1	19.0201033784
73	138	5	0	5	24.4597317721
73	140	22	1	21	13.7033077154
73	142	139	0	139	23.2130859086
73	143	2	0	2	31.821990892
73	144	3	1	2	22.6535622165
73	145	5	0	5	26.8074917185
73	146	25	12	13	11.9217380784
73	147	4	0	4	40.357475765
73	148	0	0	0	28.3424439563
73	152	1	1	0	36.9871478601
73	153	1	0	1	40.2977420629
73	154	4	0	4	29.3954072315
73	155	75	22	53	22.2624648061
73	156	9	1	8	22.4446119532
73	157	3	1	2	30.3093513132
73	158	3	1	2	30.4183381165
73	159	4	0	4	29.7866402591
73	160	4	0	4	25.9776350571
73	162	4	1	3	26.9476924759
73	163	6	0	6	37.6922920753
73	164	39	0	39	16.4587643103
73	165	2	0	2	31.4871068167
73	166	51	6	45	30.854536515
73	167	3	1	2	39.4430254332
73	168	47	7	40	19.9514286714
73	169	33	1	32	24.1420688882
73	170	1	0	1	36.150009216
73	171	90	44	46	18.2664708944
73	172	89	40	49	23.2396439648
73	173	1	0	1	36.0534460896
73	175	13	1	12	22.0578902435
73	177	96	8	88	26.1630044701
73	179	1	0	1	28.27801118
73	180	1	0	1	35.1639154171
73	183	14	0	14	90.7229853749
73	186	4	0	4	84.7128426845
73	194	0	0	0	97.7207676636
73	208	4	0	4	78.454900551
73	211	1	0	1	86.23870889
73	212	2	0	2	68.314505122
73	213	1	0	1	84.5011836489
73	219	1	0	1	111.812951542
73	220	2	0	2	108.027897172
73	222	0	0	0	102.257798146
73	223	1	0	1	91.5696497557
73	224	1	0	1	78.3877591993
73	225	1	0	1	82.2418618688
73	229	2	0	2	87.3924222264
73	236	1	0	1	72.4424751976
73	237	1	0	1	70.8932217935
73	241	1	0	1	127.120980506
73	242	0	0	0	121.42374313
73	244	0	0	0	121.388513101
73	245	33	9	24	22.9400293361
73	246	1	0	1	22.3181465682
73	247	1	0	1	34.7077895582
73	248	3	0	3	26.8514783302
73	250	2	0	2	31.867988209
73	251	10	2	8	26.542870466
73	253	2	0	2	40.0058857003
73	254	1	0	1	30.1901167
73	256	2	0	2	19.7836068572
73	257	6	0	6	26.3449919492
73	260	1	0	1	22.3590475888
73	262	1	0	1	37.9020158412
73	264	4	0	4	32.1384823242
73	266	2	0	2	67.1663760021
73	271	1	0	1	69.0278487788
73	272	2	0	2	61.610750881
73	274	0	0	0	43.9930961784
73	275	1	0	1	55.5437420225
73	276	1	0	1	48.788502297
73	277	51	2	49	50.7306136936
73	280	1	0	1	58.301620113
73	281	4	0	4	42.8641227836
73	282	1	0	1	45.9027881758
73	284	1	0	1	54.4883016845
73	287	2	0	2	54.9314594022
73	291	1	0	1	63.7227426788
73	293	1	0	1	53.0075713294
73	294	0	0	0	55.6811581281
73	303	5	0	5	43.240369925
73	304	1	0	1	32.2198288214
73	305	3	0	3	39.4268751494
73	307	10	0	10	37.4373057551
73	309	6	0	6	31.2708124891
73	310	6	0	6	49.7271047261
73	313	0	0	0	46.7766685146
73	317	2	0	2	58.4677486527
73	319	80	12	68	50.4438383076
73	320	2	1	1	53.9371109357
73	321	1	0	1	44.6146616506
73	322	1	0	1	50.2622139619
73	323	6	0	6	44.5302724474
73	325	3	0	3	59.4364735517
73	326	7	1	6	43.3094708468
73	327	5	0	5	55.2485058511
73	328	1	0	1	39.9500135318
73	329	31	1	30	37.0162751641
73	331	3	0	3	38.7288444805
73	332	1	0	1	64.1032517316
73	334	4	0	4	63.8550355004
73	338	29	5	24	54.7476933612
73	339	1	0	1	60.5895680517
73	341	1	0	1	58.9944743504
73	342	1	0	1	64.0541679949
73	345	1	0	1	80.4802409882
73	346	1	0	1	102.451506496
73	347	2	1	1	32.9371815558
73	348	4	0	4	32.5922581769
73	349	12	4	8	47.0397870323
73	350	7	1	6	42.103110111
73	351	2	0	2	44.8809924045
73	352	1	0	1	38.4814036241
73	353	10	1	9	41.5741080349
73	356	0	0	0	72.0737220891
73	357	6	2	4	53.5052206367
73	361	1	0	1	58.2956044919
73	367	2	0	2	48.2397309535
73	371	1	0	1	79.1732474331
73	375	9	0	9	73.839192451
73	377	0	0	0	60.853076671
73	379	1	0	1	74.9269538676
73	385	1	0	1	72.1923967959
73	386	1	0	1	75.8000338545
73	392	0	0	0	68.1434378148
73	396	1	0	1	82.2856145983
73	397	1	0	1	78.5318217634
73	398	1	0	1	104.284338553
73	406	5	0	5	89.1715151317
73	408	32	2	30	89.6107535773
73	411	4	0	4	86.2685483224
73	412	1	0	1	99.0812080913
73	414	0	0	0	93.4185854179
73	415	1	0	1	79.2977400309
73	419	3	0	3	99.7385670503
73	426	1	0	1	126.601330348
73	438	1	0	1	114.208211132
73	442	1	0	1	109.77969944
73	455	1	0	1	54.2126295651
73	460	1	0	1	65.7776482736
73	464	2	0	2	63.969407777
73	465	3	0	3	73.2283402248
73	466	3	1	2	79.192831666
73	469	9	1	8	65.7939721236
73	470	0	0	0	56.7290323472
73	471	1	0	1	67.0173942021
73	472	1	0	1	58.2380941985
73	474	1	0	1	85.8256409094
73	475	3	0	3	58.5373000594
73	476	4	0	4	52.6641414448
73	480	1	0	1	66.1071940003
73	481	1	0	1	90.171645258
73	484	2	0	2	75.7384760114
73	485	1	0	1	96.7974074016
73	486	1	0	1	85.5047842383
73	487	1	0	1	79.9650506835
73	488	3	0	3	81.1606092959
73	491	1	0	1	74.8774187656
73	492	1	0	1	85.6969773517
73	493	1	0	1	95.4016854034
73	495	1	0	1	81.2925409853
73	496	2	0	2	68.2346533512
73	499	1	1	0	77.0828221952
73	501	1	0	1	89.0885304315
73	503	12	6	6	77.3342747305
73	505	0	0	0	91.9366576304
73	507	2	0	2	167.080026721
73	515	0	0	0	127.717142256
73	520	2	1	1	97.0309676585
73	521	0	0	0	105.275898719
73	523	0	0	0	117.247190213
73	524	3	0	3	100.666467124
73	530	1	0	1	128.879096762
73	534	1	0	1	116.809743309
73	537	0	0	0	115.528420636
73	540	2	0	2	127.019191912
73	548	2	0	2	167.981719925
73	549	1	0	1	154.279529922
73	551	0	0	0	68.8612052563
73	552	0	0	0	95.887472751
73	554	0	0	0	85.3875697525
73	555	0	0	0	80.1242957859
73	563	3	0	3	72.8331988843
73	566	1	0	1	64.4912476162
73	567	1	0	1	70.4377009192
73	568	2	0	2	48.4501714619
73	569	1	0	1	55.6213160127
73	571	0	0	0	69.2648813055
73	573	59	1	58	57.7433067742
73	575	2	0	2	63.9416485384
73	577	1	0	1	50.4997981716
73	579	5	0	5	49.4093502529
73	581	10	3	7	42.5304366859
73	583	0	0	0	93.1886700362
74	0	2	0	2	33.2620191498
74	1	45	1	44	46.972996702
74	13	3	2	1	32.5309700466
74	23	2	1	1	44.9383522795
74	28	1	0	1	43.8432760843
74	32	5	2	3	31.0663305881
74	33	2	0	2	30.40814336
74	34	1	0	1	35.7382699366
74	36	17	6	11	22.1135645455
74	39	1	0	1	26.6448322935
74	41	1	0	1	27.3814499217
74	42	1	0	1	24.6506422594
74	46	1	0	1	61.3598612341
74	48	0	0	0	55.5261354758
74	59	1	0	1	69.2748566238
74	60	1	0	1	50.3342049146
74	68	1	0	1	45.726806696
74	69	1	0	1	50.953735229
74	70	284	176	108	7.15046040762
74	71	284	111	173	3.98352562343
74	72	30	17	13	7.90099405531
74	73	3109	1095	2014	4.65404726288
74	75	301	162	139	4.14839771717
74	76	120	17	103	5.36792205784
74	77	16	0	16	7.54662074789
74	78	1044	407	637	1.70765564696
74	79	51	4	47	7.46902531158
74	80	22	6	16	5.97212783107
74	81	187	107	80	5.89383265085
74	82	222	178	44	3.52430985909
74	83	168	26	142	2.91437241958
74	84	418	39	379	3.2690487066
74	85	302	196	106	5.33385015918
74	86	159	39	120	4.89714273784
74	87	579	0	579	3.08780588716
74	88	262	101	161	3.41327829076
74	89	18	1	17	15.0497867546
74	90	11	4	7	11.2572898019
74	92	16	3	13	11.5135156801
74	95	47	9	38	12.4910741917
74	96	9	1	8	16.2271698362
74	97	1	0	1	27.9907109307
74	98	12	6	6	8.93370020487
74	99	2	0	2	16.7604686729
74	102	4	2	2	21.424912728
74	103	164	27	137	8.49803276225
74	104	2	1	1	15.2961665734
74	106	1	0	1	20.7941934874
74	107	14	1	13	11.8941312887
74	109	10	0	10	11.6766252976
74	110	11	1	10	12.2490226876
74	111	6	0	6	16.90900685
74	112	37	1	36	11.1665316429
74	113	227	43	184	7.74066056438
74	114	1	0	1	16.8319969541
74	116	20	11	9	7.4347310414
74	117	22	0	22	5.57112286637
74	118	2	1	1	8.01357905709
74	119	6	3	3	9.94098468501
74	120	7	0	7	10.4153908852
74	121	7	0	7	6.97113833157
74	122	1	0	1	16.3690627715
74	128	2	0	2	26.1880792984
74	136	1	0	1	30.5391052501
74	140	13	6	7	13.7757571934
74	142	43	15	28	22.5317159959
74	144	2	0	2	20.587286069
74	145	1	0	1	27.5565322346
74	146	13	1	12	9.20767240552
74	147	2	0	2	38.5237048377
74	148	0	0	0	29.7381088569
74	151	2	0	2	44.2447661617
74	154	8	1	7	26.7708572827
74	155	38	0	38	17.9789674453
74	156	10	0	10	18.7383711582
74	157	3	1	2	26.3964268063
74	158	7	0	7	25.8307342625
74	160	3	0	3	22.6766071261
74	162	2	0	2	23.2758039323
74	163	1	0	1	34.7584917381
74	164	31	4	27	11.8366131052
74	165	3	0	3	27.0691833768
74	166	16	1	15	26.6137372326
74	167	1	0	1	35.5356277847
74	168	33	1	32	15.5086804004
74	169	7	3	4	21.4111052726
74	170	2	0	2	31.4961060746
74	171	52	14	38	13.7181384157
74	172	46	17	29	19.1022736001
74	173	2	0	2	31.5208970546
74	175	13	1	12	17.4044243371
74	177	85	33	52	21.6710387762
74	180	1	0	1	30.9487628711
74	183	2	0	2	94.0142226454
74	214	1	0	1	72.0131465045
74	219	1	0	1	114.449381996
74	236	1	0	1	74.8112096032
74	239	1	0	1	85.1890104081
74	243	1	0	1	118.439617735
74	245	6	1	5	26.0231040792
74	246	1	0	1	24.3594740376
74	249	3	0	3	35.505186668
74	251	1	0	1	27.3923505857
74	274	1	0	1	47.2714130846
74	277	12	2	10	54.0262403336
74	281	2	0	2	45.7414918148
74	282	1	0	1	48.4814880305
74	287	1	1	0	57.6082209754
74	295	1	0	1	54.8583213988
74	303	1	0	1	47.8855929345
74	305	1	0	1	43.506293752
74	307	2	0	2	41.9848018464
74	310	0	0	0	48.7726546916
74	311	1	0	1	59.9270703948
74	313	2	0	2	45.1530121897
74	319	29	0	29	45.9022816092
74	322	1	0	1	45.6143707064
74	326	4	0	4	39.3368036495
74	327	1	0	1	50.8187345603
74	329	3	0	3	33.0316612663
74	331	1	0	1	34.1422283837
74	338	11	0	11	51.7661658867
74	345	1	0	1	81.1273319105
74	347	0	0	0	29.9408115845
74	348	1	0	1	30.923773671
74	349	7	0	7	43.3626433411
74	353	1	0	1	38.8648013363
74	357	2	0	2	49.6209935099
74	364	1	0	1	56.8936666808
74	373	1	0	1	67.5769767415
74	375	5	0	5	73.5326950382
74	391	1	0	1	65.4135132896
74	406	1	0	1	86.9271845739
74	408	10	1	9	87.1113637622
74	411	0	0	0	83.4953774991
74	415	2	0	2	76.6781879584
74	417	1	0	1	78.2453356527
74	425	1	0	1	107.009567188
74	426	0	0	0	124.377055732
74	438	0	0	0	111.324563602
74	442	3	0	3	107.302788123
74	469	4	0	4	65.1163343688
74	471	2	0	2	67.778766591
74	472	1	0	1	58.1823392949
74	475	1	0	1	56.8564745686
74	476	1	0	1	53.3559173294
74	480	1	0	1	66.0968881399
74	495	0	0	0	80.10150236
74	501	1	0	1	88.0451752127
74	503	2	0	2	75.5040627505
74	521	1	0	1	101.55449928
74	524	1	0	1	96.520364348
74	536	0	0	0	115.602065163
74	540	1	0	1	122.637822205
74	548	0	0	0	163.47238476
74	552	0	0	0	91.2888521396
74	554	0	0	0	81.0804228581
74	555	2	0	2	75.605811824
74	559	1	0	1	83.8431778437
74	561	2	0	2	93.0483559934
74	563	1	0	1	68.3871255887
74	566	1	0	1	60.5806271337
74	567	1	0	1	66.1342983446
74	569	1	0	1	51.0813880388
74	573	33	5	28	53.4170079275
74	577	6	1	5	45.8543588307
74	579	1	0	1	44.8147185761
74	581	10	1	9	38.1006662866
74	585	0	0	0	66.5579982145
74	586	0	0	0	75.080547807
75	0	5	0	5	29.2899936173
75	1	33	4	29	42.994767623
75	2	1	0	1	33.8361323546
75	3	0	0	0	25.0966800272
75	13	1	0	1	28.4297450962
75	23	1	1	0	40.797632175
75	24	1	0	1	38.3339342604
75	28	1	0	1	39.9908477803
75	31	1	0	1	20.3214843396
75	32	2	0	2	27.7331374918
75	36	14	3	11	17.9782511393
75	38	1	0	1	25.7209523653
75	39	2	0	2	23.0545984847
75	41	0	0	0	23.2690754484
75	42	2	0	2	20.7582186994
75	43	1	0	1	70.0934067198
75	45	1	0	1	63.0058567457
75	49	1	0	1	41.5592664154
75	50	3	1	2	43.9620039969
75	59	0	0	0	65.9374923085
75	60	1	0	1	46.7355262478
75	70	192	16	176	9.29706493328
75	71	132	19	113	6.87240527086
75	72	25	1	24	8.10326551253
75	73	1864	0	1864	2.40510366275
75	74	253	50	203	4.14839771717
75	76	105	0	105	8.54159312897
75	77	19	9	10	7.01900759623
75	78	413	154	259	5.67352160827
75	79	49	17	32	6.31248679252
75	80	16	2	14	6.00619953503
75	81	134	85	49	6.55482385962
75	82	134	22	112	6.3170973252
75	83	138	6	132	3.26369557296
75	84	773	3	770	1.80551187202
75	85	140	50	90	9.43376041318
75	86	93	1	92	8.53597002325
75	87	480	11	469	2.84043971394
75	88	112	58	54	4.85534991919
75	89	24	2	22	14.240415076
75	90	18	2	16	15.2002164707
75	92	12	0	12	12.4318247469
75	95	20	1	19	8.71165131143
75	96	10	0	10	19.9610527877
75	98	2	1	1	12.3818534065
75	99	3	1	2	13.3182215199
75	100	2	0	2	15.4454760088
75	102	8	1	7	18.2806968582
75	103	150	115	35	4.46780441372
75	104	2	0	2	12.157361166
75	105	2	0	2	14.5838484437
75	106	0	0	0	19.0845615969
75	107	3	0	3	13.9240704097
75	109	12	0	12	14.6852124841
75	110	14	1	13	8.5651370866
75	111	2	0	2	17.4732552815
75	112	67	25	42	7.01813449276
75	113	296	1	295	5.43823251645
75	114	3	0	3	12.6845351391
75	115	1	0	1	22.1695988056
75	116	11	0	11	10.9499774761
75	117	23	9	14	5.0982791969
75	118	3	1	2	12.1093354312
75	119	7	0	7	14.0742687499
75	120	7	3	4	8.32420523597
75	121	8	7	1	6.53450385721
75	122	1	0	1	18.3223857184
75	124	0	0	0	34.6003046443
75	125	0	0	0	30.4638205239
75	128	1	0	1	25.5252163631
75	129	1	0	1	16.2957029163
75	131	1	0	1	48.5489258245
75	133	2	0	2	19.397112614
75	137	1	1	0	16.758622873
75	140	12	2	10	11.445356905
75	142	31	0	31	20.8772124047
75	144	1	0	1	20.2569692847
75	145	2	1	1	24.79076806
75	146	6	2	4	9.66600679075
75	147	1	0	1	37.9527084412
75	149	0	0	0	48.7415681755
75	154	2	0	2	27.0380135498
75	155	16	5	11	22.1130858304
75	156	2	0	2	22.8320640154
75	157	2	0	2	28.3098801733
75	159	1	0	1	28.9946909473
75	163	3	1	2	35.3708782307
75	164	10	0	10	15.2865640275
75	165	2	0	2	29.8616268659
75	166	7	2	5	30.7499418733
75	167	2	0	2	37.419766101
75	168	9	3	6	18.4147749363
75	169	5	1	4	25.1515285072
75	170	1	0	1	35.0994356755
75	171	18	3	15	17.7285951675
75	172	42	3	39	21.4040240582
75	173	1	0	1	34.5748056456
75	175	6	2	4	21.0986617884
75	177	33	1	32	24.6528197588
75	182	0	0	0	100.79688295
75	183	1	0	1	93.028403254
75	220	2	0	2	110.394224845
75	221	1	0	1	103.894917243
75	222	0	0	0	104.583536846
75	239	1	1	0	85.4770961032
75	241	1	0	1	129.525927772
75	245	2	0	2	25.3116442525
75	251	1	0	1	28.7927528227
75	257	1	0	1	28.4448726562
75	260	2	0	2	24.5405194458
75	262	1	0	1	40.2679918938
75	277	6	0	6	53.0461544398
75	284	1	0	1	56.8933861578
75	291	1	0	1	66.1232494406
75	294	0	0	0	57.8805381679
75	303	1	0	1	44.2541477818
75	310	0	0	0	51.5482467006
75	319	12	0	12	49.8682946159
75	320	0	0	0	53.1011954011
75	321	1	0	1	44.3741844313
75	324	1	0	1	51.7295634247
75	326	2	0	2	43.4827295353
75	328	0	0	0	39.5615245357
75	329	4	1	3	37.1775850565
75	332	1	0	1	65.3079324663
75	338	9	4	5	55.657136044
75	345	1	0	1	82.7322428336
75	347	1	0	1	33.8177526581
75	348	0	0	0	34.1228965082
75	351	1	0	1	45.5506951539
75	353	3	0	3	42.6291694201
75	356	1	0	1	71.9535410734
75	361	1	0	1	58.3009709597
75	364	1	0	1	61.0019556066
75	367	0	0	0	48.3313820949
75	375	0	0	0	75.872318585
75	377	0	0	0	62.7045645533
75	385	1	0	1	69.9917649318
75	406	1	0	1	86.7696701886
75	408	6	0	6	87.2217262206
75	415	1	0	1	76.9195433652
75	417	1	0	1	78.7111133199
75	424	2	0	2	134.644595156
75	441	0	0	0	106.981095706
75	442	0	0	0	107.387983025
75	444	0	0	0	110.031244674
75	447	0	0	0	109.431102614
75	449	0	0	0	58.7762826153
75	455	2	0	2	51.8871150071
75	456	0	0	0	46.4754255178
75	457	1	0	1	67.9198484025
75	466	0	0	0	76.9150366807
75	469	2	0	2	63.495633485
75	471	2	0	2	65.0536051661
75	475	1	0	1	56.1379928379
75	477	1	0	1	69.1846224384
75	480	1	0	1	63.9366650791
75	487	1	0	1	78.0806752468
75	492	1	0	1	83.5570296363
75	495	1	0	1	78.9312261965
75	496	1	0	1	65.8368747133
75	497	1	0	1	64.7250382546
75	500	1	0	1	70.0028552134
75	503	13	0	13	74.9314499331
75	505	0	0	0	89.6467115956
75	506	1	0	1	100.305115959
75	507	1	0	1	165.29841111
75	520	0	0	0	94.8589146667
75	524	1	0	1	98.7404808607
75	540	0	0	0	125.283767505
75	555	0	0	0	78.578210159
75	566	0	0	0	62.4441779167
75	568	1	0	1	46.3938505068
75	569	1	0	1	54.1272193633
75	573	17	1	16	55.9799662074
75	580	1	0	1	47.1331764298
75	581	0	0	0	40.8938472526
75	585	5	0	5	70.218327891
76	0	2	0	2	35.5824112729
76	1	39	4	35	49.1927525868
76	2	1	0	1	41.3625795891
76	7	3	1	2	38.8088142113
76	9	1	0	1	36.6723418076
76	13	3	0	3	35.4556407251
76	14	1	0	1	36.9453451557
76	18	1	0	1	31.843184096
76	19	1	0	1	34.3383211171
76	23	1	1	0	48.13830272
76	24	1	0	1	45.749826684
76	32	3	0	3	31.8041854302
76	33	1	0	1	34.0371343704
76	35	1	0	1	38.0942495836
76	36	10	0	10	25.4461795487
76	39	1	0	1	28.0320335052
76	41	2	0	2	31.3593567162
76	42	3	1	2	26.8589645888
76	45	1	0	1	71.3019131981
76	50	1	0	1	52.4957489562
76	56	1	0	1	60.7056763444
76	59	1	0	1	74.4149886462
76	69	1	0	1	56.2469025961
76	70	741	0	741	2.7494328292
76	71	154	0	154	8.02409958703
76	72	44	5	39	6.01447555246
76	73	2428	579	1849	7.47319852772
76	74	258	69	189	5.36792205784
76	75	188	34	154	8.54159312897
76	77	37	2	35	6.78556039303
76	78	903	11	892	3.82535756846
76	79	101	0	101	7.52239845514
76	80	27	1	26	5.43992571881
76	81	214	99	115	4.58752286134
76	82	545	349	196	2.23230828299
76	83	138	1	137	5.43920458684
76	84	292	45	247	6.86221108917
76	85	1009	280	729	3.75682816934
76	86	137	38	99	7.36469071586
76	87	276	10	266	8.42830349291
76	88	112	0	112	8.55988523802
76	89	27	1	26	12.8747964321
76	90	47	26	21	7.25605287308
76	92	26	4	22	7.70186303865
76	94	3	0	3	16.4790658115
76	95	17	0	17	14.9790746369
76	96	32	2	30	11.5280247039
76	98	6	0	6	10.6895926762
76	99	1	1	0	21.8013482233
76	100	3	0	3	21.1907371373
76	102	4	0	4	22.1108049656
76	103	80	27	53	12.9552058845
76	104	5	0	5	16.365659876
76	105	1	0	1	16.1890687044
76	107	10	2	8	15.4188957015
76	109	33	6	27	6.31936559455
76	110	4	2	2	17.1002223406
76	111	15	0	15	12.9792775357
76	112	43	7	36	15.0349079437
76	113	158	0	158	13.0548378374
76	114	3	0	3	20.5925640822
76	116	90	56	34	2.51501158955
76	117	8	3	5	10.9094489928
76	118	13	2	11	5.35101035701
76	119	26	5	21	8.48817983158
76	120	10	0	10	10.6751538113
76	121	3	0	3	12.2528959144
76	122	4	1	3	11.2828098386
76	123	3	0	3	17.7367492547
76	124	1	0	1	42.6004647182
76	131	1	0	1	56.2463415564
76	134	1	0	1	25.0480602949
76	135	1	0	1	39.0029143604
76	140	2	0	2	19.1320071922
76	142	22	0	22	27.8488720208
76	145	1	1	0	32.8817747528
76	146	5	1	4	14.0898122716
76	147	2	0	2	43.403637268
76	155	60	2	58	15.8097788119
76	156	11	0	11	15.2187671007
76	157	0	0	0	29.3945627944
76	158	5	2	3	26.7784805124
76	159	1	0	1	24.5151852116
76	160	2	0	2	26.6083789409
76	162	1	0	1	19.6572576077
76	163	2	0	2	38.8950110905
76	164	17	0	17	13.145010811
76	165	1	0	1	28.8117047612
76	166	38	0	38	24.1584679492
76	168	21	6	15	17.560303127
76	169	16	0	16	16.6937569045
76	170	1	0	1	31.4211171791
76	171	71	3	68	12.8783658223
76	172	31	3	28	21.8522281941
76	173	2	0	2	32.6916318363
76	175	10	0	10	17.5593175297
76	176	1	0	1	47.0423199527
76	177	53	7	46	23.2582688489
76	180	0	0	0	33.2258932678
76	183	1	0	1	90.8226349701
76	205	1	0	1	61.3518381485
76	209	1	0	1	74.1205320225
76	228	1	0	1	87.765606292
76	229	1	0	1	84.6745028024
76	243	2	0	2	114.343015889
76	245	10	2	8	23.0774883168
76	262	2	1	1	37.6373575252
76	277	13	0	13	50.9784455049
76	281	0	0	0	42.2404940666
76	285	1	0	1	60.4300631394
76	293	1	0	1	49.5950874081
76	302	1	0	1	42.7397674104
76	303	1	0	1	49.0605384272
76	310	3	1	2	43.4129778301
76	319	45	0	45	44.4072806072
76	320	1	0	1	48.4421581132
76	322	1	0	1	45.0612064804
76	323	1	0	1	39.483197423
76	325	1	0	1	53.8581091517
76	328	1	0	1	33.6373350267
76	329	11	1	10	29.9204392073
76	332	1	0	1	56.7788202173
76	334	1	0	1	56.4038210035
76	338	28	0	28	47.2840536219
76	339	1	0	1	53.2078272248
76	341	2	0	2	51.8040817928
76	342	1	0	1	56.6483762126
76	345	2	0	2	75.9762095142
76	347	3	0	3	25.466027395
76	348	2	0	2	25.6718907647
76	349	9	0	9	39.6892441779
76	353	4	1	3	34.1537297253
76	355	1	0	1	45.8438099947
76	357	1	0	1	46.2729355227
76	364	1	0	1	54.497728646
76	370	1	0	1	62.7890976685
76	373	1	0	1	62.2487051729
76	375	4	1	3	68.1803659274
76	385	1	0	1	71.9216111943
76	386	0	0	0	75.2012169287
76	392	0	0	0	68.201000985
76	406	2	0	2	91.4430220008
76	407	1	0	1	86.6575144583
76	408	8	0	8	91.4352497445
76	411	2	0	2	87.5893504237
76	419	1	0	1	101.229141419
76	442	1	0	1	111.621157192
76	455	0	0	0	55.2279438148
76	466	1	0	1	83.8839986069
76	469	1	0	1	70.3661253886
76	476	1	0	1	58.706347405
76	480	1	0	1	71.4509389087
76	491	0	0	0	80.2504296301
76	501	1	1	0	93.1744199226
76	503	2	0	2	80.294854593
76	507	1	0	1	164.235643214
76	512	0	0	0	135.140272594
76	519	1	0	1	122.390883658
76	540	0	0	0	124.036763714
76	551	1	0	1	64.9099812899
76	555	1	0	1	76.5473007891
76	558	1	0	1	82.4261326459
76	561	0	0	0	94.4397346739
76	563	0	0	0	69.6639648756
76	566	1	0	1	63.2651778702
76	569	0	0	0	52.0185201818
76	572	1	0	1	59.8538273502
76	573	16	0	16	55.1698367072
76	577	5	1	4	45.9327874942
76	581	7	0	7	39.6308497976
76	585	1	0	1	65.9961491382
76	586	0	0	0	74.1143949107
77	0	3	0	3	29.0943404262
77	1	18	0	18	42.6108275221
77	3	1	0	1	24.7801129811
77	5	1	0	1	50.2133043929
77	12	1	0	1	51.9619293482
77	13	1	0	1	29.3019991387
77	15	1	0	1	35.0341740168
77	19	3	0	3	27.7066403337
77	32	2	0	2	25.02160402
77	34	1	0	1	37.0653336866
77	36	15	3	12	19.7910527804
77	38	1	0	1	30.1508967778
77	39	2	0	2	21.2974623621
77	40	1	0	1	20.4154388022
77	41	0	0	0	26.2594394649
77	46	1	0	1	60.68959771
77	70	294	8	286	5.18295285759
77	71	59	11	48	11.5286735367
77	72	134	14	120	1.53783614979
77	73	1419	683	736	4.6312145791
77	74	128	0	128	7.54662074789
77	75	111	63	48	7.01900759623
77	76	85	70	15	6.78556039303
77	78	263	218	45	7.49605135302
77	79	246	0	246	1.16897723066
77	80	69	18	51	1.63021081346
77	81	245	116	129	2.22661165288
77	82	88	35	53	5.57758600907
77	83	83	13	70	4.79272166241
77	84	196	15	181	5.55721941033
77	85	112	3	109	10.0888490623
77	86	30	0	30	12.0964394334
77	87	144	35	109	9.06923782635
77	88	53	17	36	10.5460508895
77	89	53	30	23	7.54564532043
77	90	4	0	4	13.8001728019
77	92	53	32	21	5.8067959693
77	95	17	1	16	9.12200631745
77	96	11	0	11	17.2362916731
77	98	4	0	4	16.0613878858
77	99	1	0	1	19.1222182235
77	100	0	0	0	14.7218365145
77	101	2	0	2	15.2161881925
77	102	7	1	6	15.3252543674
77	103	56	14	42	9.95408240223
77	104	5	0	5	9.65822990187
77	105	4	0	4	9.6054340946
77	106	1	0	1	13.3175077465
77	107	1	0	1	19.4362509511
77	109	17	6	11	10.6817113815
77	110	5	0	5	14.2836672624
77	111	16	2	14	10.5026830337
77	112	27	9	18	10.709691281
77	113	111	4	107	12.4309224638
77	115	1	0	1	15.4459117443
77	116	13	4	9	8.98153499933
77	117	5	1	4	11.8117061842
77	119	8	0	8	15.1357424857
77	120	15	10	5	3.91818826174
77	121	2	1	1	13.3169235768
77	122	2	0	2	12.2905988874
77	138	1	0	1	28.2102615164
77	140	5	0	5	18.2833179858
77	142	11	2	9	27.8319749336
77	144	1	0	1	27.1855238573
77	146	1	0	1	16.1943386811
77	153	1	0	1	44.928032932
77	155	13	2	11	22.5946691786
77	156	2	0	2	21.7337443601
77	158	0	0	0	32.8253107142
77	159	1	0	1	31.1530725441
77	160	2	0	2	30.0710413669
77	162	1	0	1	26.0521575106
77	163	0	0	0	41.990106268
77	164	2	1	1	18.8510082995
77	165	1	0	1	34.3945499381
77	166	13	0	13	30.8991834839
77	168	6	1	5	22.8626596679
77	169	7	1	6	22.1366199473
77	171	7	2	5	19.4706982353
77	172	11	0	11	26.626294304
77	175	3	0	3	23.8932102777
77	177	19	2	17	28.9164116709
77	180	1	0	1	38.4257938373
77	183	0	0	0	86.5566127278
77	190	1	0	1	86.2712289157
77	202	1	0	1	96.9312562418
77	208	1	0	1	73.865060214
77	212	1	0	1	63.6837798771
77	214	1	0	1	66.5357416994
77	223	1	0	1	86.9717780596
77	245	2	0	2	18.6073835361
77	251	3	1	2	22.0576132694
77	253	1	0	1	35.3798899978
77	254	1	0	1	25.6193947642
77	260	2	0	2	18.7350118081
77	262	2	0	2	33.5613784543
77	276	1	0	1	44.1822142958
77	277	7	0	7	46.5568997988
77	281	0	0	0	38.4604725374
77	287	1	0	1	50.4592480754
77	307	2	0	2	35.22107576
77	310	3	0	3	45.9220940412
77	318	1	0	1	45.8415587745
77	319	12	0	12	51.1911859218
77	323	1	0	1	46.0992810159
77	326	1	0	1	42.6669326795
77	329	2	0	2	36.4605390998
77	338	4	1	3	52.6193318189
77	348	2	0	2	29.4130855232
77	349	0	0	0	45.8760650976
77	353	1	0	1	39.2433579908
77	361	0	0	0	57.8798570413
77	367	2	1	1	47.7161161494
77	369	1	0	1	69.1673320561
77	375	1	0	1	69.644759503
77	377	1	0	1	56.9740763746
77	408	5	0	5	94.0915024403
77	438	2	0	2	118.557839108
77	442	1	0	1	114.270108705
77	453	1	0	1	80.350734626
77	465	0	0	0	77.8381402437
77	469	0	0	0	70.3793205723
77	471	1	0	1	71.2025110954
77	477	1	0	1	75.9371472989
77	482	0	0	0	97.2511061541
77	501	1	0	1	93.7072736411
77	524	1	0	1	104.000637088
77	540	0	0	0	129.926960742
77	555	1	0	1	82.684390904
77	566	1	0	1	68.1248660532
77	568	1	0	1	52.1321374445
77	573	7	0	7	60.79390823
77	579	1	0	1	51.7082161522
77	581	3	0	3	45.3830554864
78	0	3	0	3	34.4422584235
78	1	71	0	71	48.1460557861
78	3	1	0	1	30.1790145854
78	5	2	0	2	54.8874162738
78	7	0	0	0	37.3530552425
78	13	9	1	8	33.8622294733
78	16	1	0	1	31.8362729047
78	19	1	0	1	33.4916940783
78	21	2	0	2	50.0095026653
78	23	1	0	1	46.3483477972
78	32	6	1	5	31.8039208635
78	33	1	0	1	31.8994350471
78	34	1	0	1	37.4419859149
78	35	3	0	3	35.7027772592
78	36	19	0	19	23.5209116496
78	37	1	0	1	41.6910601745
78	39	3	0	3	27.5538573902
78	41	3	0	3	28.9420575785
78	42	4	0	4	25.7788306567
78	46	1	0	1	62.9964138136
78	47	1	0	1	69.925394741
78	48	1	0	1	57.2328204902
78	49	1	0	1	47.1526799277
78	50	1	0	1	49.3816681903
78	56	1	0	1	57.8488374241
78	58	1	0	1	70.0282562251
78	59	2	0	2	70.9788906904
78	60	1	0	1	52.0396070875
78	65	0	0	0	68.7314729799
78	68	3	0	3	47.4332210121
78	70	540	0	540	5.95866913789
78	71	342	26	316	4.50241476196
78	72	53	0	53	7.51086016122
78	73	5313	1517	3796	5.64573747915
78	74	744	16	728	1.70765564696
78	75	371	7	364	5.67352160827
78	76	272	12	260	3.82535756846
78	77	12	2	10	7.49605135302
78	79	95	21	74	7.68232132322
78	80	38	12	26	5.86586796413
78	81	265	39	226	5.51583835376
78	82	523	8	515	2.4136311258
78	83	254	34	220	3.5496102088
78	84	587	160	427	4.44843705999
78	85	789	64	725	3.77382745836
78	86	306	86	220	4.61426952186
78	87	572	326	246	4.77306658403
78	88	270	137	133	4.73550074241
78	89	22	10	12	14.7745161821
78	90	21	6	15	9.58318060745
78	92	29	12	17	10.6398436555
78	94	1	1	0	20.3040462164
78	95	98	23	75	13.6156017193
78	96	15	2	13	14.5217440853
78	97	2	0	2	26.3750538936
78	98	19	4	15	8.56781028732
78	99	3	0	3	18.4672781049
78	100	1	0	1	20.237132687
78	101	1	0	1	20.542809911
78	102	9	2	7	22.1057377303
78	103	227	11	216	10.1037990118
78	104	5	1	4	16.0384850425
78	105	4	2	2	17.0049212752
78	107	22	1	21	12.3268224112
78	109	22	4	18	10.0718202123
78	110	9	5	4	13.9377154413
78	111	11	2	9	16.0555740124
78	112	73	13	60	12.6525934175
78	113	320	7	313	9.42440085566
78	114	4	1	3	18.3228619707
78	116	37	22	15	5.74932574023
78	117	12	4	8	7.10627027041
78	118	8	1	7	6.44031086749
78	119	33	2	31	8.64792382483
78	120	16	1	15	10.8180185678
78	121	15	9	6	8.42956467285
78	122	1	0	1	15.0310406001
78	124	1	0	1	38.8933591943
78	127	1	0	1	16.7135983556
78	129	1	0	1	21.7769597732
78	131	2	0	2	52.4638969355
78	133	1	0	1	24.3270992106
78	134	2	1	1	21.3174804061
78	135	1	0	1	35.4139431223
78	137	1	0	1	16.895271906
78	138	1	0	1	28.1405233714
78	140	10	5	5	15.4191757087
78	141	0	0	0	48.7155215179
78	142	60	0	60	24.0267344867
78	143	1	0	1	32.3943563287
78	145	2	0	2	29.2213093064
78	146	22	0	22	10.3481748402
78	147	3	0	3	39.6996714283
78	148	1	1	0	31.4381965614
78	149	1	0	1	50.8873990664
78	151	0	0	0	45.8592875987
78	152	1	0	1	38.1563812754
78	154	2	0	2	27.7224127638
78	155	58	14	44	16.6450680222
78	156	16	2	14	17.1590292995
78	157	4	0	4	26.6903130297
78	158	8	0	8	25.3897018207
78	159	3	1	2	24.2424285348
78	160	4	0	4	23.3565305018
78	162	1	0	1	21.6944168471
78	163	7	2	5	35.553534387
78	164	57	1	56	11.3835757783
78	165	1	0	1	26.8992640695
78	166	40	0	40	25.2587126329
78	167	3	0	3	35.8003047976
78	168	67	2	65	15.3762765976
78	169	15	4	11	19.7073196027
78	171	142	22	120	12.6519053621
78	172	68	16	52	19.2661809332
78	173	2	0	2	31.1728722443
78	175	28	1	27	16.6614093139
78	176	1	0	1	43.7919521267
78	177	156	2	154	21.4218104128
78	178	1	0	1	40.2756805651
78	179	2	0	2	24.1441525373
78	182	2	0	2	101.503846693
78	183	3	0	3	93.5392236876
78	187	1	0	1	93.7040606552
78	188	2	0	2	93.3916241309
78	190	3	0	3	93.5557644623
78	196	1	0	1	106.168256155
78	204	1	0	1	64.8657308998
78	205	1	0	1	65.119306665
78	208	2	0	2	78.2352729054
78	213	1	0	1	84.5455521437
78	220	1	0	1	110.270347721
78	225	2	0	2	82.9642441282
78	236	1	0	1	73.9584493775
78	245	6	2	4	25.5696792655
78	247	1	0	1	33.5916500261
78	251	4	1	3	26.1625425877
78	254	1	0	1	31.8169351274
78	257	1	0	1	30.4167247917
78	274	1	0	1	46.8338792342
78	275	1	0	1	58.9058633235
78	277	21	0	21	53.5860229216
78	281	1	0	1	45.1253548425
78	282	1	0	1	47.7385960246
78	285	1	0	1	63.3791722022
78	291	1	0	1	64.7513295429
78	293	2	0	2	53.2249215663
78	294	1	0	1	54.7133339455
78	303	1	0	1	48.7791506503
78	305	2	1	1	43.5418851552
78	307	3	0	3	42.4799381199
78	309	3	0	3	36.5964284171
78	310	6	0	6	47.1530734059
78	311	1	0	1	58.2488199563
78	313	1	0	1	43.4705013301
78	314	0	0	0	50.2672227807
78	319	93	19	74	44.8103343878
78	320	2	1	1	48.3855679086
78	322	1	0	1	44.7734796583
78	323	7	1	6	39.0728387684
78	325	1	0	1	53.8722356664
78	326	4	0	4	37.8606292303
78	327	6	0	6	49.6049725589
78	329	20	3	17	31.5570550368
78	332	1	0	1	59.9398197186
78	333	1	0	1	63.834922439
78	334	1	0	1	59.2655185017
78	336	1	0	1	47.080493185
78	338	33	4	29	50.0883908351
78	341	2	0	2	55.1303612713
78	342	2	0	2	59.6564399973
78	345	2	0	2	79.7693366516
78	347	0	0	0	28.2575525316
78	348	4	0	4	29.245224241
78	349	15	0	15	41.7962560309
78	350	2	0	2	40.1715082446
78	351	1	0	1	39.8990748804
78	353	6	1	5	37.1654454229
78	356	1	0	1	66.4846447202
78	357	1	0	1	48.1168677378
78	359	1	0	1	60.0672936536
78	364	1	0	1	55.5941628738
78	367	4	1	3	42.7423492662
78	375	11	0	11	71.9933590403
78	377	1	0	1	58.3469800062
78	379	1	0	1	72.3391311713
78	385	0	0	0	69.1066378852
78	392	1	1	0	65.2677757705
78	396	3	0	3	80.9427560033
78	397	1	0	1	77.2072072818
78	400	1	0	1	92.9723125192
78	406	6	0	6	87.9219302578
78	408	18	1	17	88.0148502774
78	411	1	0	1	84.2939811196
78	415	1	0	1	77.5420279331
78	417	1	0	1	79.0270663049
78	426	1	0	1	125.365677633
78	438	0	0	0	112.065383416
78	442	0	0	0	108.206327544
78	454	1	0	1	59.103098992
78	455	1	0	1	51.9791803143
78	456	1	0	1	47.1044301627
78	464	1	0	1	65.9938017513
78	465	0	0	0	73.6946003345
78	466	2	0	2	80.0601553506
78	469	3	0	3	66.5440426581
78	471	0	0	0	69.4221068959
78	475	5	0	5	58.0487240856
78	476	0	0	0	54.9969907571
78	477	2	0	2	72.596086296
78	480	1	1	0	67.6429225641
78	481	1	0	1	92.4378398367
78	491	2	1	1	76.442781534
78	496	1	0	1	67.7563275115
78	500	1	0	1	72.3437931688
78	501	1	0	1	89.3821408355
78	503	2	0	2	76.6379924625
78	507	6	0	6	162.573585548
78	512	2	0	2	132.942462331
78	520	0	0	0	93.7626027136
78	524	1	0	1	96.544631322
78	528	1	0	1	108.490141639
78	536	0	0	0	115.122130851
78	537	0	0	0	110.989757831
78	538	1	0	1	102.52886176
78	540	1	0	1	122.433789432
78	551	0	0	0	63.8079937702
78	554	1	0	1	80.9656719606
78	555	2	0	2	75.2385357152
78	556	1	0	1	100.367635813
78	563	4	1	3	68.1239938654
78	564	1	0	1	76.6407199067
78	566	3	0	3	60.8027774888
78	568	1	0	1	44.8598022414
78	569	0	0	0	50.6937402623
78	573	73	2	71	53.3013200286
78	576	1	0	1	36.5204382636
78	578	1	0	1	52.3320825017
78	579	1	1	0	44.3252677577
78	580	1	0	1	44.5943354647
78	581	8	0	8	37.8880423282
78	585	1	0	1	65.734732699
78	586	1	0	1	74.1504922802
79	0	6	2	4	28.1542069743
79	1	50	16	34	41.7156986562
79	3	2	0	2	23.8389326083
79	5	2	0	2	49.2099034424
79	7	2	0	2	31.5161884037
79	13	4	1	3	28.2661301422
79	15	1	0	1	34.0095263547
79	21	1	0	1	44.5075560312
79	24	2	0	2	38.7025815754
79	28	2	0	2	38.136507331
79	30	1	0	1	34.323726601
79	32	5	0	5	24.3971977807
79	34	2	0	2	35.907189347
79	35	1	0	1	31.7052230513
79	36	24	5	19	18.6702440531
79	38	1	0	1	28.9840987662
79	39	2	1	1	20.5117461097
79	41	4	0	4	25.1045912953
79	42	3	1	2	19.4409941306
79	48	1	0	1	56.1877745084
79	50	1	0	1	47.3218670855
79	56	1	0	1	54.9104615398
79	59	4	1	3	70.0727593919
79	70	551	247	304	6.19662813109
79	71	116	0	116	11.4332551942
79	72	143	55	88	2.70678262747
79	73	3199	1186	2013	3.91091027004
79	74	253	59	194	7.46902531158
79	75	234	11	223	6.31248679252
79	76	132	9	123	7.52239845514
79	77	164	0	164	1.16897723066
79	78	556	126	430	7.68232132322
79	80	78	36	42	2.08836307402
79	81	488	215	273	2.95838090982
79	82	222	141	81	6.03816977531
79	83	177	5	172	4.58214619181
79	84	425	70	355	5.0486027372
79	85	204	13	191	10.5989897157
79	86	75	1	74	12.2060488346
79	87	255	163	92	8.60303730977
79	88	124	48	76	10.2308160516
79	89	63	24	39	7.96346305385
79	90	15	5	10	14.6681713397
79	92	75	69	6	6.91505188658
79	94	1	0	1	19.414594433
79	95	60	23	37	7.99778433886
79	96	22	12	10	18.2706625817
79	98	6	0	6	16.2223951959
79	99	2	0	2	18.0369444284
79	101	0	0	0	16.1186728418
79	102	6	0	6	14.6780759478
79	103	91	19	72	8.91478345333
79	104	6	0	6	8.8440584621
79	105	14	4	10	9.32968938751
79	106	0	0	0	13.3378456979
79	107	9	3	6	19.2717844759
79	108	0	0	0	19.569303826
79	109	28	2	26	11.7825937982
79	110	11	1	10	13.2131100359
79	111	31	1	30	11.4203316479
79	112	88	29	59	9.55558728517
79	113	197	10	187	11.6435193411
79	114	3	0	3	14.4410942301
79	115	0	0	0	16.479653575
79	116	27	10	17	9.83423371817
79	117	10	3	7	11.2702949667
79	118	4	0	4	12.770021774
79	119	11	0	11	15.6959910899
79	120	72	17	55	3.21732523865
79	121	3	0	3	12.7588449061
79	122	3	0	3	13.4413462212
79	123	1	0	1	14.6494077484
79	128	1	0	1	31.8296459529
79	129	1	0	1	20.0352039801
79	130	0	0	0	36.9665975302
79	131	1	0	1	54.0685497568
79	132	0	0	0	56.8252113971
79	133	1	0	1	24.2149489298
79	134	2	0	2	23.0354149853
79	137	1	0	1	22.8248039319
79	138	1	0	1	27.0723006268
79	140	6	0	6	17.3855852936
79	141	1	0	1	53.8990985576
79	142	29	0	29	26.9773804341
79	144	1	0	1	26.5642802721
79	145	4	0	4	30.0761716333
79	146	4	0	4	15.7418396491
79	147	2	0	2	44.2554978433
79	149	0	0	0	54.989760977
79	151	1	0	1	47.1681066524
79	154	1	0	1	33.2804801308
79	155	39	5	34	23.3011774524
79	156	12	1	11	22.6270503435
79	158	3	0	3	33.0718511398
79	159	4	0	4	31.6600249249
79	161	1	0	1	38.2004985365
79	162	1	0	1	26.9853916169
79	163	3	0	3	41.5412042635
79	164	6	2	4	19.062287678
79	165	1	0	1	34.4969682671
79	166	26	8	18	31.6808396741
79	168	12	0	12	22.9412582424
79	169	11	0	11	23.2124073659
79	171	10	2	8	19.9791436416
79	172	32	6	26	26.5602709556
79	174	0	0	0	48.7838027172
79	175	4	1	3	24.2695977921
79	177	25	2	23	29.0568416718
79	179	1	0	1	26.9705592479
79	183	2	0	2	86.9139820484
79	208	1	0	1	74.7882667929
79	219	1	0	1	107.905530364
79	220	3	0	3	104.142845758
79	233	1	0	1	69.2450953493
79	245	9	3	6	19.0559361657
79	246	1	0	1	18.4848777388
79	247	1	0	1	31.4426729775
79	251	2	0	2	23.075786489
79	256	1	0	1	16.8280993781
79	257	2	0	2	22.9110810931
79	260	1	0	1	18.7970716026
79	264	3	1	2	28.7457536986
79	270	2	0	2	50.3239262351
79	272	1	0	1	57.7018600696
79	277	7	1	6	46.9138283601
79	280	0	0	0	54.4782450916
79	281	1	0	1	38.9672666119
79	287	1	0	1	51.0231064935
79	292	1	0	1	55.6378893549
79	296	2	0	2	40.657565996
79	307	1	0	1	34.8253626604
79	308	1	0	1	42.0839883059
79	309	2	0	2	29.1088447513
79	310	1	0	1	47.0749519429
79	313	1	0	1	44.6056393723
79	318	1	0	1	46.6906122098
79	319	24	2	22	51.8566017914
79	321	1	0	1	45.5375545126
79	323	4	0	4	46.577367424
79	326	1	0	1	43.5806077956
79	327	2	0	2	56.3256422141
79	329	7	2	5	37.354632999
79	332	1	0	1	62.5389559433
79	334	1	0	1	62.7204220868
79	336	1	0	1	49.4788776695
79	338	9	2	7	53.7269836269
79	347	1	0	1	32.1072441171
79	348	1	0	1	30.5795496667
79	349	7	1	6	46.8692287677
79	350	1	0	1	39.1516447406
79	351	1	0	1	44.318040464
79	353	5	0	5	40.3647185807
79	367	0	0	0	48.6141931876
79	376	1	0	1	76.2436371678
79	385	0	0	0	75.8909726593
79	394	1	0	1	83.3567071968
79	396	1	0	1	86.1965175404
79	406	1	0	1	93.0818534935
79	408	5	0	5	93.5178196199
79	411	2	0	2	90.1540957255
79	413	1	0	1	102.96933145
79	437	0	0	0	143.576832186
79	455	0	0	0	58.0623141193
79	460	0	0	0	69.6837005522
79	461	1	0	1	57.5202374008
79	463	1	0	1	89.6505609863
79	466	4	0	4	82.8223615414
79	469	2	0	2	69.464606992
79	472	1	0	1	61.7132644355
79	475	1	0	1	62.4139367513
79	480	1	0	1	69.5533963505
79	485	0	0	0	100.230753163
79	486	1	0	1	88.4345550714
79	487	1	0	1	82.92048138
79	491	1	0	1	78.3019059819
79	493	0	0	0	98.9366427714
79	496	0	0	0	72.1064643971
79	503	7	0	7	81.2219898748
79	507	2	0	2	170.179633424
79	512	0	0	0	140.287593767
79	523	0	0	0	120.736992343
79	536	1	0	1	122.798321441
79	540	0	0	0	130.060894067
79	548	1	0	1	170.782721746
79	552	0	0	0	98.4360082903
79	555	0	0	0	82.9175484566
79	563	1	0	1	75.7757147643
79	566	1	0	1	67.9944903135
79	568	0	0	0	51.9779712267
79	569	1	0	1	58.3741590418
79	572	1	0	1	66.8515705902
79	573	16	0	16	60.8693438715
79	577	0	0	0	52.8118700233
79	579	1	0	1	52.0033979299
79	580	1	0	1	52.1152770368
79	581	0	0	0	45.5130629644
79	585	1	0	1	73.1939467605
80	0	3	0	3	30.1858069357
80	1	24	6	18	43.7707693849
80	5	2	0	2	51.179423592
80	7	1	0	1	33.4926276873
80	8	0	0	0	65.9752320797
80	13	1	0	1	30.2010406353
80	23	1	0	1	42.9437744676
80	32	2	0	2	26.467620863
80	33	1	0	1	29.1092994971
80	35	0	0	0	33.3552861232
80	36	10	1	9	20.4344107611
80	41	2	0	2	26.6950814175
80	50	0	0	0	48.5952253416
80	65	3	0	3	67.3598837515
80	70	279	22	257	4.37168065322
80	71	52	28	24	9.94451416081
80	72	82	13	69	2.12859855446
80	73	1049	14	1035	3.76980575802
80	74	92	32	60	5.97212783107
80	75	89	75	14	6.00619953503
80	76	68	10	58	5.43992571881
80	77	67	0	67	1.63021081346
80	78	254	38	216	5.86586796413
80	79	93	70	23	2.08836307402
80	81	262	129	133	0.958725860712
80	82	97	57	40	4.0034378269
80	83	66	2	64	3.34405310351
80	84	138	89	49	4.35458955877
80	85	72	21	51	8.55170512177
80	86	24	8	16	10.4679452307
80	87	90	40	50	7.73534472803
80	88	28	0	28	9.07837067878
80	89	26	10	16	9.07838220012
80	90	9	4	5	12.620806293
80	92	24	3	21	6.43033870321
80	95	13	5	8	9.79858841757
80	96	9	1	8	16.3871500793
80	98	4	1	3	14.4313456485
80	100	2	0	2	15.7890561526
80	101	2	0	2	16.2230494471
80	102	2	1	1	16.7519114696
80	103	35	29	6	9.50421085073
80	104	2	1	1	10.9307817617
80	105	1	0	1	11.2052325165
80	107	3	1	2	17.8655567367
80	109	19	5	14	10.0808030844
80	110	5	0	5	13.8767741811
80	111	10	3	7	11.5183621627
80	112	26	0	26	10.7324319881
80	113	73	14	59	11.4382217094
80	114	2	0	2	15.9471478709
80	115	1	0	1	16.1715518785
80	116	9	1	8	7.7881500325
80	117	6	1	5	10.5217980921
80	118	3	1	2	10.6839651713
80	119	2	1	1	13.6336622256
80	120	12	1	11	5.2861479904
80	121	2	0	2	12.033032086
80	122	1	0	1	12.5528812918
80	124	2	0	2	40.3976243788
80	140	6	0	6	17.4349914069
80	142	7	0	7	26.8795694047
80	144	1	0	1	25.92453278
80	146	1	0	1	14.8014124371
80	147	1	0	1	43.7604758308
80	148	1	0	1	32.0310347099
80	155	8	2	6	21.2129505861
80	156	6	0	6	20.5875410835
80	157	1	0	1	32.3582944524
80	158	0	0	0	31.2048257656
80	162	2	1	1	24.9716360513
80	163	0	0	0	40.5634493155
80	164	6	1	5	17.2243086277
80	165	1	0	1	32.7646092921
80	166	4	0	4	29.5973722256
80	168	8	2	6	21.2343690734
80	169	2	0	2	21.4017606173
80	170	2	1	1	36.3516450931
80	171	11	0	11	17.9388528051
80	172	15	0	15	25.0202365584
80	175	2	0	2	22.3036818892
80	177	11	0	11	27.28632111
80	179	1	0	1	25.2911712331
80	183	0	0	0	88.0648531577
80	245	10	0	10	20.0854771463
80	246	1	0	1	18.849792791
80	251	1	0	1	22.7966938688
80	257	2	0	2	24.55466954
80	258	1	0	1	27.1683854832
80	260	1	0	1	20.3560639728
80	274	1	0	1	41.3162683164
80	275	1	0	1	53.2077445864
80	277	9	0	9	48.0705245794
80	291	1	0	1	60.2964602913
80	307	1	0	1	36.7937848779
80	310	1	0	1	46.0806652251
80	319	11	0	11	49.7728565413
80	320	1	0	1	53.6740485257
80	323	3	0	3	44.5554241347
80	329	4	1	3	35.3107427317
80	332	1	0	1	60.9885036143
80	334	2	0	2	61.0136724914
80	338	4	0	4	51.9797447706
80	348	4	0	4	29.2051268074
80	349	3	0	3	44.9071370955
80	353	2	0	2	38.6696181678
80	361	0	0	0	56.7146750287
80	367	1	0	1	46.5709776382
80	375	1	0	1	70.0860162447
80	406	1	1	0	92.4399842714
80	408	2	0	2	92.7571277814
80	413	1	0	1	102.015513639
80	414	0	0	0	96.8268570785
80	415	1	0	1	82.3777500537
80	417	1	0	1	84.0311625782
80	437	0	0	0	142.4841672
80	438	1	0	1	117.139822179
80	457	1	0	1	73.5954137821
80	466	2	0	2	82.9173527953
80	469	5	0	5	69.5015508285
80	480	1	0	1	69.873661097
80	520	1	0	1	99.36238174
80	524	0	0	0	102.379504394
80	530	0	0	0	129.332989869
80	554	1	0	1	86.8296722799
80	555	0	0	0	81.0633908293
80	573	5	0	5	59.1646425601
80	577	2	0	2	50.8357442255
80	581	1	0	1	43.7529305132
81	0	4	0	4	31.1040448464
81	1	57	0	57	44.6734718351
81	3	3	0	3	26.7890521428
81	4	1	0	1	39.2348281646
81	5	1	0	1	52.1212835726
81	7	3	0	3	34.4321963162
81	13	7	0	7	31.1494401649
81	15	4	1	3	36.9033436919
81	18	1	0	1	27.4997722411
81	22	1	0	1	52.7796557739
81	24	1	0	1	41.5448225005
81	25	1	0	1	63.0885973594
81	30	1	0	1	36.6762308928
81	32	6	0	6	27.238361751
81	33	4	0	4	30.0672044053
81	34	2	0	2	37.8888218743
81	35	3	0	3	34.3074614574
81	36	27	1	26	21.3930337702
81	39	3	0	3	23.4496044223
81	41	10	2	8	27.6423412929
81	42	7	0	7	22.3870509127
81	54	1	0	1	41.6129543714
81	60	1	0	1	52.4608191319
81	68	1	0	1	48.3594391005
81	70	1189	268	921	3.41816348935
81	71	150	13	137	9.79849342385
81	72	231	30	201	2.01763223013
81	73	3362	896	2466	4.46750552086
81	74	298	0	298	5.89383265085
81	75	291	217	74	6.55482385962
81	76	278	35	243	4.58752286134
81	77	144	42	102	2.22661165288
81	78	754	229	525	5.51583835376
81	79	269	130	139	2.95838090982
81	80	165	69	96	0.958725860712
81	82	297	23	274	3.40693282833
81	83	199	194	5	3.58803269485
81	84	493	64	429	4.81162915684
81	85	311	175	136	7.87256511502
81	86	110	55	55	10.1256014253
81	87	315	32	283	7.99316778337
81	88	158	60	98	9.15772814063
81	89	91	16	75	9.26287663736
81	90	47	9	38	11.7106621774
81	92	113	56	57	5.94168999974
81	95	35	0	35	10.7563307338
81	96	37	1	36	15.4296127037
81	98	2	1	1	14.0207690359
81	99	3	0	3	19.5056413606
81	100	1	0	1	16.7084772724
81	101	2	0	2	15.8677119439
81	102	14	1	13	17.5345177572
81	103	149	5	144	10.280779711
81	104	7	0	7	11.7869720403
81	105	5	0	5	11.800343325
81	106	0	0	0	15.3456680796
81	107	9	4	5	17.724157994
81	109	50	0	50	9.13464869409
81	110	4	1	3	14.6496269727
81	111	40	1	39	11.1946374653
81	112	129	22	107	11.6322051935
81	113	239	87	152	11.9386783352
81	114	7	2	5	16.888357359
81	115	3	3	0	15.6451757309
81	116	68	15	53	6.87645316969
81	117	10	0	10	10.7956984289
81	118	4	0	4	9.89209875344
81	119	13	0	13	12.9095990798
81	120	33	0	33	6.08790248448
81	121	7	3	4	12.3026340342
81	122	7	1	6	11.8251460376
81	124	1	0	1	41.0838613152
81	125	0	0	0	36.7887242991
81	127	1	0	1	20.4603308047
81	128	4	0	4	31.6531304434
81	129	2	0	2	21.9553858791
81	130	1	0	1	36.8942745379
81	131	1	0	1	55.0875871636
81	133	2	0	2	25.6707764381
81	134	1	0	1	23.8412401646
81	135	0	0	0	40.1043417995
81	137	1	0	1	21.870536505
81	138	0	0	0	28.8610708514
81	140	10	0	10	17.9978185422
81	142	26	3	23	27.3633915302
81	144	1	0	1	26.1768281532
81	145	2	0	2	31.2595683885
81	146	5	1	4	14.9433733281
81	147	1	0	1	44.0583442704
81	151	1	0	1	48.2747489251
81	152	1	0	1	41.2716735802
81	154	2	0	2	32.5706883869
81	155	36	0	36	20.3933846235
81	156	11	5	6	19.6720154604
81	157	2	1	1	32.1673449432
81	158	2	0	2	30.6983050202
81	159	3	0	3	28.9298840157
81	160	1	0	1	28.570294021
81	163	0	0	0	40.6294327823
81	164	9	0	9	16.7632127987
81	165	1	0	1	32.3687786317
81	166	19	2	17	28.7374883089
81	167	1	0	1	41.2898025547
81	168	23	1	22	20.8731987862
81	169	14	1	13	20.4433167687
81	170	3	0	3	35.7165424011
81	171	23	0	23	17.2489232583
81	172	27	2	25	24.7726406853
81	173	0	0	0	36.5395579854
81	174	0	0	0	48.1887523793
81	175	2	1	1	21.7064160018
81	177	24	7	17	26.8656174767
81	179	2	0	2	24.3420479396
81	180	0	0	0	36.4955992706
81	183	2	0	2	88.1388831041
81	185	1	0	1	93.1862751686
81	186	1	0	1	81.6520319296
81	190	1	0	1	88.0542712195
81	194	0	0	0	94.1819460337
81	200	1	0	1	92.3124682728
81	204	1	0	1	60.7722119023
81	208	1	0	1	74.2961188299
81	220	1	0	1	105.040598404
81	222	0	0	0	99.5483662711
81	223	1	0	1	87.945570423
81	241	0	0	0	123.601323221
81	243	1	0	1	112.612087381
81	245	15	0	15	20.1462593841
81	246	1	0	1	18.5971840059
81	250	2	0	2	28.9100310624
81	251	12	0	12	22.2609446472
81	253	2	0	2	36.0323850258
81	254	3	0	3	26.7465507121
81	256	2	0	2	19.3332258239
81	257	6	0	6	24.9531316502
81	260	2	0	2	20.7096233862
81	262	1	0	1	35.0329515995
81	274	1	0	1	41.4052593826
81	277	13	1	12	48.1599480876
81	281	1	0	1	39.8489160019
81	291	1	0	1	60.0308756721
81	293	1	0	1	48.9694025444
81	294	2	1	1	51.3262225563
81	303	1	0	1	44.4766108738
81	305	3	0	3	38.0674987753
81	307	1	0	1	37.4315600353
81	309	1	0	1	31.9011188754
81	310	3	0	3	45.2778771912
81	316	0	0	0	42.7688122366
81	319	35	2	33	48.9789099668
81	320	2	0	2	52.9422332932
81	321	0	0	0	42.5957944166
81	323	2	0	2	43.8793112197
81	326	2	0	2	40.6286017415
81	327	1	0	1	53.3956386293
81	328	3	0	3	38.2229597505
81	329	12	0	12	34.3986582802
81	331	1	0	1	37.53669503
81	332	0	0	0	60.0540613592
81	333	2	0	2	64.1356282875
81	334	2	0	2	60.0600301377
81	338	8	0	8	51.0233320704
81	341	3	0	3	54.8208999687
81	342	0	0	0	60.1331303431
81	345	1	0	1	76.1930389381
81	347	2	0	2	29.3265759519
81	348	2	0	2	28.3089514765
81	349	7	1	6	43.9616056592
81	350	4	2	2	37.6372068626
81	353	2	0	2	37.7176862018
81	361	0	0	0	55.8081134897
81	373	1	0	1	64.3320661318
81	375	4	0	4	69.3829562256
81	385	1	0	1	74.5174169558
81	396	1	0	1	85.7177252041
81	406	2	1	1	92.6539698249
81	408	7	0	7	92.914082624
81	411	0	0	0	89.3557504428
81	414	0	0	0	97.1129195153
81	426	1	0	1	130.103406846
81	428	1	0	1	121.592150677
81	442	0	0	0	113.102794993
81	464	0	0	0	68.4105384793
81	465	0	0	0	77.3725955669
81	466	2	0	2	83.4464591751
81	469	2	0	2	70.0110331722
81	476	1	0	1	57.1240815807
81	480	7	3	4	70.4881507035
81	482	0	0	0	97.3538186599
81	485	0	0	0	101.178917638
81	495	0	0	0	85.332185625
81	501	1	0	1	93.1892418971
81	503	4	0	4	81.0649326042
81	505	0	0	0	96.1678392317
81	524	1	0	1	102.053643765
81	535	0	0	0	136.873388062
81	536	0	0	0	120.314818832
81	540	1	0	1	127.85752272
81	548	0	0	0	168.399065916
81	554	0	0	0	86.4372921416
81	560	1	0	1	74.8034258665
81	566	1	0	1	66.3061636852
81	571	1	0	1	70.7433130166
81	573	15	1	14	58.7774970318
81	577	1	1	0	50.2137615274
81	581	1	0	1	43.3288307711
81	582	1	0	1	75.6170376604
82	0	2	0	2	33.7444622294
82	1	54	7	47	47.4005998538
82	2	1	0	1	39.2890077668
82	7	1	0	1	36.8692301807
82	19	1	0	1	32.6064898693
82	21	1	0	1	49.6956611337
82	28	2	0	2	43.9742114068
82	32	2	1	1	30.4299020343
82	33	1	0	1	31.9110291933
82	34	3	0	3	38.4381246788
82	35	1	0	1	35.9215097684
82	36	13	0	13	23.3586054258
82	41	3	0	3	29.1786210977
82	42	3	0	3	25.0276558593
82	46	1	0	1	63.4657583314
82	47	1	0	1	71.1095807912
82	50	1	0	1	50.2646879568
82	65	1	0	1	69.4091379188
82	70	423	141	282	3.63451739192
82	71	105	51	54	6.91516675327
82	72	29	15	14	5.29877096718
82	73	2379	1087	1292	5.30307816841
82	74	252	80	172	3.52430985909
82	75	164	3	161	6.3170973252
82	76	309	12	297	2.23230828299
82	77	30	7	23	5.57758600907
82	78	846	673	173	2.4136311258
82	79	78	68	10	6.03816977531
82	80	20	4	16	4.0034378269
82	81	212	33	179	3.40693282833
82	83	158	15	143	3.21805665447
82	84	338	263	75	4.63025939835
82	85	425	370	55	4.56107214976
82	86	95	72	23	6.86950811798
82	87	233	11	222	6.44045544552
82	88	93	15	78	6.91214610984
82	89	16	0	16	12.5419927737
82	90	18	1	17	9.29205289083
82	92	29	23	6	8.22628457466
82	95	30	13	17	13.0086341542
82	96	16	0	16	13.7424049161
82	97	1	0	1	24.6960760552
82	98	8	1	7	10.6667955424
82	99	2	0	2	19.602107141
82	100	1	0	1	19.3885349474
82	101	0	0	0	18.1415198831
82	102	8	0	8	20.709036267
82	103	71	29	42	10.7229458163
82	104	1	0	1	14.7888771498
82	105	2	0	2	15.1827348447
82	106	1	0	1	18.7369994965
82	107	5	1	4	14.7210279455
82	108	1	0	1	16.7879671653
82	109	24	10	14	8.43108502635
82	110	4	1	3	14.880623847
82	111	12	6	6	13.6422716655
82	112	38	1	37	12.837550186
82	113	142	85	57	10.9940252578
82	114	1	0	1	18.4247504119
82	116	52	51	1	4.70737936805
82	117	16	8	8	9.07330176318
82	118	5	1	4	6.84487822666
82	119	17	1	16	9.66451862738
82	120	5	0	5	9.25542020715
82	122	4	2	2	12.8458728877
82	129	1	0	1	22.595063506
82	131	1	0	1	54.2826933171
82	134	0	0	0	23.0331577071
82	136	1	0	1	33.9630660557
82	140	4	0	4	17.1109909254
82	141	1	0	1	51.0887079017
82	142	27	1	26	26.0273346946
82	143	1	0	1	34.4776973156
82	144	2	0	2	24.0638054359
82	146	12	1	11	12.6545044516
82	147	1	0	1	42.0028247459
82	154	1	0	1	30.1096844182
82	155	26	5	21	17.3846329468
82	156	6	2	4	17.1984698364
82	157	2	0	2	29.0305508618
82	158	7	0	7	27.2923172202
82	159	4	0	4	25.6253435546
82	160	4	0	4	25.7697526785
82	161	0	0	0	33.9806379065
82	164	14	3	11	13.3731186552
82	166	25	0	25	25.8742218385
82	168	19	4	15	17.5476927687
82	169	7	6	1	18.9161519158
82	170	2	0	2	32.350996347
82	171	37	9	28	13.9425938649
82	172	41	8	33	21.5690977258
82	175	6	0	6	18.3157422562
82	176	1	0	1	46.2055822099
82	177	58	8	50	23.4902475388
82	179	1	0	1	23.1586714894
82	183	6	0	6	91.1699410416
82	205	0	0	0	62.9111226198
82	220	1	0	1	107.863286111
82	229	1	0	1	85.824651465
82	245	7	0	7	23.2236916378
82	246	1	0	1	21.0965789653
82	251	2	0	2	23.882705517
82	253	1	0	1	38.1015503291
82	257	2	0	2	28.3386891903
82	264	2	0	2	34.1839603508
82	272	1	0	1	60.7816476699
82	277	8	0	8	51.2317767476
82	279	1	0	1	45.7490098485
82	286	1	0	1	40.3020416482
82	307	1	0	1	40.7925103562
82	310	6	0	6	45.4687070158
82	315	1	0	1	47.0008952148
82	319	39	4	35	45.8667505326
82	320	1	0	1	49.6944366735
82	321	1	0	1	39.7047806623
82	322	1	0	1	46.19817957
82	323	5	0	5	40.5529725629
82	326	3	1	2	38.118366525
82	327	2	0	2	50.4378892139
82	329	12	0	12	31.8396004399
82	331	1	0	1	34.3271937406
82	332	1	0	1	59.0109194049
82	333	1	0	1	62.986412588
82	338	27	2	25	49.4942484667
82	341	1	0	1	54.0264487514
82	345	1	0	1	77.6034194998
82	347	5	3	2	27.6680422102
82	348	2	0	2	27.8451945218
82	349	12	0	12	41.7574509624
82	352	1	0	1	33.783075853
82	353	2	0	2	36.3812985358
82	355	1	0	1	47.6915688974
82	357	2	0	2	48.2710700244
82	364	1	0	1	56.247417874
82	367	1	0	1	43.0854624138
82	369	1	0	1	68.9931243202
82	371	4	0	4	75.972114823
82	373	1	0	1	64.3558402639
82	375	7	0	7	70.0951438174
82	396	1	0	1	83.3291222064
82	401	1	0	1	94.8913813352
82	404	1	0	1	92.1761031733
82	406	2	0	2	90.3028322679
82	408	9	0	9	90.4159980838
82	411	0	0	0	86.7063362193
82	426	1	0	1	127.748926745
82	444	1	0	1	113.715428054
82	464	1	0	1	67.753828548
82	465	0	0	0	75.8436610382
82	469	2	0	2	68.6320314268
82	475	0	0	0	60.34401988
82	476	2	0	2	56.6498803012
82	480	1	0	1	69.5436627849
82	482	1	0	1	96.6307041356
82	488	1	0	1	84.9881623883
82	503	3	0	3	78.9656023302
82	506	0	0	0	104.347293227
82	524	1	0	1	98.7341401741
82	540	1	0	1	124.465586553
82	555	1	0	1	77.147381243
82	563	0	0	0	70.1226882829
82	566	0	0	0	63.0997341591
82	567	2	0	2	68.1480410023
82	569	0	0	0	52.5993206465
82	573	23	1	22	55.415254378
82	576	1	0	1	38.2722172885
82	577	0	0	0	46.8391333656
82	581	6	0	6	39.9473018366
82	585	1	0	1	67.1590371805
83	0	1	0	1	30.9452780124
83	1	28	0	28	44.6408576983
83	3	3	1	2	26.6702103208
83	7	1	0	1	33.9317934578
83	13	1	0	1	30.4801691639
83	36	11	0	11	20.2548504357
83	41	5	0	5	25.9762703278
83	42	4	1	3	22.2634190558
83	54	1	0	1	38.7809547919
83	70	128	28	100	6.03917921682
83	71	37	1	36	6.8536729535
83	72	17	2	15	5.44005870185
83	73	876	680	196	2.17682665049
83	74	79	55	24	2.91437241958
83	75	88	0	88	3.26369557296
83	76	52	14	38	5.43920458684
83	77	17	1	16	4.79272166241
83	78	188	47	141	3.5496102088
83	79	13	5	8	4.58214619181
83	80	5	0	5	3.34405310351
83	81	72	3	69	3.58803269485
83	82	89	2	87	3.21805665447
83	84	224	0	224	1.47283114269
83	85	73	0	73	7.1390673456
83	86	27	21	6	7.76655361689
83	87	90	37	53	4.41631077069
83	88	45	2	43	5.75588238453
83	89	9	0	9	12.3382571167
83	90	2	1	1	12.4413930491
83	92	11	4	7	9.52299746862
83	95	9	2	7	10.1192443127
83	96	1	0	1	16.9602037901
83	98	3	1	2	11.80822684
83	99	1	0	1	16.5688860906
83	101	1	0	1	19.4536986504
83	102	2	0	2	18.6184279218
83	103	47	19	28	7.54808842591
83	105	1	0	1	13.8275444634
83	106	1	0	1	17.9199574116
83	107	2	1	1	14.6985431422
83	108	1	0	1	19.7895291237
83	109	10	6	4	11.4503814365
83	111	6	1	5	14.7729079267
83	112	65	56	9	9.62767474968
83	113	80	29	51	8.44694834926
83	115	2	0	2	19.1927398809
83	116	5	2	3	7.92537982655
83	117	8	1	7	7.21627086787
83	119	2	0	2	12.1572803751
83	120	2	0	2	7.50412287087
83	122	1	0	1	15.1406671163
83	131	0	0	0	51.7282111208
83	134	1	0	1	20.4490316736
83	135	0	0	0	36.5706664322
83	136	0	0	0	31.4892417752
83	140	3	0	3	14.5595967178
83	142	8	2	6	23.8248063943
83	143	1	0	1	32.3849270929
83	144	1	0	1	22.6117611244
83	145	1	0	1	28.0308863002
83	146	2	0	2	11.4573947794
83	147	0	0	0	40.4780357894
83	152	1	0	1	37.7880429832
83	155	8	1	7	20.1055090076
83	156	1	0	1	20.2790770414
83	157	1	0	1	29.2217546479
83	159	1	0	1	27.7822536087
83	160	1	0	1	25.2790112352
83	162	1	0	1	24.7877501026
83	163	2	0	2	37.2267681055
83	164	4	1	3	14.6950489471
83	165	3	0	3	29.9833890312
83	166	5	0	5	28.6882166028
83	168	3	0	3	18.422851932
83	169	3	0	3	22.1318278838
83	171	9	2	7	16.2014827734
83	172	9	0	9	21.979488915
83	177	12	3	9	24.5798648118
83	183	2	0	2	91.3493290951
83	220	3	0	3	108.416352506
83	245	3	1	2	23.3927245321
83	251	3	0	3	25.7956138589
83	255	2	0	2	34.0528642652
83	256	4	3	1	21.2562337575
83	257	2	0	2	27.4894786102
83	264	3	0	3	33.3209388881
83	270	1	0	1	54.9032030129
83	277	5	0	5	51.3495798091
83	303	1	0	1	45.2347432081
83	305	2	0	2	40.6138671889
83	310	1	0	1	48.2865266789
83	319	14	0	14	48.3537456276
83	323	1	1	0	42.5879902752
83	329	3	0	3	34.8400314943
83	338	3	0	3	52.7122199148
83	341	0	0	0	57.1695180898
83	347	1	0	1	30.8849679524
83	348	0	0	0	30.8866201075
83	349	3	0	3	44.885846781
83	350	1	0	1	40.862036321
83	353	1	0	1	39.5927182556
83	361	1	0	1	56.1198420065
83	375	1	0	1	72.6606985849
83	377	0	0	0	59.4452013069
83	385	1	0	1	71.3804334131
83	386	0	0	0	74.9033182172
83	396	1	1	0	82.1870178095
83	408	3	0	3	89.4156647333
83	442	0	0	0	109.60089748
83	464	1	0	1	65.1170969003
83	466	0	0	0	79.933304596
83	469	1	0	1	66.4819939948
83	476	0	0	0	53.910475984
83	480	1	0	1	67.0821266108
83	486	0	0	0	86.8942515346
83	496	2	0	2	68.4623950825
83	501	1	0	1	89.6214473074
83	503	3	0	3	77.4847249253
83	555	0	0	0	78.5038443805
83	563	1	0	1	71.298384432
83	566	2	0	2	63.4176492415
83	573	6	0	6	56.3295801689
83	578	0	0	0	54.8257149843
83	581	2	0	2	41.0140333235
84	0	4	1	3	30.0377902286
84	1	151	2	149	43.7471005315
84	2	1	0	1	35.0084268896
84	3	3	1	2	25.7907255172
84	5	2	0	2	50.4395039998
84	7	3	0	3	32.9082478892
84	12	2	0	2	52.6577891161
84	13	6	1	5	29.4138089924
84	15	2	0	2	35.1792270186
84	17	1	0	1	39.4927131651
84	18	1	1	0	25.9169984166
84	21	2	0	2	45.5652291699
84	23	2	0	2	41.9117552355
84	24	3	0	3	39.4717791808
84	26	1	0	1	43.9465242153
84	28	3	0	3	40.5827479295
84	29	1	0	1	53.1565382917
84	31	2	1	1	21.9084024905
84	32	7	0	7	27.8469950643
84	33	1	0	1	27.5191245871
84	35	6	0	6	31.4154333839
84	36	44	21	23	19.0887504204
84	38	3	0	3	27.3636460379
84	39	10	2	8	23.3809712738
84	41	5	1	4	24.6596137601
84	42	15	0	15	21.4038562656
84	46	3	0	3	58.8755039429
84	48	3	1	2	53.8809942174
84	50	4	1	3	45.6424012582
84	54	1	0	1	37.3081643474
84	59	1	0	1	67.7062715426
84	60	1	0	1	48.4544142781
84	65	3	0	3	64.782795911
84	68	1	0	1	44.1109358317
84	69	1	0	1	49.7916905004
84	70	733	550	183	7.49311129927
84	71	337	91	246	6.82126849575
84	72	102	14	88	6.480807499
84	73	5486	0	5486	1.45008519904
84	74	768	339	429	3.2690487066
84	75	926	480	446	1.80551187202
84	76	302	84	218	6.86221108917
84	77	58	0	58	5.55721941033
84	78	1403	221	1182	4.44843705999
84	79	163	53	110	5.0486027372
84	80	58	7	51	4.35458955877
84	81	449	262	187	4.81162915684
84	82	498	70	428	4.63025939835
84	83	548	407	141	1.47283114269
84	85	473	43	430	8.19767068137
84	86	208	157	51	8.10725509579
84	87	1063	221	842	3.55443589193
84	88	359	109	250	5.26540476405
84	89	57	5	52	13.0004286646
84	90	35	6	29	13.7353569462
84	92	46	0	46	10.7341591117
84	95	73	38	35	9.2366327379
84	96	24	0	24	18.3572580321
84	97	1	0	1	29.0265154302
84	98	19	7	12	12.1113019103
84	99	3	0	3	15.0965445735
84	100	4	0	4	15.9255964419
84	101	2	0	2	20.5775983385
84	102	5	0	5	18.243158157
84	103	330	106	224	6.09610836785
84	104	8	2	6	12.0995407109
84	105	4	3	1	13.9286090885
84	107	21	2	19	14.413198296
84	109	44	18	26	12.9218260105
84	110	29	2	27	10.3124598999
84	111	39	0	39	15.8724091706
84	112	244	0	244	8.31121563158
84	113	627	140	487	7.12708507621
84	114	10	0	10	13.9609703403
84	116	42	36	6	9.32192002369
84	117	37	12	25	6.25687645576
84	118	5	0	5	10.8306985086
84	119	24	0	24	13.0766937658
84	120	22	6	16	7.56426172922
84	121	14	0	14	7.76023822739
84	122	1	0	1	16.5308996717
84	123	1	0	1	19.5507650982
84	124	0	0	0	36.4023120267
84	127	1	0	1	15.7297386626
84	128	4	1	3	27.0041799065
84	129	3	1	2	17.9737600651
84	131	2	1	1	50.3348814664
84	133	2	1	1	21.1917779021
84	134	4	0	4	19.0652372603
84	137	0	0	0	17.7765357606
84	138	0	0	0	24.6511674776
84	140	22	6	16	13.1989453416
84	141	1	0	1	48.9530898447
84	142	91	35	56	22.5570664134
84	143	1	0	1	31.1411540106
84	144	6	0	6	21.6317357585
84	145	3	1	2	26.5947568674
84	146	17	5	12	10.6940998028
84	147	3	0	3	39.4285642357
84	151	1	0	1	43.5539060804
84	152	1	0	1	36.4631121299
84	153	1	0	1	39.5511506451
84	154	3	0	3	28.2584926845
84	155	65	0	65	21.0895555976
84	156	8	2	6	21.4976614851
84	157	2	0	2	28.917925012
84	158	4	3	1	28.9750802253
84	159	5	0	5	28.4295677499
84	160	4	0	4	24.6910892863
84	161	1	0	1	33.184109352
84	162	2	1	1	26.0215754184
84	163	3	0	3	36.495720169
84	164	41	11	30	15.0268225312
84	165	5	0	5	30.0385793476
84	166	34	2	32	29.7066496489
84	167	3	0	3	38.0561386989
84	168	54	0	54	18.5015202844
84	169	22	11	11	23.538116534
84	170	1	0	1	34.7443380043
84	171	79	0	79	16.9625242685
84	172	82	47	35	21.8137216372
84	173	3	0	3	34.6043756741
84	175	15	4	11	20.6617319436
84	176	1	0	1	44.8735578678
84	177	135	0	135	24.7129989155
84	180	2	1	1	33.7327392434
84	183	5	0	5	91.9602713372
84	186	1	0	1	85.8362660548
84	190	1	0	1	91.4502550493
84	195	1	0	1	113.494613163
84	200	1	0	1	97.052003621
84	204	1	0	1	65.5536991772
84	208	2	1	1	79.0933792404
84	209	2	0	2	78.2480848729
84	211	1	0	1	86.8766746678
84	219	1	0	1	112.89275349
84	220	7	1	6	109.173859415
84	222	1	0	1	103.46997267
84	225	1	0	1	83.0891504822
84	229	2	0	2	88.258569455
84	236	1	0	1	73.4459357017
84	243	1	0	1	116.995761577
84	244	1	0	1	122.344195031
84	245	16	0	16	24.0935911079
84	246	1	0	1	23.1825334433
84	249	1	1	0	34.6672827344
84	250	1	0	1	32.9964151305
84	251	17	1	16	27.072307628
84	252	1	1	0	36.613416137
84	253	1	0	1	40.76157517
84	256	3	0	3	21.2222976225
84	257	4	0	4	27.7276573774
84	258	1	0	1	29.5836936428
84	260	2	0	2	23.7073498906
84	262	2	0	2	39.0583861112
84	264	17	1	16	33.5317338746
84	270	1	0	1	55.1267016736
84	271	1	0	1	70.157995164
84	272	3	0	3	62.6217571148
84	276	1	0	1	49.7088719895
84	277	43	0	43	51.9608834352
84	279	1	0	1	45.7402857329
84	281	1	0	1	43.9869808442
84	282	2	1	1	46.9500521507
84	293	1	0	1	53.7277235228
84	294	1	0	1	56.1269113139
84	304	1	0	1	33.5800344095
84	305	5	1	4	40.8226891843
84	307	1	0	1	38.8870129972
84	309	2	0	2	32.7041945752
84	310	6	1	5	49.7452353035
84	317	0	0	0	58.74172666
84	318	3	0	3	44.961033887
84	319	65	8	57	49.1490332637
84	321	2	0	2	43.4241878923
84	322	1	0	1	48.878641449
84	323	3	0	3	43.1386541727
84	326	2	0	2	42.2802764886
84	327	2	0	2	54.016840035
84	328	1	0	1	38.708347485
84	329	24	0	24	35.9791734205
84	330	1	0	1	52.5784072431
84	331	1	0	1	37.4036653925
84	332	1	0	1	63.6385212404
84	338	30	0	30	54.0960893818
84	339	2	0	2	60.06919144
84	341	1	0	1	58.6289204486
84	342	1	0	1	63.5054636773
84	345	3	0	3	81.0043527731
84	346	1	0	1	103.053054003
84	347	2	0	2	32.2614338951
84	348	2	0	2	32.3587473216
84	349	9	2	7	46.1287145293
84	350	2	0	2	42.2862688263
84	352	1	0	1	38.2788482141
84	353	3	0	3	41.0080408388
84	355	2	0	2	51.6715212192
84	357	1	0	1	52.5153610644
84	360	1	0	1	77.5513684995
84	361	1	0	1	57.2008054573
84	364	2	1	1	60.0357762145
84	367	1	0	1	47.177600113
84	371	1	0	1	79.5968614314
84	372	1	0	1	75.0160676909
84	375	14	3	11	74.0742300877
84	379	1	0	1	73.6856895056
84	380	1	0	1	59.0550936233
84	381	0	0	0	83.5557974166
84	385	1	0	1	70.881164536
84	396	1	0	1	81.2555929232
84	399	1	0	1	86.6767897905
84	401	1	0	1	93.2189447602
84	404	1	0	1	90.7948973964
84	406	8	0	8	88.1611558874
84	408	28	0	28	88.536748527
84	409	1	0	1	89.6339859764
84	410	1	0	1	84.2145534639
84	411	6	0	6	85.1277327106
84	412	0	0	0	98.038185261
84	414	0	0	0	92.496973238
84	415	3	0	3	78.1923332594
84	417	2	0	2	79.9138008014
84	419	3	0	3	98.6237106994
84	426	1	0	1	125.601434579
84	427	1	0	1	102.012031161
84	438	2	0	2	113.044895844
84	441	0	0	0	108.200221848
84	442	1	0	1	108.714277324
84	455	0	0	0	53.0164629599
84	464	4	0	4	63.7018870536
84	465	2	0	2	72.5724093587
84	466	4	0	4	78.634847528
84	469	3	1	2	65.2005130502
84	475	1	0	1	57.6626810983
84	476	1	0	1	52.4744061966
84	477	1	0	1	70.9321688744
84	479	1	0	1	60.3928444294
84	480	1	0	1	65.7101253447
84	482	3	0	3	92.6307273741
84	484	1	0	1	75.7622751111
84	485	0	0	0	96.3994123079
84	486	0	0	0	85.4371698012
84	487	0	0	0	79.88508492
84	490	1	0	1	73.9255708801
84	491	1	0	1	74.493012555
84	494	1	0	1	63.5112940275
84	496	9	0	9	67.3685141447
84	501	1	1	0	88.3997332967
84	502	1	0	1	84.9583552749
84	503	23	7	16	76.4279293779
84	505	0	0	0	91.3567184557
84	512	0	0	0	135.464512142
84	516	0	0	0	124.70075538
84	529	1	0	1	127.638463614
84	548	0	0	0	166.531646045
84	551	0	0	0	67.4157314562
84	554	1	0	1	83.9494716121
84	555	1	0	1	78.6743906384
84	561	1	0	1	95.9991938531
84	563	3	0	3	71.3842957803
84	566	4	0	4	63.1085489827
84	567	1	0	1	68.9996085538
84	569	0	0	0	54.1723059944
84	570	1	0	1	56.1233550816
84	573	55	1	54	56.30251981
84	575	0	0	0	62.4917783825
84	577	2	1	1	49.0772952521
84	579	1	0	1	47.9664666921
84	580	1	0	1	47.4934522883
84	581	13	2	11	41.0818017877
84	585	1	0	1	69.8187725721
84	586	1	0	1	78.3495920317
85	0	1	0	1	38.0770998007
85	1	85	11	74	51.7659188062
85	3	3	0	3	33.795305146
85	7	2	0	2	41.063081996
85	9	2	0	2	39.3842881708
85	13	2	0	2	37.5938476675
85	19	1	0	1	37.0366964484
85	22	1	0	1	59.901420832
85	23	1	0	1	50.1093215191
85	28	2	0	2	48.4298074602
85	32	9	0	9	34.9898161253
85	34	1	0	1	40.8928493068
85	36	18	3	15	27.2848019503
85	39	4	0	4	30.9503999323
85	41	1	0	1	32.700136758
85	42	3	0	3	29.3841316395
85	43	1	0	1	78.9589855472
85	46	1	0	1	66.6864116716
85	48	1	0	1	60.5076284481
85	56	1	0	1	61.4797052059
85	59	3	0	3	74.189093606
85	60	1	0	1	55.4581463673
85	68	2	0	2	50.7063153019
85	70	903	50	853	6.48688238004
85	71	302	11	291	5.85465590703
85	72	70	18	52	9.58066897726
85	73	4470	1844	2626	9.30498673741
85	74	394	11	383	5.33385015918
85	75	267	233	34	9.43376041318
85	76	643	453	190	3.75682816934
85	77	43	12	31	10.0888490623
85	78	1769	88	1681	3.77382745836
85	79	105	14	91	10.5989897157
85	80	21	0	21	8.55170512177
85	81	293	236	57	7.87256511502
85	82	629	317	312	4.56107214976
85	83	199	54	145	7.1390673456
85	84	424	69	355	8.19767068137
85	86	272	170	102	4.37969360668
85	87	469	381	88	8.12811072012
85	88	184	50	134	7.34849375438
85	89	39	22	17	16.6054853667
85	90	51	3	48	6.05971847659
85	92	38	4	34	11.4082091681
85	94	1	0	1	18.7034417196
85	95	40	0	40	17.2563631928
85	96	35	1	34	11.2419939607
85	98	16	5	11	7.0670433985
85	101	1	0	1	20.6828741587
85	102	7	1	6	25.2687252443
85	103	135	44	91	13.8302242165
85	105	2	0	2	19.6685116423
85	106	1	0	1	23.0069703163
85	107	21	4	17	12.231411812
85	109	44	0	44	8.1997498599
85	110	8	0	8	17.5166550407
85	111	11	3	8	16.5854243713
85	112	54	0	54	16.4257032873
85	113	255	103	152	12.6286597204
85	114	2	0	2	22.0962437713
85	115	1	0	1	19.2983817055
85	116	105	60	45	3.7076780253
85	117	15	0	15	9.9024231871
85	118	39	1	38	2.68018810513
85	119	65	49	16	5.11261682651
85	120	15	0	15	13.8163075648
85	121	4	1	3	10.9520720665
85	122	4	0	4	14.1391919197
85	123	1	0	1	21.4309989032
85	124	0	0	0	41.6781386518
85	128	0	0	0	28.8801876838
85	129	1	0	1	25.3718507226
85	131	1	0	1	54.9485791927
85	133	1	0	1	27.5863228406
85	137	1	0	1	17.6163513826
85	140	10	0	10	18.3338106043
85	142	36	2	34	26.2875118548
85	145	2	0	2	32.1526305513
85	146	8	0	8	11.9906876066
85	147	0	0	0	40.8764907055
85	151	1	0	1	48.4895628736
85	154	3	0	3	28.3995320706
85	155	148	0	148	12.9707642743
85	156	24	0	24	13.4067286437
85	157	2	1	1	25.8335888114
85	158	3	0	3	23.0393202874
85	159	7	0	7	21.0716895167
85	160	2	0	2	23.4359271213
85	161	1	0	1	31.2447431043
85	162	5	0	5	17.9440811521
85	163	4	1	3	35.7630592077
85	164	58	25	33	9.40660235546
85	165	5	0	5	25.0609525893
85	166	49	3	46	21.5498843119
85	168	53	2	51	13.873149007
85	169	15	0	15	16.3583203335
85	170	4	0	4	27.8488375684
85	171	205	9	196	9.38740234136
85	172	68	15	53	18.2711560766
85	173	0	0	0	28.9441446788
85	175	19	0	19	13.883434058
85	177	101	29	72	19.5060642542
85	179	3	0	3	20.9256916138
85	183	1	0	1	94.4707889199
85	188	1	0	1	93.7756701291
85	207	1	0	1	74.5126793378
85	208	1	0	1	77.1257542854
85	217	1	0	1	107.148570015
85	225	1	0	1	82.4601746231
85	237	2	0	2	71.1520883033
85	242	1	0	1	122.919197458
85	245	9	1	8	26.8113610677
85	247	1	0	1	32.1806323038
85	251	6	0	6	25.3852604357
85	252	1	0	1	37.5319927452
85	256	1	0	1	27.1980648428
85	257	2	0	2	32.559212771
85	260	1	0	1	28.242529599
85	262	1	0	1	41.2988210642
85	271	1	0	1	71.785785062
85	274	1	0	1	47.9483860949
85	277	17	0	17	54.6696539285
85	281	0	0	0	45.8469376377
85	282	1	0	1	48.1462493994
85	293	1	0	1	52.5041771395
85	294	0	0	0	53.2144288422
85	303	1	0	1	52.1188705296
85	304	1	0	1	41.2257289849
85	305	1	0	1	45.6079882047
85	307	1	0	1	45.3039329135
85	309	1	0	1	39.7072083532
85	310	11	0	11	44.6969028554
85	314	0	0	0	47.4131533178
85	319	106	6	100	41.3425190321
85	320	5	0	5	45.1334016512
85	321	3	0	3	35.3253292133
85	323	6	0	6	36.0110404468
85	324	2	1	1	42.6355941658
85	325	2	0	2	50.587841904
85	326	4	0	4	34.0893588503
85	327	2	0	2	46.0004328195
85	328	1	0	1	30.727316006
85	329	30	5	25	27.7864894992
85	331	2	0	2	29.7714910124
85	332	3	0	3	56.5727050783
85	333	1	0	1	60.4044608318
85	334	3	0	3	55.7090073072
85	335	1	0	1	60.3353204069
85	338	28	10	18	46.511876411
85	339	2	0	2	52.8399181184
85	341	3	0	3	51.9195353584
85	344	1	0	1	55.1569583499
85	345	0	0	0	78.34191837
85	347	3	0	3	24.7159380263
85	348	2	1	1	26.4526198479
85	349	24	3	21	38.0375332763
85	350	5	0	5	38.159552586
85	353	7	1	6	33.7250939374
85	355	1	0	1	43.4848673313
85	357	2	0	2	44.343044837
85	358	1	0	1	83.3443880965
85	367	4	1	3	38.9799503592
85	370	1	0	1	64.9179598311
85	371	4	1	3	76.3729315898
85	373	1	0	1	63.2485956914
85	375	9	0	9	69.88430391
85	377	1	0	1	55.8844137793
85	385	1	0	1	68.3609462386
85	392	0	0	0	64.7027656446
85	396	1	0	1	81.4518712178
85	398	0	0	0	101.52593371
85	406	3	0	3	88.4780035117
85	408	26	2	24	88.3317230979
85	411	1	0	1	84.3503901905
85	415	2	0	2	77.7725812736
85	417	2	0	2	79.0495342768
85	426	0	0	0	125.872985103
85	427	1	0	1	102.247878051
85	438	0	0	0	111.949891789
85	442	1	0	1	108.502590298
85	444	2	0	2	111.965792817
85	455	1	0	1	51.9702503504
85	460	0	0	0	64.6176877974
85	465	0	0	0	75.3780357556
85	466	1	0	1	81.9617203226
85	468	1	0	1	54.4451294114
85	469	3	0	3	68.414453508
85	471	1	0	1	72.1665110963
85	472	1	0	1	62.0270006259
85	475	2	0	2	59.2042169643
85	477	0	0	0	74.6915116849
85	487	0	0	0	85.4614351226
85	488	1	0	1	85.7863484653
85	489	1	0	1	95.7228443249
85	491	0	0	0	78.7408138628
85	493	0	0	0	98.6092893187
85	501	1	0	1	90.9259560916
85	502	0	0	0	86.5458874286
85	503	3	0	3	77.5908575974
85	505	0	0	0	94.5045766449
85	506	0	0	0	102.916645518
85	507	1	0	1	160.487967958
85	511	1	0	1	166.534967645
85	512	1	0	1	131.400747863
85	520	1	0	1	92.8112049736
85	524	2	0	2	94.8610508767
85	530	0	0	0	120.850876229
85	532	1	0	1	129.512545377
85	536	0	0	0	112.497803103
85	537	0	0	0	108.902825823
85	540	1	0	1	120.293131948
85	551	0	0	0	61.239403984
85	554	0	0	0	79.0264978999
85	555	1	0	1	72.8385747605
85	563	0	0	0	65.922992639
85	566	1	0	1	59.5829962805
85	568	0	0	0	43.8086709291
85	569	0	0	0	48.3016518263
85	571	0	0	0	63.6843326608
85	573	46	2	44	51.4132910674
85	576	1	0	1	33.8550819785
85	577	3	0	3	42.3512370342
85	578	1	0	1	51.3247735058
85	579	1	0	1	41.7707799894
85	581	9	1	8	35.8743457708
85	583	1	0	1	84.0640976903
85	585	1	0	1	62.6036576243
85	587	1	1	0	58.4317910486
86	1	22	1	21	51.514848912
86	3	2	0	2	33.6316649545
86	7	1	0	1	40.4203705765
86	9	1	0	1	39.4489468508
86	13	3	1	2	36.8265955531
86	28	1	0	1	48.5233870794
86	32	1	0	1	35.9498896586
86	35	2	0	2	37.7042271239
86	36	6	0	6	26.2887075411
86	39	2	0	2	31.4653889479
86	42	2	0	2	29.2931410451
86	45	1	0	1	66.9641279357
86	47	1	0	1	69.8492410866
86	50	1	0	1	50.0371351969
86	59	0	0	0	70.7659431144
86	69	1	0	1	51.9032961696
86	70	204	0	204	10.011817452
86	71	336	0	336	2.17762592146
86	72	6	3	3	12.1088642839
86	73	1659	773	886	9.52939070541
86	74	208	42	166	4.89714273784
86	75	126	6	120	8.53597002325
86	76	78	26	52	7.36469071586
86	77	10	2	8	12.0964394334
86	78	704	477	227	4.61426952186
86	79	39	5	34	12.2060488346
86	80	11	1	10	10.4679452307
86	81	83	2	81	10.1256014253
86	82	136	54	82	6.86950811798
86	83	67	16	51	7.76655361689
86	84	209	80	129	8.10725509579
86	85	275	80	195	4.37969360668
86	87	319	132	187	6.14278443169
86	88	116	1	115	4.46350373925
86	89	11	0	11	19.3742991475
86	90	9	3	6	9.77055960349
86	92	8	2	6	14.9229075954
86	95	12	0	12	17.2011782051
86	96	3	1	2	15.061583506
86	98	16	3	13	4.04190513031
86	99	2	0	2	19.1050700651
86	100	1	0	1	23.934458562
86	101	1	0	1	24.6084001756
86	103	58	14	44	12.2959001755
86	105	1	0	1	21.5323206859
86	107	16	7	9	8.05538551877
86	109	6	0	6	12.5762444968
86	110	9	0	9	15.2199077406
86	111	4	1	3	20.2881016211
86	112	13	2	11	15.2937113425
86	113	112	67	45	9.78457617681
86	114	0	0	0	20.8297524337
86	116	18	0	18	8.04971305196
86	117	13	1	12	6.74833877715
86	118	6	0	6	6.14705842549
86	119	7	1	6	6.41191446964
86	120	5	0	5	15.2569281115
86	121	2	1	1	7.3914245537
86	131	1	0	1	50.8882899343
86	134	1	0	1	20.4198426284
86	140	6	5	1	14.8505627176
86	141	1	0	1	45.0871450959
86	142	13	3	10	22.1817929931
86	146	5	0	5	7.77843635632
86	147	3	2	1	36.4973107608
86	154	2	0	2	24.0632154935
86	155	34	5	29	14.1563635066
86	156	4	0	4	15.9651807044
86	157	1	0	1	22.1764740045
86	158	3	0	3	20.9407052781
86	159	3	0	3	20.4588216916
86	160	4	0	4	19.2562576815
86	162	1	0	1	20.4042296513
86	163	2	0	2	31.5603179423
86	164	25	15	10	6.93950889022
86	165	4	0	4	22.3039042069
86	166	19	5	14	22.7228983842
86	168	36	31	5	10.7664348132
86	169	3	0	3	19.9878134166
86	171	33	8	25	9.35418921617
86	172	40	5	35	14.6999622648
86	173	4	0	4	26.6587735255
86	175	12	0	12	12.5866247443
86	177	77	8	69	16.8508102552
86	179	1	0	1	24.6643038472
86	180	1	0	1	26.3701084688
86	183	0	0	0	98.0069343384
86	220	0	0	0	114.575878682
86	236	1	0	1	78.0421635218
86	242	1	0	1	126.991447632
86	245	4	0	4	30.0875422383
86	262	1	0	1	44.8254155299
86	264	1	1	0	40.8689695791
86	272	1	0	1	67.3205884808
86	277	3	0	3	58.0872796478
86	281	0	0	0	49.5032681575
86	282	1	0	1	51.9863734027
86	303	1	0	1	52.6995693659
86	307	1	0	1	46.8720837607
86	309	1	0	1	40.79777402
86	310	2	0	2	48.89660283
86	314	1	0	1	51.3812633633
86	319	31	1	30	41.3672668043
86	321	1	0	1	36.1094950918
86	323	2	1	1	35.0603541197
86	324	1	0	1	43.4821867588
86	325	1	0	1	50.089058236
86	329	8	1	7	29.5039066044
86	331	2	0	2	29.52826161
86	332	1	0	1	59.9577297241
86	334	1	1	0	58.714137828
86	338	11	0	11	49.4885858183
86	341	6	1	5	55.5354145788
86	346	0	0	0	105.126240427
86	347	1	0	1	27.8971272964
86	348	2	0	2	30.5185795493
86	349	3	0	3	40.209677455
86	350	1	0	1	42.4978830601
86	353	1	0	1	37.0528169278
86	357	2	0	2	46.1370209879
86	358	1	0	1	83.9396944644
86	361	0	0	0	50.2812715625
86	367	1	0	1	40.4678838164
86	371	1	0	1	80.7442618412
86	372	1	0	1	76.0307958729
86	375	0	0	0	74.1858473783
86	408	8	0	8	84.1193305039
86	411	2	0	2	80.2323665547
86	412	0	0	0	93.810668468
86	416	1	0	1	91.4416981004
86	417	1	0	1	74.9440610877
86	425	1	0	1	104.127905163
86	441	0	0	0	103.225295835
86	460	1	0	1	60.3706563361
86	464	0	0	0	64.5289094271
86	465	0	0	0	71.0259937693
86	466	1	0	1	77.6505059769
86	469	1	0	1	64.0997372593
86	471	1	0	1	68.2627902217
86	476	1	0	1	53.8586320321
86	480	1	0	1	65.7779167789
86	485	0	0	0	96.2752601606
86	493	1	0	1	94.3322213593
86	495	0	0	0	78.4821890516
86	503	4	0	4	73.2329495391
86	521	1	0	1	97.3416976206
86	549	0	0	0	145.076858766
86	552	1	0	1	86.3930977981
86	554	1	0	1	76.3637448553
86	555	1	0	1	70.7426642767
86	563	0	0	0	63.570298191
86	566	1	0	1	56.2306789066
86	567	1	0	1	61.4265725586
86	568	2	1	1	40.3160208058
86	569	1	0	1	46.2094510561
86	571	0	0	0	60.6182488519
86	573	36	3	33	48.6980937685
86	575	0	0	0	54.5626042298
86	577	1	0	1	40.9711653182
86	579	6	2	4	39.9205390858
86	581	7	1	6	33.3095638718
87	0	4	0	4	31.7773864142
87	1	58	1	57	45.4566104681
87	5	1	0	1	51.5810195217
87	7	4	0	4	34.2990529482
87	13	4	0	4	30.6941917939
87	15	1	0	1	36.3987159086
87	24	1	0	1	40.3810199559
87	28	1	0	1	42.5774374204
87	32	3	0	3	30.541335106
87	36	20	1	19	20.1478452603
87	39	1	0	1	25.8025394427
87	41	1	0	1	24.9577207785
87	42	4	0	4	23.34522834
87	45	3	0	3	62.9318017641
87	46	3	0	3	58.6617476101
87	47	1	0	1	65.1753853384
87	48	3	0	3	52.484179293
87	49	1	0	1	42.7295140247
87	50	1	0	1	44.7608613618
87	53	1	0	1	69.8653060749
87	56	1	0	1	53.3871952292
87	59	5	0	5	66.2168853825
87	60	1	0	1	47.35197495
87	68	5	0	5	42.6829238203
87	70	285	48	237	9.96346054639
87	71	305	47	258	4.22658969175
87	72	28	0	28	9.84948307679
87	73	3609	618	2991	4.83604381991
87	74	608	264	344	3.08780588716
87	75	501	161	340	2.84043971394
87	76	105	0	105	8.42830349291
87	77	10	2	8	9.06923782635
87	78	795	636	159	4.77306658403
87	79	60	1	59	8.60303730977
87	80	21	12	9	7.73534472803
87	81	186	10	176	7.99316778337
87	82	215	22	193	6.44045544552
87	83	188	164	24	4.41631077069
87	84	605	72	533	3.55443589193
87	85	270	6	264	8.12811072012
87	86	191	37	154	6.14278443169
87	88	433	256	177	2.03503017149
87	89	17	0	17	16.5510908667
87	90	14	1	13	14.1666862787
87	92	30	8	22	13.9032662988
87	95	21	0	21	11.4395072527
87	96	7	1	6	19.2339784702
87	97	0	0	0	31.0592425604
87	98	14	1	13	9.76312437185
87	99	3	0	3	13.7762915179
87	100	1	0	1	18.1473283278
87	102	3	0	3	21.1170774834
87	103	209	29	180	6.15677852949
87	104	4	0	4	14.9972798004
87	105	7	1	6	17.3162991053
87	107	27	9	18	11.0964295792
87	109	12	6	6	14.7465705609
87	110	13	0	13	9.42374809527
87	111	6	0	6	19.1862118688
87	112	61	7	54	9.16165119852
87	113	414	227	187	4.65358695422
87	116	18	2	16	10.5186109573
87	117	64	27	37	2.80259372202
87	118	2	0	2	10.7584579057
87	119	17	2	15	12.1908165871
87	120	15	6	9	10.9897185246
87	121	23	0	23	4.31017503893
87	122	1	0	1	19.2129638073
87	124	1	0	1	34.1733555048
87	125	1	0	1	30.4259848292
87	129	4	0	4	17.2723264954
87	131	1	0	1	47.8482680979
87	135	1	0	1	32.1689767864
87	138	0	0	0	23.4501883955
87	140	15	0	15	10.7038998932
87	142	58	23	35	19.6252189779
87	144	2	0	2	18.1961153858
87	145	2	0	2	24.4702323759
87	146	15	6	9	7.14087232168
87	147	2	1	1	36.0652652201
87	148	1	0	1	26.6693052392
87	154	2	0	2	24.7287915954
87	155	51	5	46	20.1590414517
87	156	4	0	4	21.396585657
87	157	1	0	1	25.5238011234
87	158	3	0	3	26.2928983111
87	159	2	0	2	26.501632411
87	160	2	1	1	21.1506532642
87	162	2	0	2	25.9217949697
87	163	3	0	3	32.9438895174
87	164	25	1	24	12.6338176132
87	165	2	0	2	27.0267528111
87	166	25	1	24	28.7743909617
87	168	43	13	30	15.6020199844
87	169	4	1	3	24.4034367842
87	171	72	21	51	15.4908245035
87	172	62	7	55	18.5695428426
87	173	1	0	1	31.7635207034
87	175	13	0	13	18.5332454705
87	176	1	0	1	41.3196030441
87	177	110	9	101	21.8398389697
87	183	3	0	3	95.5131096538
87	220	1	0	1	112.717168602
87	222	1	0	1	107.02440122
87	245	8	4	4	27.6429176588
87	248	1	0	1	31.0445415696
87	250	1	0	1	36.5378410126
87	256	1	0	1	24.4664517976
87	257	2	0	2	31.1618578722
87	264	1	0	1	36.9421616966
87	270	1	0	1	58.531776615
87	272	3	0	3	66.098036931
87	277	9	0	9	55.5143083708
87	283	1	0	1	50.4195120083
87	284	1	0	1	58.9030099873
87	291	1	0	1	68.0123773137
87	303	1	0	1	46.9651519374
87	305	1	0	1	44.2255210378
87	310	2	0	2	51.8412626769
87	314	1	0	1	55.0336725689
87	319	50	1	49	47.476362419
87	320	1	0	1	50.5439659286
87	321	3	0	3	42.2397315959
87	323	3	0	3	40.9216537171
87	325	3	0	3	56.0725813863
87	326	4	0	4	41.7124295544
87	327	1	0	1	52.6253558277
87	328	1	0	1	37.3219179938
87	329	11	0	11	35.4167454434
87	332	1	0	1	64.6421739701
87	338	13	1	12	54.6389444858
87	339	2	0	2	60.9410605756
87	341	1	0	1	59.8822796569
87	345	2	0	2	83.9274421849
87	347	1	0	1	32.8423951751
87	348	0	0	0	34.0108886427
87	349	6	0	6	45.9382108148
87	350	3	0	3	44.7066906599
87	353	8	3	5	41.8260202444
87	356	1	0	1	69.8803951064
87	361	0	0	0	56.3488526542
87	367	2	0	2	46.4734874573
87	368	1	0	1	78.0941900424
87	371	1	0	1	82.3680181698
87	375	6	0	6	76.5349936183
87	377	2	0	2	63.0303331578
87	379	1	0	1	70.132579698
87	385	2	0	2	67.3580578761
87	386	1	0	1	70.964633201
87	392	0	0	0	63.3189132482
87	394	1	0	1	74.754341926
87	396	1	0	1	77.7843806662
87	397	1	0	1	74.0346432689
87	399	0	0	0	83.3300232494
87	401	1	0	1	89.6908807668
87	406	4	0	4	84.7048463959
87	408	18	1	17	85.0339404133
87	411	1	0	1	81.59020155
87	412	0	0	0	94.5558594408
87	415	2	1	1	74.6717046246
87	417	1	0	1	76.3717871071
87	438	1	0	1	109.499075491
87	440	1	0	1	108.121055053
87	441	0	0	0	104.661239062
87	442	2	0	2	105.215948738
87	455	1	0	1	49.4641554647
87	460	1	0	1	61.1963991495
87	464	1	0	1	61.3357871672
87	466	1	0	1	75.7472813369
87	467	0	0	0	53.3107401119
87	469	1	0	1	62.266511644
87	477	0	0	0	68.168669663
87	479	2	0	2	58.2848800808
87	493	0	0	0	92.1561284472
87	496	2	0	2	64.0597641096
87	501	0	0	0	85.3116563203
87	503	4	0	4	73.0719212523
87	507	2	0	2	162.462657379
87	510	1	0	1	147.403974937
87	524	5	0	5	95.9324290749
87	536	0	0	0	115.920532608
87	537	0	0	0	110.935019423
87	540	1	0	1	122.444390874
87	551	0	0	0	64.63467304
87	554	0	0	0	80.7561219657
87	558	1	0	1	79.0717880451
87	563	6	0	6	68.3491389358
87	566	1	0	1	59.6859840203
87	568	0	0	0	43.6399299436
87	569	1	0	1	51.3081096731
87	573	41	8	33	53.1414748627
87	574	1	0	1	69.1862103701
87	575	0	0	0	59.5762009285
87	576	1	0	1	37.7067093035
87	577	3	1	2	46.5997433127
87	579	1	0	1	45.2489637929
87	581	7	6	1	38.0565419388
87	583	0	0	0	90.1613398581
87	585	2	0	2	67.5709090834
88	0	5	0	5	33.7282543927
88	1	43	1	42	47.3913492836
88	3	2	0	2	29.6090363064
88	5	1	0	1	53.377057451
88	7	2	0	2	36.1758615368
88	9	1	0	1	35.5073671046
88	13	8	0	8	32.5507122668
88	17	1	0	1	41.5371480259
88	28	3	0	3	44.5623117072
88	31	2	1	1	22.9218473422
88	32	4	0	4	32.5747899368
88	36	29	12	17	21.9811450783
88	39	1	0	1	27.8344760128
88	41	1	0	1	26.5425436576
88	42	1	0	1	25.336935352
88	45	1	0	1	63.3293400795
88	48	2	0	2	53.1962886124
88	50	1	0	1	45.771325856
88	57	1	0	1	54.9075756977
88	59	1	0	1	66.8546160128
88	60	1	0	1	48.2402354405
88	65	1	0	1	65.3677164677
88	68	1	0	1	43.3977965479
88	70	197	58	139	10.5464800318
88	71	281	183	98	2.3557110443
88	72	23	5	18	11.1221388871
88	73	3024	0	3024	6.65764227289
88	74	546	139	407	3.41327829076
88	75	305	233	72	4.85534991919
88	76	86	1	85	8.55988523802
88	77	17	4	13	10.5460508895
88	78	670	392	278	4.73550074241
88	79	30	18	12	10.2308160516
88	80	14	5	9	9.07837067878
88	81	122	3	119	9.15772814063
88	82	141	4	137	6.91214610984
88	83	115	43	72	5.75588238453
88	84	332	238	94	5.26540476405
88	85	225	5	220	7.34849375438
88	86	193	78	115	4.46350373925
88	87	924	352	572	2.03503017149
88	89	9	1	8	18.0893344554
88	90	10	9	1	13.3786511784
88	92	19	0	19	14.9018626169
88	95	44	0	44	13.4713002305
88	96	8	0	8	18.5904614221
88	98	5	5	0	7.81828852932
88	99	2	1	1	14.7739207609
88	100	1	0	1	20.1724230839
88	102	3	1	2	23.1353236975
88	103	184	61	123	7.96481094728
88	104	2	0	2	17.0073467302
88	105	1	0	1	19.1789958957
88	107	18	7	11	9.16537200283
88	109	11	3	8	14.7524466287
88	110	18	0	18	10.7621549078
88	111	4	0	4	20.2802808048
88	112	49	2	47	11.0491705777
88	113	336	114	222	5.41973302971
88	114	1	0	1	16.4755576269
88	116	12	0	12	10.3004116006
88	117	65	39	26	2.55395840482
88	118	7	0	7	9.81666436532
88	119	16	8	8	10.7846595251
88	120	12	0	12	12.8216773039
88	121	25	19	6	3.72011448261
88	122	0	0	0	19.7294560922
88	124	1	0	1	34.3845371444
88	127	3	1	2	11.978152784
88	129	1	0	1	18.5191854891
88	131	1	0	1	47.8177151567
88	133	2	0	2	20.293882676
88	134	1	0	1	16.8050215381
88	137	2	0	2	12.7258658139
88	140	19	2	17	10.9881092225
88	142	41	3	38	19.3075893435
88	143	1	0	1	27.6588588899
88	144	2	0	2	17.1741083682
88	145	1	0	1	24.8136749443
88	146	16	3	13	5.80980956859
88	147	1	0	1	35.1104550786
88	149	0	0	0	46.2322982711
88	154	1	0	1	23.4172352519
88	155	39	4	35	18.6176634105
88	156	4	0	4	20.2167623551
88	157	2	0	2	23.6549165636
88	158	2	0	2	24.2602746838
88	160	3	0	3	19.5255823129
88	163	5	1	4	31.4892646089
88	164	38	9	29	10.6568568843
88	165	2	1	1	25.007146968
88	166	18	5	13	27.1851888752
88	168	25	1	24	13.5682191115
88	169	7	1	6	23.6947740901
88	170	2	0	2	30.4536262306
88	171	54	0	54	13.7778876556
88	172	60	1	59	16.6076002878
88	173	2	0	2	29.7297953108
88	175	8	4	4	16.5941919114
88	177	97	22	75	19.8062946738
88	180	1	0	1	28.5416278359
88	183	2	0	2	97.100266105
88	190	1	0	1	96.6939520652
88	219	1	0	1	117.746834819
88	242	0	0	0	127.160566899
88	245	12	0	12	29.1485418494
88	251	1	0	1	30.7943670336
88	277	9	0	9	57.0994610968
88	281	1	0	1	48.9583529351
88	303	1	0	1	48.9884796049
88	304	2	0	2	37.8601393053
88	305	1	0	1	46.0822486341
88	309	1	0	1	37.478346691
88	310	1	0	1	51.7719975663
88	314	1	0	1	54.6992260707
88	315	1	0	1	53.7549210886
88	319	39	1	38	45.6099084595
88	320	0	0	0	48.5903551345
88	321	1	0	1	40.5278775608
88	323	2	0	2	38.9374969399
88	326	1	0	1	40.2329718191
88	327	2	0	2	50.8359507899
88	329	13	0	13	33.9545584465
88	331	0	0	0	33.7248495163
88	332	1	0	1	63.8779947659
88	334	1	0	1	62.8609133911
88	338	10	0	10	53.6447048118
88	341	4	0	4	59.2657483563
88	345	3	0	3	84.4840668501
88	347	1	0	1	31.9268958666
88	348	0	0	0	33.7019521766
88	349	8	2	6	44.6110492399
88	352	1	0	1	39.6533715612
88	353	5	0	5	41.003315332
88	357	1	0	1	50.5891117147
88	361	1	0	1	54.7387822126
88	375	7	0	7	76.7026853441
88	377	1	0	1	62.9676563904
88	379	1	0	1	68.5678082545
88	385	1	0	1	65.6607416871
88	386	0	0	0	69.2181884224
88	392	1	0	1	61.6741411615
88	406	3	0	3	83.5420200983
88	408	9	0	9	83.7623547185
88	411	3	0	3	80.2035804267
88	415	1	0	1	73.35015185
88	416	2	0	2	90.7602534503
88	427	1	0	1	97.378485941
88	435	1	0	1	99.628962651
88	439	1	0	1	116.412648777
88	441	0	0	0	103.264387233
88	444	1	0	1	106.920711105
88	455	0	0	0	47.9925555136
88	460	0	0	0	59.9315422261
88	465	1	0	1	68.9703615585
88	466	2	0	2	75.3246604573
88	469	0	0	0	61.8089229881
88	471	2	0	2	64.8976935035
88	474	1	0	1	82.4340097117
88	476	1	0	1	50.4709239638
88	485	1	0	1	93.5701472095
88	491	0	0	0	71.7491902572
88	493	0	0	0	91.8379243376
88	495	1	0	1	76.7152372397
88	496	0	0	0	63.1559499429
88	501	0	0	0	84.6736818463
88	503	4	0	4	72.0916491373
88	507	1	0	1	160.487790245
88	520	0	0	0	90.4598202411
88	536	1	0	1	113.887626676
88	548	0	0	0	161.548267318
88	551	0	0	0	62.6002045504
88	554	1	0	1	78.7849855563
88	555	0	0	0	73.7230683241
88	561	0	0	0	90.8971237017
88	562	1	0	1	85.5660948514
88	563	3	0	3	66.3381567543
88	567	1	0	1	63.8363017132
88	569	0	0	0	49.2766834574
88	572	1	0	1	58.7445269948
88	573	26	0	26	51.1584964668
88	577	2	0	2	44.5785771465
88	578	2	0	2	49.1919602944
88	579	2	0	2	43.2141164475
88	581	7	0	7	36.0412412677
89	0	3	0	3	27.5865454038
89	1	94	0	94	40.3084701051
89	3	16	1	15	23.4729507325
89	5	3	1	2	48.9813590643
89	7	2	0	2	31.5979383611
89	13	5	0	5	28.9317509728
89	15	2	0	2	34.3406800882
89	17	1	1	0	41.196761242
89	19	4	1	3	25.5602458266
89	21	2	0	2	44.6698053024
89	23	2	0	2	41.5862623451
89	24	3	0	3	39.4980084215
89	28	3	1	2	36.0929315234
89	30	1	0	1	38.0283372192
89	31	2	0	2	27.9133524103
89	32	7	2	5	21.0162400243
89	34	2	0	2	40.7801833192
89	35	1	0	1	34.3627457107
89	36	40	0	40	21.2828398383
89	38	1	0	1	33.5220109947
89	39	12	5	7	18.7367573405
89	41	2	0	2	28.3293444151
89	42	11	0	11	19.5247551321
89	50	4	0	4	51.4646229875
89	53	1	1	0	70.563334129
89	55	1	0	1	63.0532961954
89	60	1	1	0	54.866002098
89	69	1	0	1	58.6232252393
89	70	348	119	229	10.2707121938
89	71	49	27	22	19.0147286979
89	72	180	0	180	7.26558896193
89	73	1726	112	1614	11.8567665741
89	74	91	0	91	15.0497867546
89	75	122	0	122	14.240415076
89	76	75	18	57	12.8747964321
89	77	106	22	84	7.54564532043
89	78	239	88	151	14.7745161821
89	79	343	68	275	7.96346305385
89	80	57	13	44	9.07838220012
89	81	358	24	334	9.26287663736
89	82	119	3	116	12.5419927737
89	83	91	21	70	12.3382571167
89	84	215	58	157	13.0004286646
89	85	69	21	48	16.6054853667
89	86	44	26	18	19.3742991475
89	87	111	43	68	16.5510908667
89	88	46	31	15	18.0893344554
89	90	34	16	18	18.4741996862
89	92	389	27	362	6.14258775713
89	93	1	0	1	23.4538127305
89	94	5	1	4	16.3706719401
89	95	98	0	98	12.0379047648
89	96	78	6	72	20.1807143722
89	97	1	0	1	24.0484439445
89	98	7	2	5	23.2057542087
89	99	7	2	5	24.5005008769
89	100	7	0	7	14.4966595094
89	101	17	12	5	9.71533420722
89	102	28	0	28	12.2631369256
89	103	126	16	110	16.0476700204
89	104	76	42	34	9.23418952273
89	105	122	68	54	5.3754174282
89	106	54	14	40	6.59941339344
89	107	3	1	2	26.9407495984
89	108	1	0	1	18.7468795282
89	109	56	7	49	13.483647412
89	110	12	3	9	19.9567519567
89	111	264	6	258	5.8497807144
89	112	137	40	97	15.530065965
89	113	230	60	170	19.4380537002
89	114	2	0	2	18.7790094625
89	115	17	0	17	11.3467048992
89	116	21	6	15	14.2447399457
89	117	5	0	5	19.2337553403
89	118	6	1	5	17.9936543851
89	119	7	0	7	21.2495961562
89	120	136	14	122	6.59681876001
89	121	2	0	2	20.7210295816
89	122	28	5	23	11.0676885747
89	123	28	15	13	7.00451589109
89	124	1	0	1	46.3893742186
89	125	1	0	1	41.3957796606
89	127	1	0	1	28.3086905029
89	128	1	0	1	39.6814960468
89	129	8	0	8	25.5293026708
89	131	1	0	1	60.7279736554
89	133	2	0	2	30.5040223478
89	134	1	0	1	30.2420692196
89	135	2	0	2	48.5529404044
89	137	1	0	1	30.760525907
89	138	0	0	0	32.624390007
89	140	14	2	12	24.8712879951
89	142	65	10	55	34.521858332
89	145	0	0	0	36.6919564692
89	146	5	0	5	23.6917644416
89	154	1	0	1	41.2437460762
89	155	3	0	3	27.8086291401
89	156	7	0	7	25.7734033066
89	158	1	0	1	39.6448028869
89	163	1	0	1	49.4949787933
89	164	11	0	11	25.8655829137
89	166	5	0	5	35.4783559326
89	168	11	0	11	30.08962342
89	169	12	1	11	24.2144233863
89	171	10	0	10	25.6416775202
89	172	6	0	6	34.0355018926
89	177	2	0	2	35.9995798662
89	183	7	0	7	79.0113961921
89	187	0	0	0	80.2873461396
89	188	1	0	1	79.4818131353
89	190	1	0	1	78.7946481397
89	191	1	0	1	96.5891392563
89	196	0	0	0	94.8452006993
89	208	1	0	1	67.8252268306
89	212	3	0	3	57.1311877661
89	217	2	0	2	93.0315793775
89	220	1	0	1	96.1793900244
89	222	0	0	0	90.4880753281
89	229	2	0	2	75.9227357089
89	233	1	0	1	61.6317983266
89	242	0	0	0	109.630335885
89	244	1	0	1	109.692945926
89	245	163	6	157	11.0935802894
89	246	10	5	5	11.2743905805
89	247	1	1	0	26.0694066176
89	248	3	1	2	15.7843110931
89	249	1	0	1	23.0256466722
89	250	4	0	4	20.0115247062
89	251	18	2	16	17.3197656719
89	252	1	0	1	23.9545774341
89	253	2	1	1	29.0931424053
89	254	7	0	7	18.5386761852
89	256	11	0	11	11.6932012014
89	257	37	7	30	15.9854049388
89	258	2	0	2	19.7105060131
89	260	10	6	4	11.6449063665
89	262	5	1	4	26.0588203955
89	263	1	0	1	20.9872409714
89	264	2	0	2	21.7957058098
89	266	0	0	0	55.715289878
89	271	4	0	4	57.1727286565
89	272	2	0	2	49.8407906854
89	273	1	0	1	39.2647502656
89	276	1	0	1	37.2296425313
89	277	77	6	71	39.0113369561
89	281	1	0	1	31.00743521
89	282	4	0	4	34.0918993001
89	284	2	0	2	42.802836375
89	285	0	0	0	49.2654348006
89	286	2	1	1	29.5326265199
89	287	1	0	1	43.0885937058
89	292	1	1	0	48.1092552601
89	293	2	0	2	42.1398967669
89	294	1	0	1	46.158887338
89	296	0	0	0	34.3435943207
89	303	3	0	3	38.3222472579
89	304	2	0	2	28.3817057884
89	305	2	0	2	29.0028789964
89	306	1	0	1	36.4714049192
89	307	9	0	9	29.5965233577
89	310	1	0	1	43.0882838454
89	316	1	0	1	38.046562588
89	319	5	0	5	56.2454192641
89	323	1	0	1	52.0810903742
89	329	4	0	4	40.1091947808
89	330	1	0	1	61.4142890812
89	338	7	0	7	53.4168635367
89	341	0	0	0	55.0913233952
89	348	2	0	2	28.6719318522
89	350	4	0	4	34.5135553515
89	371	0	0	0	69.5909776964
89	397	1	0	1	90.3576998025
89	408	1	0	1	101.462009858
89	415	1	0	1	91.1545026711
89	419	1	0	1	111.594832458
89	425	1	0	1	121.196392173
89	431	1	0	1	125.522950582
89	465	0	0	0	84.3008221423
89	466	3	0	3	89.9315780244
89	469	3	0	3	76.6869434502
89	471	1	0	1	76.1117615897
89	473	1	0	1	69.4858428911
89	475	3	0	3	70.1675981801
89	478	0	0	0	95.3979698612
89	485	0	0	0	106.873205688
89	486	0	0	0	94.0193961108
89	491	1	0	1	84.9610999362
89	493	0	0	0	105.809831318
89	495	1	0	1	92.572803399
89	499	0	0	0	88.4935657332
89	503	2	0	2	89.0069618716
89	507	2	0	2	177.085142836
89	548	1	0	1	177.194629882
89	563	0	0	0	82.5278946936
89	573	2	0	2	67.9335407449
89	581	1	0	1	52.4338099179
90	0	1	0	1	42.8060389336
90	1	32	3	29	56.3838672213
90	5	3	0	3	63.7298385489
90	7	2	0	2	46.0634232711
90	13	3	1	2	42.7103523411
90	15	2	0	2	48.4801517081
90	19	1	0	1	41.4971521198
90	24	1	0	1	52.9843970315
90	27	1	0	1	62.0093217707
90	28	3	0	3	52.7616138755
90	31	1	0	1	35.499909677
90	32	1	0	1	38.5958824984
90	35	0	0	0	45.1496528237
90	36	18	0	18	32.6504211522
90	39	4	0	4	35.086621544
90	40	1	0	1	33.8190649914
90	41	1	0	1	38.3948026946
90	42	4	2	2	34.0848255878
90	46	1	0	1	72.5590568944
90	50	1	0	1	58.9209080679
90	66	0	0	0	61.5539062221
90	70	432	107	325	8.76052447019
90	71	60	44	16	11.6624817516
90	72	23	10	13	12.7208193531
90	73	1163	129	1034	14.581920608
90	74	90	2	88	11.2572898019
90	75	84	21	63	15.2002164707
90	76	231	9	222	7.25605287308
90	77	11	0	11	13.8001728019
90	78	273	14	259	9.58318060745
90	79	77	0	77	14.6681713397
90	80	18	9	9	12.620806293
90	81	135	17	118	11.7106621774
90	82	149	74	75	9.29205289083
90	83	54	21	33	12.4413930491
90	84	119	0	119	13.7353569462
90	85	540	288	252	6.05971847659
90	86	48	1	47	9.77055960349
90	87	88	9	79	14.1666862787
90	88	47	0	47	13.3786511784
90	89	37	15	22	18.4741996862
90	92	84	35	49	12.4014936616
90	93	1	0	1	22.0917607717
90	94	6	1	5	14.8926879379
90	95	27	3	24	22.2331070493
90	96	687	152	535	5.29205193915
90	97	2	0	2	18.9201368928
90	98	7	1	6	10.5487114827
90	99	1	0	1	27.9421070137
90	100	0	0	0	28.409379628
90	101	2	0	2	19.5370129229
90	102	2	0	2	28.9943567503
90	103	51	22	29	19.6615122752
90	104	6	2	4	23.4583010248
90	105	2	0	2	22.6701102946
90	107	17	10	7	16.4120001752
90	108	12	6	6	10.8775025496
90	109	287	32	255	5.75376178799
90	110	5	1	4	23.5046527526
90	111	32	1	31	16.4250427475
90	112	60	11	49	22.0439968706
90	113	138	48	90	18.6882914097
90	114	4	0	4	27.6758501077
90	115	5	2	3	17.3407471196
90	116	108	0	108	4.83428787364
90	117	6	1	5	15.9293931612
90	118	53	4	49	3.63390940107
90	119	275	67	208	5.10604224189
90	120	18	0	18	17.7158789782
90	121	2	0	2	16.9028713936
90	122	15	6	9	11.9721139587
90	128	2	0	2	33.9041096607
90	129	6	0	6	31.3528230957
90	133	0	0	0	33.6441579419
90	134	1	0	1	30.066097516
90	135	0	0	0	40.5320226191
90	136	1	0	1	40.3812289261
90	140	5	0	5	24.3390148189
90	142	48	3	45	31.9475124768
90	143	1	0	1	39.8055280767
90	146	4	1	3	17.5351290896
90	147	3	0	3	45.5195343517
90	152	1	0	1	45.9899797853
90	155	56	2	54	9.35193663775
90	156	16	9	7	7.96957512592
90	158	1	0	1	22.9633515932
90	162	3	1	2	12.4042547178
90	163	2	0	2	39.3816112857
90	164	13	0	13	11.5760071743
90	166	19	4	15	17.2006730173
90	167	1	0	1	36.7243566882
90	168	8	3	5	16.0890742001
90	169	20	7	13	10.3186174777
90	170	1	0	1	26.2428773695
90	171	57	22	35	8.46461409246
90	172	9	3	6	20.8646490078
90	175	4	1	3	13.5615288126
90	177	12	0	12	20.5081058161
90	183	0	0	0	93.4773187636
90	188	3	0	3	91.9134736554
90	198	1	0	1	113.857850639
90	208	2	1	1	73.175026042
90	213	1	0	1	79.8254509737
90	217	0	0	0	105.117716095
90	220	1	0	1	109.018275469
90	239	1	0	1	81.313154622
90	245	21	6	15	27.114872837
90	246	1	0	1	22.8550618767
90	247	1	0	1	28.1780111327
90	251	1	0	1	22.5233930812
90	254	1	0	1	31.0872228971
90	256	1	0	1	29.9650803685
90	257	1	0	1	34.2081142432
90	258	1	0	1	38.1644952473
90	262	1	0	1	40.6808766093
90	275	2	0	2	60.3444554155
90	277	41	3	38	54.1528327483
90	281	1	0	1	44.841411405
90	282	2	0	2	46.6085898685
90	293	2	0	2	49.2191049962
90	294	1	0	1	48.8637246317
90	296	0	0	0	38.6212002809
90	304	1	0	1	45.3253876595
90	305	1	0	1	46.8928255197
90	307	4	0	4	48.03322757
90	309	1	0	1	43.0946637639
90	310	3	0	3	39.2658037358
90	319	18	2	16	37.8143329848
90	320	1	0	1	42.2681800545
90	321	1	0	1	31.0357366859
90	323	1	0	1	33.8116311195
90	324	1	0	1	38.1864053431
90	326	2	0	2	28.9316528858
90	329	9	0	9	22.6899570148
90	334	1	1	0	49.6926912688
90	338	8	0	8	40.5088876801
90	341	1	0	1	45.8989105085
90	347	0	0	0	18.6866466498
90	348	8	1	7	20.7863627632
90	349	2	0	2	32.4655753847
90	350	2	0	2	33.2744670184
90	351	2	0	2	30.3605308645
90	353	2	0	2	27.6667445728
90	375	3	0	3	64.7442733898
90	396	1	0	1	85.1325346276
90	406	1	0	1	92.1981755733
90	408	0	0	0	91.7467121668
90	424	1	0	1	138.33499393
90	435	1	0	1	107.259897372
90	452	1	0	1	73.00489993
90	464	3	0	3	74.2990983439
90	465	0	0	0	80.3849453835
90	466	1	0	1	87.1629735931
90	468	0	0	0	59.9112781086
90	469	1	0	1	73.6103679385
90	472	1	0	1	67.5932077755
90	476	1	0	1	63.6077469076
90	478	0	0	0	91.7117841893
90	480	1	0	1	75.5022961157
90	487	0	0	0	91.3619034528
90	491	1	0	1	84.2827816475
90	494	1	0	1	70.9204457052
90	503	1	0	1	81.8167323276
90	551	0	0	0	59.9619687521
90	555	0	0	0	71.855407662
90	566	0	0	0	60.877963994
90	573	1	0	1	51.6052324217
90	581	1	0	1	36.060331409
91	1	3	0	3	68.0991369354
91	7	1	0	1	60.7266770768
91	28	1	0	1	63.3864396891
91	32	1	0	1	48.0210047126
91	36	2	0	2	50.7257500731
91	39	1	0	1	47.4019454314
91	70	22	8	14	28.5868195095
91	71	4	1	3	37.282501765
91	72	2	0	2	30.6628744355
91	73	106	11	95	36.0157371315
91	74	7	2	5	35.2527574124
91	75	5	0	5	37.881558242
91	76	17	2	15	29.8850325795
91	78	18	2	16	33.6710003658
91	79	2	0	2	33.3267889751
91	81	6	0	6	31.5582055799
91	82	13	0	13	31.8832991275
91	83	3	0	3	34.6259985983
91	84	8	0	8	36.0763489333
91	85	13	4	9	31.4608108729
91	86	9	1	8	35.7621733759
91	87	4	1	3	38.2970628963
91	88	5	0	5	38.3496746056
91	89	8	0	8	29.5667979933
91	90	8	4	4	26.4021841727
91	92	2	0	2	26.4855669078
91	93	10	3	7	6.11903407998
91	94	6	3	3	13.9141728175
91	95	2	0	2	40.6416712328
91	96	27	8	19	21.5405148806
91	97	16	1	15	7.48280874265
91	101	1	0	1	20.6793826711
91	103	3	0	3	41.8386835437
91	106	1	0	1	32.997079851
91	108	1	0	1	15.623180464
91	109	3	0	3	23.601799656
91	111	1	0	1	23.7180360937
91	112	1	0	1	42.8823241684
91	113	3	0	3	42.8764927013
91	115	0	0	0	18.2769171936
91	116	3	0	3	28.0762783538
91	120	0	0	0	34.5299592302
91	122	3	0	3	19.8855905002
91	128	1	0	1	60.2289118049
91	142	1	0	1	57.639590556
91	146	1	0	1	43.4497846518
91	155	4	1	3	30.0654352008
91	156	4	1	3	25.0365126032
91	162	1	0	1	24.1621762736
91	166	1	0	1	30.9136984771
91	168	1	0	1	41.8088597935
91	169	1	0	1	18.344235755
91	171	4	2	2	33.1993524472
91	172	1	0	1	46.5588970682
91	173	1	0	1	50.5781507649
91	177	2	0	2	44.7586355353
91	183	1	0	1	77.30938704
91	225	1	0	1	56.1736477144
91	245	4	0	4	27.7410505105
91	247	43	0	43	7.91964179991
91	249	2	0	2	17.9882362112
91	250	1	0	1	28.4234837441
91	251	7	0	7	13.8161180594
91	253	1	0	1	19.5996650628
91	257	1	0	1	36.9520483258
91	277	8	1	7	42.972585887
91	281	1	0	1	33.2333167596
91	282	1	0	1	32.259218257
91	293	1	0	1	27.0396120684
91	300	1	0	1	12.5110580333
91	307	1	0	1	51.9893452614
91	310	16	3	13	13.7482453258
91	315	1	0	1	16.4573929562
91	316	1	0	1	14.9038778006
91	319	1	0	1	47.9372486298
91	328	1	0	1	38.5254206692
91	338	1	0	1	28.8602016757
91	347	3	1	2	18.1727763316
91	348	21	2	19	7.81582394074
91	350	17	8	9	6.98274011202
91	351	1	0	1	25.7438842273
91	352	0	0	0	7.15022515038
91	353	3	1	2	17.7386318308
91	371	1	0	1	45.421835089
91	375	1	0	1	38.4249354869
91	377	0	0	0	24.8373933657
91	392	0	0	0	91.0583273367
91	406	1	0	1	118.01016421
91	471	1	0	1	102.919201791
91	488	1	0	1	116.868944752
91	581	1	0	1	57.5062756714
92	0	10	3	7	32.6920383432
92	1	100	15	85	45.8056944893
92	2	2	0	2	39.9944569772
92	3	8	1	7	28.447118369
92	7	1	0	1	36.4654758583
92	9	1	0	1	33.1448494952
92	11	1	0	1	62.8532523928
92	13	7	0	7	33.5077120878
92	15	4	0	4	39.1166855325
92	16	1	0	1	29.1403570902
92	17	1	0	1	45.2697084283
92	18	1	0	1	29.7962925955
92	19	6	0	6	30.9150411637
92	23	1	0	1	46.3014567438
92	24	1	0	1	44.0864729003
92	26	1	0	1	50.5646646392
92	28	2	0	2	41.7717072693
92	29	1	0	1	59.3158250335
92	31	1	0	1	30.0809573764
92	32	6	1	5	26.940114135
92	34	1	0	1	42.7506611902
92	35	3	1	2	37.9002240716
92	36	52	6	46	24.7102188158
92	39	8	1	7	24.1735404453
92	41	3	0	3	31.4635367466
92	42	6	3	3	24.2348067142
92	43	1	0	1	80.038319001
92	48	0	0	0	63.0516572688
92	50	4	0	4	54.042996589
92	55	1	0	1	65.8351807219
92	61	1	0	1	74.8416135467
92	65	2	0	2	72.3448637138
92	70	1290	779	511	4.95652629253
92	71	81	11	70	15.1411343189
92	72	257	115	142	4.403867223
92	73	2726	898	1828	10.1797176503
92	74	171	68	103	11.5135156801
92	75	180	0	180	12.4318247469
92	76	172	6	166	7.70186303865
92	77	100	1	99	5.8067959693
92	78	351	30	321	10.6398436555
92	79	323	254	69	6.91505188658
92	80	79	35	44	6.43033870321
92	81	536	42	494	5.94168999974
92	82	216	111	105	8.22628457466
92	83	105	56	49	9.52299746862
92	84	279	108	171	10.7341591117
92	85	226	14	212	11.4082091681
92	86	82	3	79	14.9229075954
92	87	192	90	102	13.9032662988
92	88	66	2	64	14.9018626169
92	89	406	359	47	6.14258775713
92	90	95	27	68	12.4014936616
92	93	1	0	1	20.574620063
92	94	9	2	7	12.6034403593
92	95	82	35	47	14.2663992394
92	96	185	0	185	14.1202372506
92	97	5	0	5	20.0632772433
92	98	3	2	1	18.3908307558
92	99	5	0	5	24.9285234063
92	101	18	13	5	9.98849994041
92	102	18	0	18	17.7512235642
92	103	142	0	142	15.7448462351
92	104	20	1	19	13.2984674841
92	105	23	18	5	10.9393676914
92	106	4	0	4	12.6991420265
92	107	12	2	10	22.9061634257
92	108	5	0	5	13.5567587986
92	109	153	68	85	7.36013388783
92	110	15	0	15	20.0867917921
92	111	184	8	176	5.4168486007
92	112	137	0	137	16.4385389226
92	113	246	0	246	17.8531831016
92	114	6	1	5	21.0334539485
92	115	30	4	26	9.74140039671
92	116	45	0	45	8.47876976584
92	117	13	1	12	16.7029149978
92	118	8	2	6	12.3193103846
92	119	18	7	11	15.5944171041
92	120	83	26	57	8.2088358605
92	121	5	0	5	18.2027695185
92	122	105	55	50	6.63938191249
92	123	7	2	5	10.0348936465
92	125	1	0	1	42.2293102009
92	128	2	0	2	37.5586325698
92	129	5	0	5	26.9220008555
92	131	1	0	1	60.8349961976
92	132	0	0	0	63.1239177974
92	133	3	0	3	31.1108009729
92	134	3	0	3	29.6586116541
92	140	10	2	8	23.8652698622
92	141	0	0	0	59.2125510985
92	142	84	0	84	33.2904470763
92	144	3	0	3	32.0378003507
92	145	2	0	2	36.9005731068
92	146	2	0	2	20.711289207
92	147	3	1	2	49.948455056
92	149	0	0	0	60.9474692438
92	154	1	0	1	38.2787719654
92	155	15	0	15	21.7529039139
92	156	11	0	11	19.6329967825
92	157	0	0	0	37.0639256229
92	159	1	0	1	31.2452826363
92	162	1	0	1	23.5062872262
92	163	0	0	0	46.1880036993
92	164	6	0	6	20.8140301295
92	166	10	0	10	29.3375951527
92	167	1	0	1	46.0959092238
92	168	8	1	7	25.2599311486
92	169	14	0	14	18.4002682039
92	171	16	0	16	19.9321115112
92	172	13	7	6	29.535932008
92	175	2	0	2	24.8669130988
92	177	15	0	15	30.8910147698
92	180	1	0	1	40.9184268986
92	183	5	0	5	83.1296461921
92	186	2	0	2	76.2413011588
92	187	0	0	0	83.0709332397
92	188	1	0	1	82.7657514289
92	194	1	0	1	88.4306224624
92	206	1	0	1	60.9442118083
92	207	1	0	1	65.0609803372
92	208	2	0	2	68.3596753085
92	211	1	0	1	76.1428535018
92	213	1	0	1	74.487441696
92	214	1	0	1	60.968601249
92	219	1	0	1	103.039574972
92	220	4	1	3	99.6679539525
92	222	0	0	0	94.4129110339
92	229	5	0	5	77.7466025795
92	231	1	0	1	59.0787008443
92	232	0	0	0	66.7423288963
92	237	1	0	1	61.1906045074
92	242	1	0	1	112.327178434
92	243	1	0	1	106.975882799
92	245	71	23	48	15.4133137989
92	246	9	0	9	12.8734616071
92	247	6	2	4	24.5791397363
92	248	1	0	1	17.2445977411
92	249	2	0	2	24.0427626363
92	250	1	0	1	23.7938520394
92	251	42	4	38	16.3668234257
92	252	2	1	1	26.5625237729
92	253	5	0	5	30.1118956686
92	254	11	0	11	21.1825710162
92	256	3	1	2	17.8094539311
92	257	7	0	7	21.8322590519
92	260	4	1	3	17.457241471
92	262	5	1	4	29.9419930262
92	264	2	0	2	27.5552291151
92	271	2	0	2	60.6429950181
92	272	1	0	1	52.5581359655
92	275	2	0	2	48.9397941472
92	276	2	0	2	39.3759271386
92	277	86	0	86	43.2767544575
92	279	2	0	2	38.3153447676
92	280	1	0	1	50.7298938028
92	281	0	0	0	34.5820001041
92	282	6	0	6	37.1073262996
92	284	1	0	1	45.2572195898
92	286	1	0	1	32.0774980959
92	287	1	0	1	46.2659039512
92	291	1	0	1	54.2123708418
92	293	1	0	1	43.0321041517
92	294	1	0	1	45.5060695797
92	303	2	0	2	44.3031134728
92	304	2	0	2	34.1208908105
92	305	2	0	2	34.6468027312
92	307	8	0	8	35.7345630698
92	309	4	1	3	31.1857372397
92	310	4	0	4	40.2297914432
92	317	0	0	0	48.4252029457
92	319	18	6	12	50.1185243318
92	323	2	0	2	46.1432127316
92	327	1	0	1	53.9324604761
92	329	11	0	11	34.0262500577
92	334	1	0	1	57.0703405279
92	338	2	0	2	48.2554045344
92	341	1	0	1	50.879155742
92	345	1	0	1	70.3072844276
92	346	1	0	1	92.3216511763
92	347	2	0	2	27.1434720753
92	348	5	0	5	24.2304797748
92	349	8	0	8	42.5925233728
92	350	4	0	4	32.2389334402
92	351	2	0	2	39.5175620509
92	352	1	0	1	29.8625053172
92	353	3	0	3	34.7785451914
92	354	0	0	0	32.5509850963
92	367	2	0	2	45.1454108904
92	371	1	0	1	69.0027090784
92	375	1	0	1	63.8379907344
92	386	0	0	0	82.8861364707
92	403	1	0	1	108.247829571
92	408	2	0	2	98.6106678325
92	411	0	0	0	94.930585665
92	441	1	0	1	117.965063133
92	460	0	0	0	74.7912954022
92	465	0	0	0	83.3064573853
92	466	1	0	1	89.3464422325
92	467	0	0	0	67.0295245494
92	469	3	0	3	75.925708515
92	471	3	0	3	77.0081926603
92	472	1	0	1	68.4151273767
92	475	2	0	2	68.2474888565
92	476	0	0	0	62.7020707177
92	477	0	0	0	81.5945922194
92	480	2	0	2	76.2800571699
92	487	1	0	1	89.8334254247
92	495	1	0	1	91.2738108389
92	503	2	0	2	86.9507878201
92	507	1	0	1	171.672551115
92	573	2	0	2	62.752207963
92	577	1	0	1	52.8397175584
92	579	1	0	1	52.6629040727
92	581	2	0	2	47.1873415683
93	0	2	0	2	50.4156418985
93	1	9	1	8	62.1491678284
93	17	2	0	2	64.6211220754
93	36	6	1	5	44.6406517156
93	70	102	2	100	23.0539888447
93	71	15	7	8	32.2971113943
93	72	12	1	11	24.8370895646
93	73	563	0	563	30.3296619628
93	74	33	0	33	29.940994702
93	75	33	0	33	32.2971457367
93	76	61	0	61	24.6066645292
93	77	3	0	3	26.3270031248
93	78	57	0	57	28.429592959
93	79	21	6	15	27.4656308722
93	80	2	0	2	26.6111083463
93	81	41	5	36	25.8622464582
93	82	51	5	46	26.4877036219
93	83	22	1	21	29.0684682138
93	84	38	1	37	30.4943866555
93	85	15	0	15	26.5843155324
93	86	21	7	14	30.953660634
93	87	11	1	10	32.9281584671
93	88	9	0	9	33.1569157699
93	89	36	2	34	23.4538127305
93	90	29	0	29	22.0917607717
93	91	8	1	7	6.11903407998
93	92	49	0	49	20.574620063
93	94	34	6	28	8.19972323999
93	95	6	1	5	34.6334984397
93	96	250	129	121	17.7777915292
93	97	64	37	27	4.78234612391
93	101	3	0	3	14.6219667481
93	102	1	0	1	35.0911347027
93	103	15	2	13	36.1151275979
93	105	4	0	4	28.5992722276
93	107	1	0	1	38.3861189451
93	108	25	8	17	11.2770354682
93	109	49	0	49	18.471829688
93	110	3	0	3	40.4874576308
93	111	19	2	17	17.6068819592
93	112	17	1	16	37.010745389
93	113	23	8	15	37.431598457
93	114	3	1	2	41.4816028222
93	115	15	2	13	12.1582717008
93	116	10	0	10	23.0298794987
93	117	1	0	1	35.5072024211
93	118	1	0	1	25.210010796
93	119	8	4	4	27.1711864569
93	120	3	0	3	28.5252085629
93	121	5	2	3	36.85903704
93	122	19	11	8	14.0632899748
93	123	1	0	1	19.0589071323
93	140	3	0	3	43.5654469363
93	141	1	0	1	75.5504719286
93	142	19	2	17	52.4555362974
93	147	1	0	1	67.3974885032
93	155	4	0	4	27.3057415824
93	163	0	0	0	61.4596396644
93	164	2	1	1	33.6122910945
93	166	1	0	1	29.8198067572
93	169	4	0	4	15.8778616813
93	172	3	0	3	42.8033856265
93	175	2	0	2	34.2670476704
93	177	2	0	2	41.6066237723
93	179	1	0	1	13.5058694068
93	183	3	0	3	76.4938343293
93	187	0	0	0	71.4352320282
93	191	0	0	0	86.0138236919
93	206	1	0	1	44.8402324586
93	208	1	1	0	51.1564557308
93	212	1	0	1	43.5698936889
93	220	1	0	1	90.0285092747
93	245	56	0	56	22.079340866
93	246	5	0	5	15.6501833692
93	247	144	92	52	6.61427147179
93	248	5	0	5	14.6670735548
93	249	3	0	3	14.7030622772
93	250	2	0	2	23.9038563274
93	251	109	16	93	8.23168430351
93	252	1	0	1	21.3224502397
93	253	7	0	7	18.0977476268
93	254	3	1	2	18.9301719787
93	257	6	1	5	31.3861878897
93	262	2	0	2	28.1146218222
93	263	1	0	1	27.4569349826
93	264	1	0	1	35.1384686608
93	266	1	0	1	57.4414362248
93	276	1	0	1	28.8893859291
93	277	22	7	15	40.2217966179
93	281	1	0	1	30.2947359961
93	282	1	0	1	30.1347996523
93	284	1	0	1	34.9342391562
93	293	3	1	2	28.1212070917
93	296	5	0	5	16.9365280034
93	297	0	0	0	32.3619416529
93	300	5	0	5	12.1556586711
93	303	1	0	1	58.0975072066
93	310	10	1	9	19.7248979585
93	319	2	0	2	48.5475784823
93	329	2	0	2	29.9295457441
93	336	1	0	1	26.04868983
93	338	4	0	4	33.4328084176
93	347	0	0	0	18.6963829912
93	348	22	16	6	8.8764656038
93	350	7	1	6	11.7939677131
93	352	2	0	2	11.7647750682
93	353	1	0	1	21.0712045059
93	354	0	0	0	25.0973164421
93	357	1	0	1	40.5475210992
93	375	2	0	2	43.6115227986
93	466	1	0	1	108.449484305
93	469	1	0	1	94.9165567649
93	475	1	0	1	85.6809480943
93	489	0	0	0	120.369582604
93	581	1	0	1	55.4399631545
94	1	11	0	11	56.2968055847
94	5	1	0	1	65.2594163059
94	7	1	0	1	47.9605106934
94	12	1	0	1	66.1401441676
94	13	1	0	1	45.2910621409
94	18	1	0	1	41.605103789
94	19	1	0	1	41.7624199456
94	29	0	0	0	71.5076484663
94	35	0	0	0	50.3106100154
94	36	8	1	7	37.1124514986
94	41	2	1	1	43.975924123
94	42	1	0	1	35.8880674317
94	48	0	0	0	75.6015720411
94	50	1	0	1	66.6462539905
94	55	1	0	1	78.4329912576
94	70	173	17	156	14.8553696259
94	71	15	1	14	24.293785924
94	72	13	1	12	16.7487599366
94	73	443	96	347	22.1556438114
94	74	17	5	12	21.7833386172
94	75	26	4	22	24.1004483359
94	76	46	21	25	16.4790658115
94	77	9	1	8	18.2607484296
94	78	53	7	46	20.3040462164
94	79	29	1	28	19.414594433
94	80	2	0	2	18.4587340926
94	81	54	11	43	17.689165972
94	82	40	6	34	18.3103374261
94	83	16	5	11	20.8691018837
94	84	27	1	26	22.2969722147
94	85	27	8	19	18.7034417196
94	86	15	4	11	23.0818041837
94	87	8	0	8	24.7490567941
94	88	8	0	8	25.0389470724
94	89	64	26	38	16.3706719401
94	90	87	0	87	14.8926879379
94	91	2	0	2	13.9141728175
94	92	90	26	64	12.6034403593
94	93	12	7	5	8.19972323999
94	95	12	0	12	26.8346070279
94	96	487	119	368	11.6488534048
94	97	40	2	38	7.68091367971
94	98	1	0	1	25.0776531194
94	99	1	0	1	37.1905308487
94	101	8	3	5	9.50105850903
94	102	1	0	1	28.5153817934
94	103	14	0	14	27.9596708351
94	104	4	0	4	25.2953584139
94	105	3	0	3	21.7198673895
94	106	1	0	1	21.0501963943
94	108	57	21	36	5.47515496974
94	109	112	42	70	10.5065972479
94	110	1	0	1	32.3319313009
94	111	37	1	36	10.673707104
94	112	26	0	26	28.9696431469
94	113	30	4	26	29.2360146049
94	115	22	0	22	6.2975999977
94	116	21	0	21	15.0594753116
94	118	4	1	3	17.625129853
94	119	13	5	8	19.9783670911
94	120	5	0	5	20.7338851655
94	121	1	0	1	28.7255901432
94	122	122	2	120	5.9768515655
94	123	2	0	2	13.7669297988
94	131	0	0	0	72.561728038
94	133	0	0	0	43.359508035
94	134	2	0	2	41.2844970913
94	135	1	0	1	54.8891986612
94	137	0	0	0	36.3085873299
94	140	1	0	1	35.3702688234
94	142	20	1	19	44.3130116987
94	147	0	0	0	59.5788616757
94	155	7	1	6	21.8139626266
94	156	1	0	1	17.3990047847
94	162	1	0	1	19.1598471488
94	163	1	0	1	54.1131540952
94	164	1	0	1	26.4387168781
94	166	5	0	5	26.3845977849
94	168	2	0	2	30.9789835889
94	169	7	2	5	12.1036403735
94	171	4	0	4	23.0611705028
94	177	0	0	0	35.1993786811
94	183	3	0	3	79.9545873907
94	188	2	0	2	77.5680501154
94	196	1	0	1	86.7711126341
94	202	1	0	1	83.2771429695
94	204	0	0	0	45.4516881581
94	208	2	0	2	58.4885580058
94	211	1	0	1	66.2070796611
94	212	1	0	1	49.9874463005
94	213	1	0	1	65.0447379046
94	224	1	0	1	60.691796876
94	225	1	0	1	64.4297927207
94	229	1	0	1	69.7476989299
94	245	46	19	27	18.3165975933
94	246	5	0	5	12.0283615299
94	247	10	3	7	13.485265478
94	248	1	0	1	13.6044861134
94	251	85	0	85	8.13304416447
94	252	2	0	2	22.7407531249
94	254	1	0	1	18.6156218869
94	255	1	0	1	29.553952268
94	257	4	0	4	27.4327959381
94	260	1	0	1	23.5903292955
94	262	5	0	5	28.5411710267
94	271	1	0	1	56.3335908389
94	272	1	0	1	46.8526404818
94	275	1	0	1	48.6035501446
94	277	25	0	25	41.7050919753
94	281	2	1	1	31.9141556957
94	282	5	0	5	32.9187266118
94	284	1	0	1	39.3295878184
94	287	1	0	1	41.8408775952
94	292	1	0	1	42.2083090714
94	293	1	0	1	34.3271630544
94	296	2	0	2	23.8272637445
94	297	1	0	1	39.795029456
94	307	0	0	0	42.6972766213
94	309	2	0	2	39.9210469919
94	310	3	0	3	27.6614207441
94	319	1	0	1	46.6312101277
94	329	2	0	2	28.4725140323
94	338	1	0	1	37.565749032
94	347	1	0	1	18.615743766
94	348	8	1	7	12.3855355698
94	350	2	0	2	19.9936826367
94	352	1	0	1	17.5812465454
94	353	2	0	2	24.2313997227
94	367	1	0	1	38.5319774705
94	375	0	0	0	51.8059627867
94	392	0	0	0	81.8184042416
94	406	1	0	1	106.933402306
94	463	1	0	1	107.483837267
94	465	0	0	0	93.9419591456
94	466	1	0	1	100.362088855
94	469	1	0	1	86.8411335114
94	471	1	0	1	89.1476302158
94	480	1	0	1	87.8515735836
94	482	0	0	0	114.89293942
94	492	0	0	0	107.526212439
94	501	0	0	0	109.563679184
94	505	1	0	1	112.982403816
94	524	0	0	0	108.803285295
95	0	16	3	13	20.8288839333
95	1	200	0	200	34.5305487174
95	2	1	0	1	26.4656066523
95	3	6	0	6	16.5639636662
95	5	1	0	1	41.5028490867
95	7	10	0	10	23.8608023262
95	10	1	0	1	23.7088547233
95	12	2	0	2	43.5451417713
95	13	19	0	19	20.4773247499
95	14	1	0	1	22.0625373535
95	15	3	0	3	26.2479058669
95	16	2	0	2	18.312281772
95	18	6	1	5	16.8794905767
95	19	6	0	6	19.9293392909
95	21	1	0	1	36.717641074
95	23	2	0	2	33.172908765
95	24	3	0	3	30.8033064207
95	28	7	1	6	31.3534195625
95	31	8	2	6	16.0213194604
95	32	17	2	15	19.1963996805
95	33	5	2	3	19.3697739672
95	35	5	0	5	23.7468674408
95	36	148	29	119	10.6724598586
95	37	0	0	0	30.4786803758
95	38	2	0	2	21.6800590983
95	39	24	1	23	14.3631919783
95	40	1	0	1	15.6216561485
95	41	9	0	9	17.2176649758
95	42	19	2	17	12.1691336338
95	45	1	0	1	61.2063929592
95	46	4	0	4	51.6094420495
95	47	2	0	2	61.6639689435
95	48	2	0	2	49.1646476706
95	49	1	0	1	36.4195347343
95	50	5	2	3	39.8669447475
95	53	1	0	1	61.3953714321
95	58	1	0	1	58.5561965127
95	60	1	0	1	43.1243386348
95	68	1	0	1	39.677028267
95	70	252	119	133	14.1408155308
95	71	60	43	17	15.5814391698
95	72	40	0	40	10.6189036829
95	73	2410	949	1461	7.97142742729
95	74	136	65	71	12.4910741917
95	75	278	123	155	8.71165131143
95	76	84	2	82	14.9790746369
95	77	34	9	25	9.12200631745
95	78	280	87	193	13.6156017193
95	79	270	0	270	7.99778433886
95	80	29	12	17	9.79858841757
95	81	228	49	179	10.7563307338
95	82	108	30	78	13.0086341542
95	83	108	0	108	10.1192443127
95	84	326	289	37	9.2366327379
95	85	79	2	77	17.2563631928
95	86	66	26	40	17.2011782051
95	87	246	21	225	11.4395072527
95	88	70	0	70	13.4713002305
95	89	114	6	108	12.0379047648
95	90	27	0	27	22.2331070493
95	92	82	12	70	14.2663992394
95	94	1	0	1	26.8346070279
95	96	28	1	27	26.1857362523
95	97	1	0	1	34.3290262286
95	98	6	0	6	21.0918045527
95	99	18	1	17	12.9113601562
95	100	61	0	61	6.73639476783
95	101	1	0	1	21.7058836063
95	102	78	42	36	10.1432222695
95	103	417	197	220	6.65279494406
95	104	161	0	161	4.64317111354
95	105	22	10	12	9.09977741883
95	106	4	3	1	13.8576472009
95	107	13	0	13	22.1880047569
95	108	3	0	3	27.4837384754
95	109	38	7	31	19.7783840122
95	110	64	4	60	8.98504594442
95	111	27	2	25	17.4126904883
95	112	950	618	332	4.32809269103
95	113	560	24	536	11.2274405886
95	114	39	38	1	6.8631936074
95	115	3	0	3	22.9244847811
95	116	18	0	18	17.454101366
95	117	7	0	7	12.8834587297
95	118	3	0	3	19.7805138317
95	119	10	1	9	22.2611969115
95	120	104	57	47	6.11171301932
95	121	6	0	6	13.9304837879
95	122	10	0	10	20.897654218
95	123	4	0	4	18.8382777507
95	124	0	0	0	34.5395004109
95	125	1	0	1	29.4105015472
95	128	2	1	1	30.2378305213
95	129	7	2	5	13.500883991
95	130	0	0	0	34.9037807263
95	131	1	0	1	48.918468985
95	133	3	0	3	18.6669576608
95	134	7	3	4	19.3063431473
95	135	1	0	1	39.622481771
95	136	1	0	1	29.8586970777
95	137	4	0	4	23.8733203555
95	138	1	0	1	20.5875634592
95	140	22	0	22	14.8024852592
95	141	1	0	1	52.5465840386
95	142	126	23	103	24.1195407305
95	143	4	1	3	32.4606474777
95	144	1	0	1	25.8194850658
95	145	3	1	2	24.9789988922
95	146	9	0	9	17.176682481
95	147	1	0	1	42.3335430496
95	148	1	0	1	25.2674164499
95	151	0	0	0	41.8921113907
95	154	2	0	2	33.0781917823
95	155	9	0	9	30.2247312174
95	156	7	1	6	30.1841566385
95	157	1	0	1	36.1612216542
95	158	1	0	1	37.7315670914
95	160	1	0	1	30.9065433904
95	163	0	0	0	41.6383213943
95	164	11	4	7	23.9981184053
95	165	1	0	1	38.3366091335
95	166	4	0	4	38.8005618562
95	167	1	0	1	45.1335991047
95	168	10	0	10	27.0125981988
95	169	7	2	5	31.1833291
95	171	21	8	13	26.199156398
95	172	13	1	12	29.6585240134
95	175	1	0	1	29.7859033326
95	176	3	0	3	50.0308836853
95	177	22	17	5	33.2435882501
95	183	3	0	3	87.4412164759
95	186	1	0	1	82.4939641649
95	187	1	0	1	90.6075599552
95	188	1	0	1	89.2080830504
95	190	1	0	1	85.8895427996
95	194	1	0	1	96.6649650531
95	198	1	0	1	118.553396678
95	208	1	0	1	79.690752955
95	209	1	0	1	78.071563653
95	212	2	1	1	68.6980988209
95	220	2	0	2	105.530988999
95	225	3	0	3	82.1216341581
95	229	1	0	1	87.1169499368
95	236	1	0	1	71.2584168493
95	242	0	0	0	119.933797635
95	243	1	0	1	114.292842966
95	245	31	4	27	21.5684082295
95	246	0	0	0	23.2484886415
95	247	2	0	2	37.909051355
95	248	1	0	1	27.6912932963
95	250	3	0	3	30.2857192377
95	251	2	0	2	29.2259505991
95	254	4	0	4	29.8681036738
95	256	4	0	4	14.5027661536
95	257	5	1	4	22.0455351067
95	258	3	0	3	22.2242352563
95	260	2	0	2	18.8095400747
95	262	2	0	2	35.8915725413
95	264	4	0	4	27.4696668681
95	267	1	0	1	59.9963094316
95	270	1	0	1	48.7460290567
95	273	1	0	1	49.7614807274
95	276	1	0	1	48.4615390498
95	277	32	0	32	47.7888881608
95	281	0	0	0	41.0461795686
95	282	3	0	3	44.6615178142
95	291	3	0	3	63.3526108145
95	293	1	0	1	53.9604178971
95	303	5	1	4	35.5433266492
95	305	4	0	4	34.5697194722
95	307	7	3	4	30.824250645
95	309	8	2	6	24.1207769363
95	319	9	1	8	58.3856333686
95	322	1	0	1	58.0131466124
95	323	1	0	1	52.2507299878
95	326	1	0	1	51.1235181262
95	328	1	0	1	47.9201160635
95	329	6	0	6	44.847748773
95	336	1	0	1	57.4088680426
95	338	7	5	2	61.722614067
95	341	0	0	0	65.0507714521
95	344	2	0	2	70.8528931065
95	345	1	0	1	82.3730022864
95	348	1	0	1	38.406141941
95	350	2	0	2	46.0910589674
95	353	1	0	1	48.3617822462
95	358	0	0	0	100.594498478
95	392	0	0	0	72.5628066735
95	396	1	0	1	84.5573292769
95	408	3	0	3	92.1787352768
95	415	1	0	1	82.1507841258
95	460	1	0	1	68.5004537041
95	464	1	0	1	61.6408659812
95	466	5	0	5	78.3999044886
95	468	1	0	1	50.303229115
95	469	1	0	1	65.308187055
95	471	2	0	2	64.0826466775
95	472	0	0	0	56.7868402336
95	475	1	0	1	59.8923042577
95	476	1	1	0	50.0358470728
95	477	1	0	1	70.2486920138
95	480	1	0	1	64.4769851307
95	482	2	0	2	90.5282780708
95	491	3	1	2	73.1111919827
95	493	1	0	1	94.0645990156
95	495	1	0	1	81.5535549272
95	503	7	0	7	78.7590028846
95	505	1	0	1	91.2094245422
95	507	1	0	1	173.413128218
95	524	0	0	0	106.566499476
95	543	1	0	1	151.673119375
95	551	0	0	0	76.0396208317
95	573	4	2	2	64.2040229884
95	579	1	0	1	56.6778992905
95	581	2	0	2	49.3259462681
95	583	0	0	0	101.130008311
95	585	1	0	1	78.924228651
96	0	7	0	7	46.2472079875
96	1	62	1	61	59.6269051731
96	3	1	0	1	41.9425234941
96	5	1	0	1	67.4428013711
96	7	1	0	1	49.7481106198
96	9	1	0	1	46.9760209309
96	12	3	0	3	69.1054977669
96	13	8	3	5	46.5341412495
96	18	1	0	1	42.8625055874
96	19	3	0	3	44.6955372693
96	23	1	0	1	59.3056732743
96	24	1	0	1	56.9666902078
96	25	1	0	1	78.4922521673
96	27	1	0	1	66.4023154194
96	29	2	0	2	71.326277111
96	31	1	0	1	40.2632051383
96	32	2	0	2	41.0530716694
96	35	2	0	2	49.5894183472
96	36	35	3	32	36.803338415
96	39	4	0	4	38.0680932688
96	41	3	0	3	42.8672625479
96	42	2	0	2	37.589579072
96	46	2	0	2	77.2022579347
96	50	3	0	3	63.885370932
96	55	1	0	1	75.7811124494
96	59	2	0	2	85.4162183753
96	60	1	0	1	66.5612816131
96	67	1	0	1	78.7563404215
96	70	524	259	265	12.0740700266
96	71	58	8	50	16.9438609399
96	72	41	4	37	15.8963380423
96	73	1635	235	1400	18.9930490826
96	74	123	0	123	16.2271698362
96	75	132	21	111	19.9610527877
96	76	263	174	89	11.5280247039
96	77	17	6	11	17.2362916731
96	78	257	8	249	14.5217440853
96	79	98	48	50	18.2706625817
96	80	17	2	15	16.3871500793
96	81	189	0	189	15.4296127037
96	82	183	1	182	13.7424049161
96	83	65	39	26	16.9602037901
96	84	160	1	159	18.3572580321
96	85	282	17	265	11.2419939607
96	86	69	21	48	15.061583506
96	87	85	6	79	19.2339784702
96	88	46	12	34	18.5904614221
96	89	90	43	47	20.1807143722
96	90	701	269	432	5.29205193915
96	92	128	46	82	14.1202372506
96	93	4	0	4	17.7777915292
96	94	26	0	26	11.6488534048
96	95	28	2	26	26.1857362523
96	97	18	13	5	14.1146015427
96	98	12	1	11	15.5348431867
96	99	4	0	4	32.9866735463
96	101	4	0	4	18.572375663
96	102	13	1	12	31.7371992442
96	103	93	0	93	24.4195641058
96	104	13	0	13	26.6924679115
96	105	5	0	5	25.0281289711
96	106	3	0	3	26.555792148
96	107	10	5	5	21.4069277979
96	108	62	3	59	6.60078694852
96	109	673	262	411	6.82099213771
96	110	12	0	12	28.4333239976
96	111	40	10	30	16.6401337416
96	112	81	0	81	26.5608847881
96	113	168	3	165	23.8253123155
96	114	4	0	4	32.0912336234
96	115	12	0	12	15.7948634121
96	116	177	85	92	9.03671573952
96	117	2	0	2	21.1444064711
96	118	28	17	11	8.92460050894
96	119	208	3	205	9.8407968354
96	120	31	14	17	21.009462432
96	121	3	0	3	22.1626334426
96	122	62	44	18	10.9585897392
96	124	1	0	1	52.8621541808
96	128	1	0	1	39.0392168649
96	129	1	0	1	36.2416297803
96	131	0	0	0	65.9428449379
96	133	2	1	1	38.7863942435
96	134	1	0	1	35.3324628332
96	136	1	0	1	45.67303777
96	137	2	0	2	27.3036232421
96	140	11	2	9	29.5736647877
96	142	71	11	60	37.2337299436
96	143	1	0	1	45.0452844031
96	144	1	0	1	33.3101616929
96	145	2	0	2	43.384949858
96	146	7	0	7	22.819878317
96	149	0	0	0	61.9624377
96	154	2	0	2	37.5368965025
96	155	73	15	58	10.1778397756
96	156	43	9	34	6.16130991976
96	157	1	0	1	32.2413448147
96	158	2	0	2	25.4886765135
96	159	1	0	1	20.1368643608
96	162	6	1	5	9.44009792997
96	164	11	3	8	16.0745565947
96	166	26	14	12	15.8760128062
96	168	5	0	5	20.3282355809
96	169	90	10	80	5.19277745335
96	171	33	4	29	11.8676709635
96	172	16	0	16	25.1059513537
96	175	11	1	10	16.5616850145
96	177	14	0	14	23.8732298073
96	179	7	3	4	9.68369996676
96	183	3	0	3	91.4877052897
96	186	1	0	1	83.025302673
96	187	1	0	1	88.3762966857
96	198	1	0	1	109.689089938
96	208	0	0	0	68.9125103129
96	209	2	0	2	69.4980757941
96	211	1	0	1	76.5277298736
96	213	1	0	1	75.6826355663
96	220	2	0	2	106.374863436
96	223	1	0	1	86.197995817
96	236	1	1	0	68.7698246979
96	242	0	0	0	117.06126922
96	245	24	11	13	27.0146596193
96	246	4	0	4	21.8001234369
96	247	4	1	3	24.1721375524
96	248	2	0	2	24.5744733267
96	250	1	0	1	33.6186156043
96	251	21	0	21	19.7478120545
96	253	1	0	1	34.1687192908
96	254	2	0	2	29.538893513
96	257	5	0	5	35.0457452366
96	258	1	0	1	39.7016685481
96	260	1	0	1	30.7457434624
96	262	2	0	2	39.4043526007
96	268	1	0	1	76.0963638145
96	270	1	0	1	60.5450593
96	272	1	0	1	58.4990256261
96	275	2	0	2	59.3784211905
96	276	1	0	1	44.8208182476
96	277	43	5	38	52.7860195782
96	279	1	0	1	49.6569147611
96	281	1	0	1	43.1622208634
96	282	6	1	5	44.4473213014
96	284	1	0	1	50.9761125913
96	293	3	0	3	45.5680264452
96	294	1	0	1	44.3877321983
96	296	0	0	0	34.6331107541
96	301	1	0	1	42.6276935672
96	303	2	0	2	58.4216896902
96	304	1	0	1	48.1503315325
96	306	1	0	1	56.5739803388
96	307	4	0	4	49.585220874
96	309	1	0	1	45.295369269
96	310	14	2	12	34.1125164961
96	313	2	1	1	29.5134006542
96	319	12	0	12	36.7125327061
96	320	1	0	1	41.7990915808
96	321	11	2	9	29.1735085416
96	323	1	0	1	34.1701358935
96	326	4	1	3	25.9032269178
96	328	1	0	1	25.7328499988
96	329	13	3	10	19.9298771105
96	332	1	0	1	45.4183250631
96	333	1	0	1	49.3225754888
96	338	8	0	8	35.756269444
96	341	1	0	1	40.6813959456
96	345	1	0	1	69.4256234061
96	347	6	3	3	13.9497785686
96	348	24	7	17	15.5558622967
96	349	2	1	1	28.6928793671
96	350	3	0	3	28.4899044729
96	351	1	0	1	26.0532760919
96	352	3	0	3	21.4127545265
96	353	15	1	14	22.6698278263
96	366	1	0	1	46.101041877
96	373	1	0	1	52.3005685095
96	375	4	0	4	59.7149780093
96	396	0	0	0	89.5202960708
96	401	1	0	1	99.7954507795
96	408	1	0	1	95.9649345919
96	464	2	0	2	79.5885266818
96	465	1	0	1	85.458207478
96	466	3	0	3	92.309930597
96	469	2	0	2	78.7608769288
96	471	2	0	2	83.3089458674
96	476	1	0	1	68.8965454644
96	480	4	0	4	80.7615401576
96	485	0	0	0	111.178402998
96	493	1	0	1	109.099820175
96	503	0	0	0	86.5144529517
96	505	2	0	2	104.710388501
96	554	1	0	1	80.662161313
96	571	0	0	0	66.8385170358
96	573	2	0	2	53.7433080849
96	581	1	0	1	38.4035502969
96	585	1	0	1	59.5061169666
97	1	6	0	6	63.8184779161
97	3	1	0	1	47.4979055944
97	13	1	0	1	52.9718971679
97	32	1	0	1	43.8878391673
97	36	6	0	6	44.7129286724
97	46	1	0	1	85.7764072122
97	48	0	0	0	82.7601845061
97	69	1	0	1	78.8009176185
97	70	90	12	78	21.5460297216
97	71	11	0	11	29.8690392319
97	72	5	0	5	23.9954413
97	73	375	87	288	29.0853492859
97	74	25	1	24	27.9907109307
97	75	12	1	11	30.8241513491
97	76	40	17	23	22.6309392473
97	78	43	4	39	26.3750538936
97	79	18	0	18	26.6977639791
97	80	3	0	3	25.5213766464
97	81	33	8	25	24.6768576785
97	82	33	0	33	24.6960760552
97	83	10	5	5	27.5605067059
97	84	31	1	30	29.0265154302
97	85	21	4	17	24.030733945
97	86	13	6	7	28.3089832534
97	87	20	4	16	31.0592425604
97	88	1	0	1	31.0124448441
97	89	24	3	21	24.0484439445
97	90	40	0	40	18.9201368928
97	91	6	1	5	7.48280874265
97	92	26	2	24	20.0632772433
97	93	22	7	15	4.78234612391
97	94	20	6	14	7.68091367971
97	95	1	0	1	34.3290262286
97	96	238	0	238	14.1146015427
97	101	1	0	1	16.4415005442
97	103	11	1	10	34.9238179142
97	108	23	2	21	8.1660458858
97	109	52	2	50	16.314188103
97	110	1	0	1	39.2694712129
97	111	13	2	11	18.3138138355
97	112	10	1	9	36.2025593176
97	113	21	0	21	35.6764263556
97	115	3	0	3	13.4492232143
97	116	17	6	11	20.7149262736
97	118	1	0	1	22.3063265995
97	119	4	0	4	23.8592789295
97	120	3	1	2	28.2607219582
97	122	32	0	32	13.4498571746
97	123	1	0	1	20.9034919648
97	124	0	0	0	65.229777518
97	129	0	0	0	46.6178853456
97	131	0	0	0	78.8277349554
97	133	1	0	1	50.2178397482
97	134	1	0	1	47.6771507237
97	140	6	1	5	41.7627983037
97	142	8	0	8	50.2662815111
97	144	1	0	1	46.9940295353
97	146	1	0	1	36.0208082555
97	151	0	0	0	72.2326059087
97	155	7	0	7	23.0787863472
97	156	3	3	0	18.0830482875
97	162	1	0	1	17.9571038937
97	164	2	1	1	30.1818047213
97	166	5	0	5	25.1042805112
97	168	3	0	3	34.4305993235
97	169	13	2	11	11.4334756889
97	171	3	0	3	25.8767742074
97	172	2	0	2	39.1983548922
97	177	2	0	2	37.6213693707
97	179	5	0	5	8.72891438107
97	183	1	0	1	81.2752586176
97	199	1	0	1	69.6347512617
97	208	1	0	1	55.0016009124
97	212	2	0	2	47.9502446671
97	217	1	0	1	90.2353292908
97	220	0	0	0	94.7488595091
97	244	1	0	1	102.781443114
97	245	15	2	13	24.7776602374
97	246	2	1	1	18.2530000972
97	247	27	3	24	11.2685417937
97	249	1	0	1	19.2951107541
97	250	2	0	2	27.7998969767
97	251	33	0	33	11.6991866116
97	253	1	0	1	22.879784241
97	254	3	0	3	22.8837157048
97	257	1	0	1	34.0972855896
97	260	1	0	1	30.5425639405
97	262	0	0	0	32.3899147426
97	271	1	0	1	57.3027521668
97	272	1	0	1	47.1105205725
97	275	1	0	1	52.1287343944
97	276	1	0	1	33.6704521406
97	277	13	0	13	44.7791617168
97	290	1	0	1	56.0877733589
97	293	2	0	2	32.6405852521
97	294	2	0	2	30.3545665281
97	310	9	0	9	20.7821911727
97	313	0	0	0	17.9824551702
97	314	3	0	3	24.5471393862
97	316	2	0	2	21.7449490822
97	319	8	0	8	43.7862038545
97	326	2	1	1	29.2160456743
97	329	2	0	2	25.1714280027
97	331	1	0	1	36.2445243473
97	333	1	0	1	41.2771094954
97	338	5	0	5	30.4229997978
97	347	2	0	2	14.0137759344
97	348	94	15	79	5.05302316601
97	349	2	0	2	29.0010314662
97	350	4	0	4	14.3842586655
97	352	8	0	8	9.90078721781
97	353	8	3	5	17.434123747
97	354	1	0	1	20.4697619489
97	357	2	0	2	36.3291669401
97	375	9	0	9	45.8819174963
97	408	0	0	0	109.981138661
97	469	0	0	0	92.4047214794
97	486	0	0	0	114.432325912
97	487	0	0	0	108.871013989
97	489	0	0	0	119.03965455
97	490	0	0	0	102.793255195
97	496	1	0	1	92.201851893
97	573	0	0	0	65.847740694
98	1	21	0	21	55.2072800236
98	7	1	0	1	43.9858301052
98	13	2	0	2	40.351768185
98	15	1	0	1	46.0148773581
98	26	1	0	1	52.5825713288
98	28	1	0	1	52.3345976857
98	32	3	0	3	39.9568625652
98	33	1	0	1	37.502232308
98	34	1	0	1	39.9231607367
98	36	14	2	12	29.7742568151
98	41	3	0	3	34.0554769911
98	46	1	0	1	66.8389655745
98	47	1	0	1	71.1605508118
98	59	1	0	1	71.9611732305
98	65	1	0	1	71.8439344456
98	70	49	12	37	13.4350246027
98	71	80	0	80	5.53971509101
98	72	7	0	7	15.9630843375
98	73	519	21	498	13.5453036652
98	74	51	24	27	8.93370020487
98	75	62	10	52	12.3818534065
98	76	31	3	28	10.6895926762
98	77	1	0	1	16.0613878858
98	78	156	65	91	8.56781028732
98	79	14	1	13	16.2223951959
98	80	1	0	1	14.4313456485
98	81	36	35	1	14.0207690359
98	82	47	23	24	10.6667955424
98	83	17	0	17	11.80822684
98	84	69	0	69	12.1113019103
98	85	70	38	32	7.0670433985
98	86	99	42	57	4.04190513031
98	87	98	71	27	9.76312437185
98	88	43	6	37	7.81828852932
98	89	7	0	7	23.2057542087
98	90	14	1	13	10.5487114827
98	92	12	4	8	18.3908307558
98	95	25	0	25	21.0918045527
98	96	7	0	7	15.5348431867
98	102	3	1	2	30.3459406867
98	103	58	0	58	15.7706813704
98	105	1	0	1	25.552044028
98	106	1	1	0	29.3580204952
98	107	259	73	186	5.87768883375
98	108	0	0	0	21.4194689989
98	109	5	2	3	14.7906523123
98	110	3	0	3	18.1353186716
98	111	2	0	2	23.6362558601
98	112	42	0	42	18.8671287759
98	113	135	64	71	12.5308322081
98	114	1	0	1	24.2461507675
98	116	8	1	7	10.621308506
98	117	8	6	2	9.51231038926
98	118	3	1	2	7.45351270153
98	119	14	0	14	5.71970814959
98	120	4	0	4	19.2940145062
98	121	10	8	2	9.58698851887
98	127	3	1	2	15.2090700289
98	128	0	0	0	23.5390496921
98	129	5	0	5	25.5661345732
98	131	2	0	2	50.969817088
98	133	1	0	1	26.2424169021
98	134	4	1	3	21.5920603483
98	136	1	0	1	30.9796348857
98	137	11	1	10	11.7713947528
98	140	11	1	10	16.5599353519
98	142	76	3	73	22.42294844
98	143	1	0	1	29.764562499
98	145	1	0	1	29.6319294077
98	146	30	0	30	8.4989002629
98	147	2	0	2	34.9833741347
98	151	1	0	1	44.895283772
98	155	11	3	8	11.8707614431
98	156	3	1	2	14.8215328969
98	157	2	0	2	18.7676948002
98	158	0	0	0	16.8990321711
98	159	1	0	1	16.7808854651
98	160	2	0	2	16.7460090062
98	162	1	0	1	18.9475403019
98	164	45	30	15	2.91755301935
98	166	3	0	3	20.0680529822
98	168	17	5	12	6.89905854138
98	169	1	0	1	19.9529786077
98	171	33	1	32	6.59952100224
98	172	65	28	37	11.204281267
98	173	1	0	1	22.625630812
98	175	4	0	4	8.77644973617
98	177	24	0	24	12.8550844757
98	229	1	0	1	94.5544297816
98	238	1	0	1	89.8767156824
98	242	0	0	0	129.894184591
98	245	0	0	0	33.7323436488
98	256	1	0	1	33.0344840683
98	257	0	0	0	38.9686252769
98	259	1	0	1	50.6011921893
98	262	1	0	1	48.3252967791
98	277	4	1	3	61.6657278225
98	281	1	0	1	52.9032586513
98	282	0	0	0	55.2111309523
98	303	2	0	2	56.6289576947
98	307	1	0	1	50.9138232188
98	309	2	0	2	44.8151236255
98	310	1	0	1	49.6417148271
98	317	1	0	1	60.5025839606
98	319	7	0	7	37.8246064055
98	326	1	0	1	33.3222770345
98	329	3	0	3	27.1488075565
98	334	1	0	1	57.3860534761
98	338	1	1	0	48.1710753092
98	341	1	0	1	55.0472496028
98	349	1	0	1	38.1295383888
98	385	0	0	0	61.2939164321
98	408	1	0	1	81.5614818402
98	460	1	0	1	57.9305934712
98	464	1	0	1	64.6445008402
98	466	1	0	1	76.7994742805
98	469	1	0	1	63.255396469
98	495	0	0	0	77.0850670458
98	505	0	0	0	89.1786419955
98	507	1	0	1	154.009137832
98	537	0	0	0	102.424260686
98	569	0	0	0	42.1706160358
98	573	4	0	4	44.7568505605
98	581	1	1	0	29.3218247463
99	0	2	0	2	24.5954679578
99	1	72	4	68	37.1907650497
99	2	3	1	2	25.1482699165
99	3	2	0	2	21.4405378693
99	6	1	0	1	44.1540634203
99	7	6	0	6	25.5282249991
99	13	8	0	8	21.8570362673
99	15	4	0	4	26.874203772
99	17	1	0	1	28.05550949
99	19	4	0	4	25.2753479489
99	20	1	0	1	35.060644612
99	21	3	0	3	36.1124374884
99	22	1	0	1	44.9217111085
99	24	3	0	3	29.6743805177
99	26	1	0	1	31.1609818662
99	28	1	0	1	35.6081748623
99	31	14	10	4	8.87445893687
99	32	3	0	3	28.0775867751
99	33	8	2	6	17.4893893018
99	34	6	2	4	18.99880724
99	35	7	4	3	19.7217407036
99	36	139	3	136	12.4185744595
99	38	4	2	2	13.2799953504
99	39	6	0	6	22.6002737967
99	41	12	1	11	13.5778398266
99	42	8	1	7	18.3879338269
99	46	3	0	3	45.3706159045
99	48	3	1	2	38.8199427876
99	50	1	0	1	31.0103543737
99	53	1	0	1	57.3015063759
99	55	1	0	1	42.877682175
99	60	1	1	0	33.5783652293
99	65	2	0	2	50.605432132
99	68	2	0	2	29.0345878603
99	70	36	0	36	22.5555019585
99	71	15	1	14	16.9286410393
99	72	11	0	11	20.5588909059
99	73	450	206	244	15.0466962988
99	74	27	0	27	16.7604686729
99	75	110	16	94	13.3182215199
99	76	13	0	13	21.8013482233
99	77	4	2	2	19.1222182235
99	78	65	11	54	18.4672781049
99	79	23	0	23	18.0369444284
99	80	4	1	3	18.7363240981
99	81	20	12	8	19.5056413606
99	82	17	2	15	19.602107141
99	83	14	6	8	16.5688860906
99	84	104	29	75	15.0965445735
99	85	31	0	31	21.8942818891
99	86	6	4	2	19.1050700651
99	87	57	11	46	13.7762915179
99	88	23	9	14	14.7739207609
99	89	14	2	12	24.5005008769
99	90	8	0	8	27.9421070137
99	92	13	0	13	24.9285234063
99	95	46	2	44	12.9113601562
99	96	8	5	3	32.9866735463
99	98	6	0	6	21.4841371044
99	100	2	0	2	16.0111975987
99	102	4	0	4	21.3478499224
99	103	222	1	221	9.23212494033
99	104	5	1	4	17.312248321
99	105	3	0	3	22.0035477869
99	106	1	0	1	26.7239877962
99	107	6	0	6	19.0033221599
99	109	1	0	1	28.0023400161
99	110	106	96	10	4.85958555924
99	111	7	1	6	29.2508838078
99	112	181	29	152	8.97236380151
99	113	449	122	327	9.35433502262
99	114	27	1	26	8.32004704345
99	115	1	1	0	34.4914959984
99	116	4	0	4	24.1164220575
99	117	3	0	3	12.356905417
99	118	1	0	1	24.4927406294
99	119	1	0	1	25.5112776841
99	120	4	0	4	17.9651119746
99	121	11	2	9	11.9245412321
99	122	1	0	1	31.286013208
99	124	5	0	5	21.939883683
99	125	2	0	2	17.307725585
99	126	3	0	3	29.2569179003
99	127	5	1	4	10.3209406895
99	128	0	0	0	19.0548377261
99	129	65	7	58	4.31951942408
99	131	2	0	2	36.2373675019
99	133	41	28	13	6.18345655132
99	134	39	13	26	6.91659372802
99	136	3	0	3	16.9542652315
99	137	4	0	4	17.2281059925
99	138	18	0	18	9.67588322271
99	140	100	13	87	5.74618937355
99	142	239	69	170	12.1180840567
99	143	3	0	3	19.9111427318
99	144	3	1	2	16.1346684261
99	145	12	2	10	12.192541962
99	146	10	1	9	13.5477838444
99	147	4	1	3	30.3749087611
99	148	6	3	3	13.2972397459
99	154	0	0	0	23.2934466733
99	155	3	0	3	33.1326517679
99	156	1	0	1	34.9905957472
99	160	1	0	1	23.2397512544
99	164	3	0	3	23.7735402666
99	167	1	0	1	37.7637297671
99	168	5	0	5	24.6409740786
99	171	9	2	7	28.016066776
99	172	3	0	3	25.1764337032
99	175	0	0	0	29.6258374714
99	177	3	1	2	30.1346310526
99	179	1	0	1	42.6053598104
99	183	1	0	1	99.6108378066
99	188	0	0	0	101.873605681
99	220	1	0	1	118.042327916
99	229	2	0	2	100.023313807
99	242	1	0	1	132.736219392
99	245	5	1	4	34.4770534248
99	247	1	0	1	49.47892455
99	248	1	0	1	40.2848079299
99	251	1	0	1	41.0532674796
99	253	1	0	1	53.5932030822
99	256	0	0	0	26.515150882
99	257	1	0	1	34.2916889899
99	262	1	0	1	48.7226235744
99	277	3	0	3	60.2949302493
99	281	1	0	1	53.8894795483
99	282	0	0	0	57.5603505725
99	295	1	0	1	65.896233029
99	303	2	0	2	41.3476623546
99	307	2	0	2	40.2148087351
99	338	3	0	3	68.3820278813
99	347	1	0	1	46.6086725972
99	349	1	0	1	59.305375741
99	396	1	0	1	72.3956693083
99	408	1	0	1	80.1753133043
99	453	1	0	1	66.7157270923
99	465	0	0	0	60.1545973026
99	466	3	1	2	65.5240811134
99	469	1	0	1	52.3996749936
99	474	1	0	1	71.607010965
99	475	1	0	1	47.3693994161
99	480	2	0	2	51.783021127
99	489	1	0	1	75.0296334302
99	491	1	0	1	60.4790962724
99	492	1	0	1	71.1891006608
99	493	1	0	1	81.311373004
99	495	1	0	1	68.6725982148
99	503	1	0	1	66.1894365804
99	504	1	0	1	54.6243833606
99	573	0	0	0	57.8182793791
99	581	0	0	0	44.2878396929
100	0	9	0	9	14.3967530852
100	1	176	10	166	28.0143193221
100	2	2	1	1	21.2867029933
100	3	9	3	6	10.0827553676
100	4	1	0	1	22.8638335444
100	5	0	0	0	35.5188322476
100	7	10	0	10	17.8314816864
100	9	2	0	2	15.605296754
100	11	2	0	2	44.6642485661
100	13	13	3	10	14.7626554741
100	15	12	0	12	20.4146543082
100	16	2	0	2	11.6040206625
100	18	11	2	9	11.0521388766
100	19	2	0	2	13.2556251166
100	20	1	0	1	32.2478819448
100	21	6	0	6	30.9051778905
100	23	3	0	3	27.5651006654
100	24	1	0	1	25.3377382003
100	28	2	1	1	24.6696209223
100	29	1	1	0	40.7955638402
100	30	1	0	1	24.0211860611
100	31	18	0	18	15.2427418771
100	32	17	2	15	12.8539897141
100	33	14	4	10	15.1459846473
100	35	8	0	8	19.9435245163
100	36	356	116	240	7.24539045562
100	38	1	0	1	20.3914304079
100	39	57	26	31	7.72235928142
100	40	2	0	2	10.1364873398
100	41	15	4	11	14.2864716205
100	42	146	65	81	5.67928717972
100	46	2	1	1	47.5730553093
100	52	1	0	1	37.2807240578
100	55	1	0	1	48.9085639585
100	65	1	0	1	54.5581367984
100	70	37	0	37	19.9046349812
100	71	4	1	3	22.3112132607
100	72	3	0	3	16.0346738274
100	73	284	25	259	14.6039440333
100	74	10	3	7	19.1919941638
100	75	27	3	24	15.4454760088
100	76	12	6	6	21.1907371373
100	77	2	0	2	14.7218365145
100	78	25	1	24	20.237132687
100	79	41	5	36	13.7617092928
100	80	2	0	2	15.7890561526
100	81	32	1	31	16.7084772724
100	82	17	3	14	19.3885349474
100	83	9	1	8	16.6995015225
100	84	48	1	47	15.9255964419
100	85	5	1	4	23.7885382059
100	86	11	0	11	23.934458562
100	87	30	2	28	18.1473283278
100	88	7	1	6	20.1724230839
100	89	22	4	18	14.4966595094
100	90	2	1	1	28.409379628
100	92	19	18	1	18.7487370361
100	95	113	90	23	6.73639476783
100	96	3	0	3	31.9302401071
100	98	1	0	1	27.8270030043
100	99	10	3	7	16.0111975987
100	102	193	42	151	5.528896632
100	103	72	0	72	12.8609026703
100	104	86	13	73	5.46184024272
100	105	9	2	7	9.52387123938
100	106	3	0	3	13.011539593
100	107	1	0	1	28.708734146
100	109	2	0	2	25.2497298135
100	110	10	0	10	13.6630927523
100	111	6	0	6	20.3460543754
100	112	135	78	57	9.87210620509
100	113	87	19	68	17.3782737876
100	114	29	1	28	7.74399454778
100	115	2	0	2	25.8220971642
100	116	4	0	4	23.5772039084
100	117	2	0	2	19.4019509691
100	119	1	0	1	28.8521028508
100	120	12	0	12	10.9295413314
100	122	1	0	1	25.0566300696
100	123	2	1	1	20.0776868054
100	124	1	0	1	35.7317807248
100	129	5	0	5	14.6717864221
100	133	1	0	1	20.5391226323
100	134	2	0	2	22.9179786262
100	135	1	0	1	44.3044169817
100	136	1	0	1	32.3864793329
100	140	2	0	2	19.6359209984
100	141	2	0	2	56.8179128904
100	142	35	26	9	28.0778147858
100	144	2	0	2	30.985436426
100	145	2	0	2	26.8900858098
100	146	1	0	1	23.487557503
100	155	1	0	1	36.7462224779
100	168	3	0	3	33.671042979
100	171	1	0	1	32.8700927437
100	172	3	1	2	36.129961436
100	175	1	0	1	36.5204108604
100	177	0	0	0	39.8891917365
100	183	2	0	2	83.6963749838
100	188	1	0	1	86.3886507537
100	194	1	0	1	94.6917978226
100	208	1	0	1	79.7504480633
100	220	0	0	0	102.341110305
100	243	1	0	1	111.749134672
100	245	3	0	3	21.0694605709
100	256	7	0	7	10.9284057169
100	257	4	2	2	18.6738790837
100	258	1	0	1	17.1408738529
100	259	1	0	1	33.1986826147
100	260	2	0	2	16.5459467044
100	262	2	0	2	33.924573013
100	272	1	0	1	58.6915658086
100	274	1	0	1	38.4155317175
100	277	6	0	6	44.699032851
100	282	1	0	1	43.1042067348
100	288	1	0	1	54.6166037803
100	291	1	0	1	62.2150380109
100	303	2	0	2	28.8182464561
100	305	1	0	1	30.0765444809
100	307	4	1	3	24.8341933641
100	309	4	1	3	17.7642200142
100	319	1	0	1	65.046246903
100	392	0	0	0	77.8441659187
100	465	0	0	0	75.1584664578
100	471	1	0	1	63.890495476
100	488	1	0	1	78.605311904
100	491	0	0	0	73.8761204655
100	506	1	0	1	106.966861362
101	0	2	1	1	35.8184457703
101	1	18	4	14	47.5849275198
101	3	1	0	1	31.9809497289
101	13	1	0	1	37.7543067125
101	21	1	0	1	52.9258838664
101	28	1	0	1	42.9787589256
101	29	1	0	1	64.2961158274
101	32	2	0	2	27.5555252136
101	33	1	0	1	38.9975068341
101	35	1	0	1	43.8070856899
101	36	11	4	7	30.8623266254
101	39	4	1	3	26.7230864343
101	41	1	0	1	37.940146375
101	42	2	0	2	28.4229743296
101	48	1	0	1	70.7644073712
101	65	1	0	1	78.410871822
101	69	1	0	1	68.2504302502
101	70	124	0	124	14.6411120016
101	71	17	0	17	25.0382196036
101	72	30	6	24	14.099245701
101	73	780	197	583	19.8329386213
101	74	31	1	30	21.4954311501
101	75	46	16	30	22.1876087662
101	76	77	34	43	17.2447173193
101	77	14	0	14	15.2161881925
101	78	76	27	49	20.542809911
101	79	79	15	64	16.1186728418
101	80	16	2	14	16.2230494471
101	81	81	51	30	15.8677119439
101	82	89	0	89	18.1415198831
101	83	18	3	15	19.4536986504
101	84	83	2	81	20.5775983385
101	85	23	0	23	20.6828741587
101	86	17	3	14	24.6084001756
101	87	18	0	18	23.859680402
101	88	12	2	10	24.8893740493
101	89	162	9	153	9.71533420722
101	90	21	5	16	19.5370129229
101	92	144	76	68	9.98849994041
101	93	1	0	1	14.6219667481
101	94	5	0	5	9.50105850903
101	95	17	0	17	21.7058836063
101	96	80	0	80	18.572375663
101	97	2	0	2	16.4415005442
101	98	1	0	1	27.7445369412
101	100	1	0	1	23.8636062596
101	102	9	1	8	20.557603642
101	103	30	3	27	24.9593856245
101	104	5	0	5	18.8349469739
101	105	10	0	10	14.3495494245
101	106	1	0	1	12.3309317499
101	108	6	1	5	14.1123062237
101	109	35	10	25	13.807219897
101	110	1	0	1	29.1320665486
101	111	187	4	183	4.71554674573
101	112	33	1	32	24.9401172169
101	113	60	23	37	27.6232126428
101	115	76	51	25	3.21677845442
101	116	6	0	6	17.190012396
101	117	1	0	1	26.6622238819
101	118	3	0	3	20.8459659603
101	120	7	2	5	15.9225108495
101	121	1	0	1	28.1674068741
101	122	40	27	13	7.71115683076
101	123	38	23	15	4.48607366734
101	128	2	0	2	47.5206892314
101	131	1	0	1	70.0490699464
101	133	1	0	1	39.9407503541
101	139	0	0	0	65.3363461304
101	140	1	0	1	33.4933744025
101	141	1	0	1	69.1962148142
101	142	18	1	17	43.0454130794
101	146	1	0	1	30.698161451
101	147	2	1	1	59.9222615474
101	149	6	0	6	70.8745825907
101	155	8	0	8	28.2832925681
101	156	1	0	1	24.7335745815
101	163	0	0	0	56.0787246937
101	164	2	0	2	29.8723582046
101	165	0	0	0	45.1807808394
101	166	2	0	2	34.3659915753
101	169	6	1	5	20.7633177556
101	171	1	0	1	27.9269406159
101	172	2	0	2	38.9463498324
101	175	1	0	1	33.0299663324
101	177	0	0	0	39.6683802758
101	183	3	1	2	74.0474882245
101	186	1	0	1	66.6338400838
101	208	3	0	3	58.6705826753
101	213	3	1	2	64.6698703489
101	219	1	0	1	93.2524746267
101	220	1	0	1	90.0824200565
101	227	1	0	1	68.7426125849
101	229	1	0	1	67.760301024
101	232	1	0	1	56.7569816781
101	245	241	102	139	8.88421175934
101	246	128	4	124	3.31859207511
101	247	13	5	8	16.4123175492
101	248	8	2	6	7.29702192475
101	249	1	0	1	14.0902617613
101	250	6	1	5	15.1692689753
101	251	108	71	37	7.64405229898
101	252	1	0	1	16.851034492
101	253	5	2	3	20.1848216329
101	254	14	0	14	11.6471809128
101	256	3	0	3	17.8117344324
101	257	14	6	8	17.9320511322
101	258	2	0	2	23.7698464031
101	260	8	0	8	14.1518628461
101	262	8	2	6	21.1462597906
101	263	1	0	1	17.6851389495
101	264	1	0	1	22.7140933487
101	271	1	0	1	51.1305442784
101	272	1	0	1	42.7122711909
101	274	6	0	6	28.0462078663
101	276	1	0	1	29.422187131
101	277	55	0	55	34.6172926205
101	280	1	0	1	41.8664808811
101	281	2	0	2	25.3683518121
101	282	4	0	4	27.4697228885
101	287	1	0	1	36.6482120568
101	291	2	0	2	44.2299769977
101	292	1	0	1	39.8172816203
101	293	4	1	3	33.1746344328
101	296	0	0	0	24.7388046427
101	303	1	0	1	43.9806140622
101	305	2	0	2	28.9748912929
101	307	1	0	1	33.2064034975
101	309	2	0	2	30.7019319757
101	310	2	1	1	33.8369323485
101	319	1	0	1	55.0757319042
101	329	1	0	1	37.3844508331
101	338	1	0	1	46.8194930224
101	348	1	0	1	21.4506535417
101	350	2	0	2	25.0379532201
101	354	1	0	1	34.3209663876
101	375	2	0	2	55.6721330832
101	408	1	0	1	108.557116162
101	452	1	0	1	90.0330118241
101	455	1	0	1	72.4579031582
101	465	0	0	0	93.0542702252
101	469	2	0	2	85.5823416996
101	475	1	0	1	78.2055875451
101	476	0	0	0	71.5503898419
101	504	1	0	1	86.4264468839
102	0	30	11	19	15.3952721959
102	1	329	2	327	28.0918295733
102	2	2	0	2	24.0748375015
102	3	48	5	43	11.4311824559
102	4	1	0	1	24.9491223624
102	5	1	0	1	36.7486038409
102	6	3	0	3	43.7209249765
102	7	22	4	18	19.5442971112
102	9	2	0	2	15.4555786678
102	13	21	6	15	17.222304605
102	15	9	0	9	22.3394850276
102	16	3	1	2	11.5257865622
102	17	1	0	1	29.873532344
102	18	17	0	17	13.7104493676
102	19	7	0	7	13.2971089117
102	20	1	0	1	34.6394099472
102	21	4	0	4	32.524227709
102	22	2	0	2	36.0220879836
102	23	5	0	5	29.5835006467
102	24	3	0	3	27.6208475676
102	26	1	0	1	35.9139917251
102	28	9	0	9	24.025935127
102	31	6	0	6	20.6269569612
102	32	90	2	88	9.72116539645
102	33	16	7	9	19.1338346284
102	35	7	3	4	24.0025303995
102	36	299	43	256	12.3284200526
102	37	1	0	1	31.2307193978
102	38	2	0	2	25.5709260895
102	39	200	34	166	6.47640211686
102	40	24	23	1	5.51876862956
102	41	9	0	9	19.0674097046
102	42	138	61	77	8.04679351573
102	48	0	0	0	52.4369814087
102	50	4	1	3	42.1179398145
102	54	1	0	1	37.9385420829
102	59	2	0	2	66.0186750925
102	60	2	1	1	45.8384954759
102	64	1	0	1	51.383912429
102	65	1	0	1	58.2784166251
102	68	2	0	2	43.655582221
102	70	61	0	61	20.2344733166
102	71	15	0	15	25.0206865848
102	72	11	4	7	16.2769398911
102	73	598	13	585	16.8024768452
102	74	39	4	35	21.424912728
102	75	60	24	36	18.2806968582
102	76	13	0	13	22.1108049656
102	77	14	1	13	15.3252543674
102	78	47	16	31	22.1057377303
102	79	107	17	90	14.6780759478
102	80	6	3	3	16.7519114696
102	81	57	2	55	17.5345177572
102	82	33	0	33	20.709036267
102	83	16	2	14	18.6184279218
102	84	101	44	57	18.243158157
102	85	10	0	10	25.2687252443
102	86	11	1	10	26.3200170656
102	87	47	0	47	21.1170774834
102	88	13	0	13	23.1353236975
102	89	94	5	89	12.2631369256
102	90	12	0	12	28.9943567503
102	92	36	1	35	17.7512235642
102	93	1	0	1	35.0911347027
102	94	1	0	1	28.5153817934
102	95	175	85	90	10.1432222695
102	96	12	1	11	31.7371992442
102	97	2	0	2	36.1574241993
102	98	2	1	1	30.3459406867
102	99	4	1	3	21.3478499224
102	100	190	0	190	5.528896632
102	101	1	0	1	20.557603642
102	103	103	18	85	16.7941343117
102	104	192	27	165	6.14706076479
102	105	84	67	17	6.91111849571
102	106	26	0	26	8.57741150278
102	107	4	1	3	32.1248734214
102	108	0	0	0	30.9739602082
102	109	12	0	12	24.9164008813
102	110	10	4	6	18.5031075969
102	111	15	7	8	17.845735998
102	112	170	17	153	14.1938590644
102	113	150	2	148	21.3706235877
102	114	10	0	10	13.1932909667
102	116	2	0	2	24.2386655004
102	117	3	0	3	22.8909937892
102	118	1	0	1	27.424504684
102	119	1	0	1	30.3723780026
102	120	31	0	31	11.465820084
102	122	3	0	3	23.3295042146
102	123	3	1	2	16.3482850292
102	124	1	0	1	41.237518289
102	127	1	0	1	29.1592001592
102	129	3	0	3	20.1978388105
102	133	5	1	4	26.0562094877
102	137	1	0	1	34.0164863419
102	138	0	0	0	26.4529232388
102	140	5	1	4	24.5004912326
102	142	52	9	43	33.3109118404
102	143	4	1	3	41.2521194508
102	144	1	0	1	35.7467992375
102	145	2	0	2	32.4152629415
102	146	4	2	2	27.2795743687
102	147	2	0	2	51.6336041742
102	155	2	1	1	37.9194926955
102	164	4	0	4	33.2568511017
102	166	1	0	1	46.1736255601
102	168	6	0	6	36.6723023513
102	169	1	0	1	36.1514704749
102	171	3	0	3	34.631871892
102	172	4	0	4	39.6163238316
102	177	3	1	2	42.9051991423
102	183	2	0	2	78.2699146395
102	188	2	0	2	80.8618585978
102	198	1	0	1	112.327728839
102	206	1	0	1	66.496175893
102	208	0	0	0	74.7387855172
102	220	1	0	1	96.8382972398
102	226	1	0	1	80.4946015263
102	229	1	0	1	80.4605494652
102	233	1	0	1	66.3819554346
102	245	26	7	19	16.2854326807
102	246	1	0	1	20.6103196938
102	250	2	1	1	23.6855919505
102	251	7	3	4	27.995843856
102	252	1	0	1	29.4200188141
102	254	3	0	3	24.7901400334
102	255	2	0	2	20.9848165005
102	256	85	37	48	5.4168279687
102	257	81	10	71	13.1450445785
102	258	4	1	3	12.135512295
102	260	4	1	3	11.2047429249
102	262	3	0	3	28.4879164739
102	263	1	0	1	22.6440552719
102	264	2	0	2	17.9699987949
102	272	2	0	2	53.2406301298
102	274	1	0	1	32.8878280308
102	276	1	0	1	42.3710014653
102	277	37	4	33	39.1753391708
102	279	1	0	1	31.0703363789
102	281	1	0	1	33.6331263343
102	282	3	0	3	37.7172216231
102	284	1	0	1	47.048645704
102	291	1	0	1	56.8796972124
102	294	0	0	0	55.1838006962
102	303	5	3	2	26.961937841
102	304	1	0	1	16.4157836436
102	305	3	0	3	24.809228128
102	306	2	0	2	26.7177347833
102	307	35	1	34	20.7732225434
102	309	24	0	24	14.4926931245
102	329	1	0	1	51.4711396803
102	349	1	0	1	60.3337639896
102	352	1	0	1	46.0163275408
102	375	1	0	1	75.161641918
102	415	2	0	2	91.6229244384
102	442	1	0	1	121.414218312
102	465	0	0	0	80.6870534873
102	468	1	0	1	57.6665479599
102	471	1	0	1	69.1174163318
102	475	0	0	0	68.6874192614
102	476	3	0	3	55.6961814293
102	486	0	0	0	86.0850979963
102	493	1	0	1	100.48915689
102	503	2	0	2	87.4735165256
102	524	1	0	1	116.693177525
102	573	2	0	2	74.2003698019
102	576	1	0	1	58.5145677339
103	0	5	0	5	25.8574387333
103	1	39	15	24	39.4800892153
103	2	3	0	3	29.6909327978
103	3	2	0	2	21.8103726654
103	5	1	0	1	45.4326821951
103	7	2	0	2	28.2151884522
103	12	1	0	1	47.9629770687
103	15	2	0	2	30.269220589
103	17	1	0	1	33.8571604072
103	18	2	1	1	21.3212374927
103	19	2	0	2	25.4652469754
103	20	1	0	1	40.4779004469
103	21	2	0	2	40.4665986793
103	23	1	0	1	36.715504529
103	31	2	0	2	15.8539326047
103	32	1	0	1	25.6490014558
103	33	5	1	4	22.0293000514
103	34	3	0	3	27.7677804942
103	35	3	0	3	25.6538443019
103	36	60	25	35	14.0175773979
103	39	3	0	3	20.5773668685
103	41	0	0	0	18.8991929217
103	42	1	0	1	17.6401987398
103	43	0	0	0	65.6821050533
103	51	1	0	1	34.3586232155
103	59	1	0	1	61.7163857765
103	65	1	0	1	58.7161244465
103	70	61	1	60	13.4049892202
103	71	26	1	25	10.3037874023
103	72	13	1	12	11.3541086332
103	73	627	1	626	5.83863131694
103	74	45	6	39	8.49803276225
103	75	169	10	159	4.46780441372
103	76	21	5	16	12.9552058845
103	77	7	2	5	9.95408240223
103	78	97	10	87	10.1037990118
103	79	32	13	19	8.91478345333
103	80	6	3	3	9.50421085073
103	81	30	6	24	10.280779711
103	82	40	13	27	10.7229458163
103	83	47	45	2	7.54808842591
103	84	148	101	47	6.09610836785
103	85	32	3	29	13.8302242165
103	86	27	5	22	12.2959001755
103	87	116	85	31	6.15677852949
103	88	34	4	30	7.96481094728
103	89	12	9	3	16.0476700204
103	90	8	2	6	19.6615122752
103	92	11	1	10	15.7448462351
103	95	79	32	47	6.65279494406
103	96	13	4	9	24.4195641058
103	98	2	0	2	15.7706813704
103	99	13	0	13	9.23212494033
103	100	3	0	3	12.8609026703
103	102	13	0	13	16.7941343117
103	104	9	2	7	11.1072402273
103	106	1	0	1	19.6184628591
103	107	6	2	4	15.8865168183
103	108	0	0	0	27.2821281191
103	109	5	0	5	18.9733345969
103	110	58	40	18	4.37264004523
103	111	2	1	1	20.2921464416
103	112	385	140	245	3.14835158008
103	113	443	210	233	4.58432614818
103	114	23	7	16	8.53387679202
103	115	1	0	1	25.3907429452
103	116	5	0	5	15.3959328216
103	117	16	1	15	6.64266270668
103	119	4	0	4	18.2675965318
103	120	8	0	8	9.47877105728
103	121	4	3	1	7.45488773892
103	122	0	0	0	22.0549654079
103	123	1	1	0	23.0364690798
103	128	3	0	3	24.0842540246
103	129	6	0	6	11.8792744547
103	131	2	0	2	45.154468093
103	133	0	0	0	15.4090132402
103	134	5	0	5	14.2300456285
103	140	8	4	4	8.86994497231
103	142	54	23	31	18.5077162579
103	144	2	0	2	19.3684045273
103	145	1	0	1	21.1668318103
103	146	4	2	2	10.6342921926
103	147	2	0	2	36.3776468736
103	148	1	0	1	22.5277467807
103	153	1	0	1	35.6831784755
103	154	1	0	1	26.5565169704
103	155	4	0	4	26.2760154137
103	156	1	0	1	27.236240293
103	159	2	0	2	32.5512681489
103	160	3	1	2	24.2538219498
103	164	6	1	5	18.5681829982
103	165	1	0	1	32.0929550005
103	166	1	0	1	34.9035494135
103	168	3	0	3	21.0237553346
103	169	3	0	3	29.6077184595
103	170	1	0	1	38.2865335353
103	171	4	0	4	21.6471685066
103	172	5	0	5	23.2757098642
103	173	1	0	1	37.0600606328
103	175	1	0	1	24.5381962935
103	176	0	0	0	43.5016777273
103	177	3	1	2	27.1882777253
103	183	1	0	1	93.6397433107
103	220	1	0	1	111.458321046
103	222	1	0	1	105.31780096
103	229	2	0	2	91.9676305878
103	245	5	1	4	26.7272916624
103	249	1	0	1	38.871439015
103	250	1	0	1	35.6463061196
103	251	1	0	1	31.9905260178
103	257	1	0	1	28.3961549795
103	263	1	0	1	36.0019602617
103	272	1	0	1	65.7310867554
103	277	7	1	6	53.8130966369
103	282	0	0	0	49.9352194219
103	286	1	0	1	45.5365351063
103	291	0	0	0	68.2220679869
103	303	1	0	1	41.4726475712
103	307	1	0	1	37.4225236881
103	310	1	0	1	55.5577620307
103	319	2	0	2	53.5746563063
103	321	1	0	1	48.3962256385
103	329	1	0	1	41.4677020843
103	347	1	0	1	38.2853816011
103	349	1	0	1	51.8589873007
103	375	1	0	1	79.5583573331
103	386	0	0	0	74.0683317641
103	406	1	0	1	85.3582220908
103	408	0	0	0	86.0878064601
103	411	1	0	1	83.0977116697
103	415	2	0	2	75.9521871044
103	455	0	0	0	51.4769485174
103	464	1	0	1	58.3366019523
103	466	0	0	0	74.0086698093
103	469	2	0	2	60.701732202
103	475	1	0	1	54.2624776224
103	476	1	0	1	46.9591112136
103	501	1	0	1	84.1971185051
103	502	1	0	1	81.3420680949
103	503	4	0	4	73.1279857147
103	521	1	0	1	103.571111929
103	573	2	1	1	57.7201334177
104	0	21	0	21	19.5606224837
104	1	159	3	156	32.9799221885
104	2	1	1	0	26.7457470979
104	3	17	0	17	15.2655086326
104	6	1	0	1	47.0507057881
104	7	5	0	5	23.1983588083
104	8	1	0	1	55.3154841823
104	12	0	0	0	42.4130940999
104	13	14	0	14	20.2102089255
104	15	6	0	6	25.8263787552
104	16	2	0	2	16.3169463783
104	17	4	0	4	32.1455138707
104	18	5	1	4	16.498806124
104	19	1	0	1	18.0601582089
104	21	1	0	1	36.2991579989
104	22	2	0	2	41.0588320514
104	24	4	0	4	30.7926658335
104	28	5	1	4	29.3066458973
104	31	3	1	2	19.055068036
104	32	11	1	10	15.7774389998
104	33	3	0	3	20.4246770325
104	35	2	0	2	25.1429616851
104	36	100	85	15	12.0513440207
104	38	3	0	3	24.5609021417
104	39	28	1	27	11.668172088
104	40	1	0	1	11.6330137712
104	41	1	0	1	19.1122905867
104	42	26	0	26	10.9680316482
104	47	1	0	1	64.380928521
104	48	2	0	2	52.0532751311
104	49	1	0	1	38.3086953365
104	50	2	0	2	42.3046164849
104	59	1	0	1	65.8640149002
104	65	3	0	3	59.771407889
104	70	141	27	114	14.7860522299
104	71	40	0	40	18.8739444452
104	72	33	0	33	10.8377334206
104	73	1386	145	1241	10.6619322932
104	74	76	8	68	15.2961665734
104	75	130	1	129	12.157361166
104	76	34	2	32	16.365659876
104	77	26	1	25	9.65822990187
104	78	162	7	155	16.0384850425
104	79	249	79	170	8.8440584621
104	80	15	3	12	10.9307817617
104	81	123	49	74	11.7869720403
104	82	49	0	49	14.7888771498
104	83	51	1	50	12.5213808716
104	84	171	112	59	12.0995407109
104	85	41	6	35	19.3241092546
104	86	24	0	24	20.1870330798
104	87	101	8	93	14.9972798004
104	88	48	4	44	17.0073467302
104	89	140	76	64	9.23418952273
104	90	14	6	8	23.4583010248
104	92	70	0	70	13.2984674841
104	94	1	0	1	25.2953584139
104	95	403	248	155	4.64317111354
104	96	30	11	19	26.6924679115
104	99	9	6	3	17.312248321
104	100	62	7	55	5.46184024272
104	101	5	2	3	18.8349469739
104	102	155	38	117	6.14706076479
104	103	200	25	175	11.1072402273
104	105	83	69	14	4.92605195509
104	106	18	0	18	9.44896076886
104	107	8	0	8	26.0449620443
104	109	14	6	8	19.9456278085
104	110	14	6	8	13.6093735032
104	111	21	0	21	15.048855197
104	112	310	2	308	8.97049549737
104	113	265	8	257	15.6005585098
104	114	9	3	6	10.1687737063
104	115	1	0	1	20.5758058637
104	116	9	1	8	18.6358733371
104	118	5	0	5	21.5942855158
104	119	10	0	10	24.4366561876
104	120	105	9	96	5.74710731069
104	121	3	0	3	18.0710797409
104	122	1	0	1	19.600602321
104	124	2	0	2	38.5691953905
104	128	1	0	1	34.8795940775
104	129	4	2	2	17.305148424
104	133	1	0	1	22.8070334169
104	134	2	0	2	23.866727705
104	135	1	0	1	44.254271643
104	137	1	0	1	28.209887417
104	138	1	0	1	24.2171692464
104	140	19	7	12	19.4451191066
104	141	1	0	1	57.1897332954
104	142	80	1	79	28.7366190689
104	145	1	0	1	29.1862345794
104	146	7	0	7	21.3401119936
104	147	1	0	1	46.9707591309
104	151	1	1	0	45.9098395979
104	153	1	0	1	45.66380678
104	154	1	0	1	37.6447484173
104	155	8	0	8	32.1355550973
104	156	4	0	4	31.3872192286
104	164	6	1	5	27.1202794572
104	166	2	0	2	40.5232050126
104	168	8	0	8	30.5300157988
104	169	6	2	4	31.3990832581
104	171	13	2	11	28.6356508629
104	172	10	0	10	33.5355692941
104	177	6	0	6	36.7612487382
104	182	1	0	1	90.2981935246
104	183	3	0	3	82.7984694866
104	206	1	0	1	67.8920893541
104	208	2	0	2	75.9082218978
104	220	0	0	0	100.918988023
104	223	0	0	0	86.4321769271
104	238	1	0	1	74.6758639624
104	244	1	0	1	115.93423041
104	245	20	2	18	17.3940392901
104	247	2	1	1	35.2430669136
104	248	2	0	2	24.1479523205
104	254	1	0	1	25.861889874
104	256	6	5	1	9.92325798553
104	257	9	2	7	17.4045763788
104	259	1	0	1	31.5242818358
104	260	2	0	2	14.2086673919
104	267	1	0	1	55.3831827136
104	270	1	0	1	44.2233408442
104	272	2	0	2	56.0606432829
104	277	23	7	16	43.1687817976
104	281	1	0	1	36.5783693794
104	282	1	0	1	40.2929986487
104	285	0	0	0	54.3911506605
104	286	1	0	1	36.4138235704
104	288	1	0	1	53.7325390315
104	293	1	0	1	50.1683293784
104	303	6	0	6	32.7949204052
104	304	1	0	1	21.9446254543
104	305	5	0	5	30.0041117653
104	307	7	0	7	26.8764485619
104	309	5	0	5	20.6108238343
104	317	1	0	1	59.0318238031
104	319	5	0	5	60.655621182
104	320	1	0	1	64.4040794504
104	321	1	0	1	54.3807115209
104	329	3	0	3	46.1108078932
104	338	1	1	0	61.5403705377
104	350	2	1	1	43.7442276605
104	353	0	0	0	48.0703945174
104	357	1	0	1	62.217792944
104	375	0	0	0	74.465238979
104	406	1	0	1	95.8954362864
104	408	2	0	2	96.820287278
104	411	1	0	1	94.0083925514
104	415	1	0	1	86.793430837
104	442	1	0	1	116.85502484
104	465	0	0	0	77.4232790641
104	466	1	0	1	82.614197173
104	469	0	0	0	69.614337618
104	471	1	0	1	67.6539748196
104	476	1	0	1	53.7846283548
104	483	0	0	0	103.217166582
104	485	0	0	0	98.9058100958
104	503	2	0	2	83.3414689994
104	507	1	0	1	177.4211346
104	529	1	0	1	139.699001445
104	573	3	0	3	68.1208958657
104	576	1	0	1	52.3789944311
104	585	0	0	0	81.7729431139
104	586	1	0	1	90.1584109963
105	0	5	0	5	22.2115174768
105	1	87	0	87	34.9960265931
105	3	15	5	10	18.1109455068
105	5	1	0	1	43.6061879348
105	7	1	0	1	26.240776643
105	9	2	0	2	22.3664406653
105	13	6	3	3	23.6410214649
105	15	1	0	1	28.9948410557
105	17	1	0	1	36.0321675335
105	18	2	0	2	19.9896738847
105	19	3	1	2	20.201477847
105	21	2	0	2	39.3014586432
105	23	2	0	2	36.2439553798
105	24	2	0	2	34.1829458759
105	28	1	0	1	30.8636058478
105	32	14	0	14	16.0354462525
105	33	1	0	1	24.6480988894
105	34	1	0	1	36.7436918912
105	35	1	0	1	29.4627223113
105	36	66	13	53	16.6268985666
105	39	24	5	19	13.3869670969
105	40	5	0	5	11.1673963723
105	41	5	0	5	23.7161031681
105	42	13	3	10	14.2374466634
105	48	1	0	1	56.8559452244
105	50	1	0	1	46.9754509408
105	51	2	0	2	41.5124718419
105	59	1	0	1	70.6362569175
105	60	1	0	1	50.5020515888
105	68	1	0	1	47.6498814975
105	70	118	10	108	13.9788391906
105	71	14	2	12	20.6513745334
105	72	28	10	18	10.1767953623
105	73	786	12	774	12.521441078
105	74	38	23	15	16.7415096249
105	75	66	3	63	14.5838484437
105	76	31	21	10	16.1890687044
105	77	18	11	7	9.6054340946
105	78	57	6	51	17.0049212752
105	79	190	47	143	9.32968938751
105	80	12	3	9	11.2052325165
105	81	99	35	64	11.800343325
105	82	43	7	36	15.1827348447
105	83	33	3	30	13.8275444634
105	84	91	28	63	13.9286090885
105	85	22	0	22	19.6685116423
105	86	14	0	14	21.5323206859
105	87	57	18	39	17.3162991053
105	88	9	0	9	19.1789958957
105	89	346	0	346	5.3754174282
105	90	10	0	10	22.6701102946
105	92	95	15	80	10.9393676914
105	94	5	0	5	21.7198673895
105	95	154	11	143	9.09977741883
105	96	23	18	5	25.0281289711
105	97	2	0	2	29.3895960434
105	99	1	0	1	22.0035477869
105	100	15	3	12	9.52387123938
105	101	6	4	2	14.3495494245
105	102	111	2	109	6.91111849571
105	103	89	14	75	14.8307509454
105	104	134	39	95	4.92605195509
105	106	91	0	91	4.80975348804
105	107	3	1	2	28.3398461642
105	109	22	3	19	18.2198990587
105	110	5	0	5	17.9820560952
105	111	47	11	36	11.1010186112
105	112	130	4	126	13.2978806476
105	113	139	0	139	19.0002452908
105	114	7	0	7	15.0935349052
105	115	1	0	1	16.4411439201
105	116	10	2	8	18.0630694945
105	117	2	0	2	19.6463087098
105	118	2	0	2	21.5335561561
105	119	1	0	1	24.657816567
105	120	122	59	63	6.36671834853
105	121	4	2	2	21.0100456859
105	122	5	0	5	16.4280251167
105	123	6	0	6	10.6043589152
105	124	2	1	1	43.4523731562
105	127	3	0	3	27.6556234136
105	129	2	0	2	22.2118197218
105	131	0	0	0	57.8400161601
105	134	1	0	1	28.3661136341
105	135	1	0	1	48.1394634977
105	137	1	0	1	31.2812380978
105	138	0	0	0	29.1425431948
105	140	9	0	9	23.5741511103
105	142	50	0	50	33.0759375618
105	144	1	0	1	34.1400213496
105	146	1	0	1	24.2201364422
105	147	1	0	1	51.1593664069
105	154	1	0	1	41.2293260162
105	155	1	0	1	31.8325565786
105	164	1	0	1	28.3882866764
105	166	2	0	2	39.8605316742
105	168	1	0	1	32.247036306
105	169	4	1	3	29.3167944757
105	171	6	0	6	29.0255858126
105	177	2	1	1	38.3816344502
105	179	2	0	2	32.1829611205
105	183	4	0	4	78.8276041812
105	186	1	0	1	73.531238634
105	190	1	0	1	77.7927999895
105	208	3	1	2	70.9822939144
105	213	1	0	1	76.4709046
105	220	3	0	3	96.6516704731
105	229	3	1	2	78.0522621679
105	241	1	0	1	116.822187015
105	242	0	0	0	110.868293787
105	245	71	0	71	12.5179483209
105	246	1	0	1	15.0859691414
105	247	1	0	1	30.7287560843
105	248	1	0	1	19.276762604
105	250	3	1	2	21.1859419357
105	251	8	0	8	21.9710643722
105	252	1	0	1	26.1151316183
105	254	2	0	2	20.9452411575
105	255	1	0	1	20.9974501784
105	256	78	0	78	7.53422136488
105	257	66	1	65	13.8619944332
105	258	2	0	2	15.9639540752
105	260	16	5	11	10.0790512208
105	261	1	0	1	22.1724678626
105	262	6	1	5	26.8276739787
105	263	1	0	1	21.2322788585
105	264	3	0	3	19.6260103923
105	270	1	0	1	41.2161380146
105	275	1	0	1	43.321600426
105	277	34	6	28	38.9828005337
105	281	0	0	0	31.9706488907
105	282	3	0	3	35.561803055
105	284	2	0	2	44.6478442895
105	286	1	0	1	31.5600756944
105	293	2	0	2	45.242670733
105	303	3	0	3	33.4142647343
105	305	2	0	2	26.9098263821
105	307	5	0	5	25.642051346
105	308	1	0	1	32.799118144
105	309	7	2	5	20.4292177264
105	319	1	0	1	60.4379474877
105	353	0	0	0	45.2844859827
105	367	1	0	1	56.0405791652
105	408	1	0	1	100.914703082
105	454	0	0	0	72.7624992834
105	465	1	0	1	82.1580456665
105	466	1	0	1	87.4398878867
105	475	1	0	1	68.8849553562
105	484	1	0	1	79.7720389964
105	485	0	0	0	103.819759472
105	491	1	0	1	81.973724294
105	503	1	0	1	87.7574610002
105	552	1	0	1	107.707127056
105	581	1	0	1	54.8316984927
106	0	6	0	6	23.5443275865
106	1	72	2	70	35.3256880056
106	3	5	0	5	19.8347981392
106	7	1	0	1	27.8464024384
106	12	1	0	1	45.2082320562
106	13	4	0	4	25.7383703291
106	15	4	1	3	30.6696333639
106	18	1	0	1	22.275565834
106	19	2	0	2	21.1188748062
106	21	2	0	2	40.6202800782
106	24	1	0	1	36.0126658266
106	27	1	0	1	47.3740458347
106	28	1	0	1	30.8138103165
106	29	0	0	0	52.3130035209
106	32	10	0	10	15.417041375
106	33	4	2	2	27.6406772369
106	36	38	12	26	20.2540155955
106	39	14	5	9	14.4449994973
106	41	3	0	3	27.2514511377
106	42	10	0	10	16.6222873202
106	48	0	0	0	60.6105023273
106	59	1	0	1	74.2942608189
106	62	1	0	1	77.4908290462
106	65	1	0	1	66.8548194886
106	70	71	32	39	16.8029543434
106	71	11	3	8	24.7682571286
106	72	23	0	23	13.4610344715
106	73	689	513	176	16.8896259082
106	74	34	0	34	20.7941934874
106	75	34	3	31	19.0845615969
106	76	25	3	22	19.3273970774
106	77	10	1	9	13.3175077465
106	78	53	0	53	20.8057769169
106	79	103	10	93	13.3378456979
106	80	6	1	5	14.9449187547
106	81	61	17	44	15.3456680796
106	82	42	15	27	18.7369994965
106	83	21	5	16	17.9199574116
106	84	98	4	94	18.2360435716
106	85	15	0	15	23.0069703163
106	86	11	1	10	25.4127535223
106	87	28	0	28	21.7252367137
106	88	11	4	7	23.4971812364
106	89	392	48	344	6.59941339344
106	90	18	1	17	25.0695862087
106	92	77	2	75	12.6991420265
106	93	1	0	1	26.9526441179
106	94	2	0	2	21.0501963943
106	95	51	6	45	13.8576472009
106	96	19	7	12	26.555792148
106	97	1	0	1	28.5015959449
106	99	2	0	2	26.7239877962
106	100	10	0	10	13.011539593
106	101	5	0	5	12.3309317499
106	102	68	1	67	8.57741150278
106	103	56	9	47	19.6184628591
106	104	40	6	34	9.44896076886
106	105	112	13	99	4.80975348804
106	108	0	0	0	24.3802863588
106	109	16	7	9	19.9736499881
106	110	4	1	3	22.780940027
106	111	65	1	64	10.6193949892
106	112	76	7	69	18.0945941666
106	113	80	7	73	23.7141051514
106	114	2	0	2	19.5072481383
106	115	3	0	3	15.0721064951
106	116	2	0	2	20.8198844298
106	117	1	0	1	24.1802286882
106	118	1	0	1	24.533469305
106	119	2	0	2	27.7710772518
106	120	37	18	19	10.7604663286
106	122	6	1	5	16.6353233141
106	123	7	4	3	7.93503857916
106	134	1	0	1	33.1534947666
106	140	1	0	1	28.3820671863
106	141	1	0	1	66.021077624
106	142	36	24	12	37.8837804011
106	144	2	0	2	38.8835402566
106	146	3	0	3	28.7505672708
106	148	1	0	1	38.450717673
106	155	1	0	1	34.4074048379
106	156	2	1	1	32.2806474311
106	168	1	0	1	36.1791799428
106	169	3	0	3	30.2955880205
106	171	1	0	1	32.1683689737
106	177	3	0	3	42.2090269783
106	182	1	0	1	81.7735747421
106	183	1	1	0	74.0872264972
106	187	1	0	1	76.7506223491
106	188	1	0	1	75.4212389972
106	208	1	0	1	66.7866814051
106	212	1	0	1	55.3396863482
106	214	1	0	1	59.9883302385
106	220	2	0	2	91.8479829693
106	239	1	0	1	68.5088562521
106	242	0	0	0	106.079511299
106	245	151	55	96	8.091559511
106	246	4	0	4	12.0584193955
106	248	3	1	2	15.7341633996
106	249	0	0	0	22.6569679671
106	250	1	0	1	16.4780643163
106	251	1	0	1	19.5511513526
106	252	1	0	1	21.6507317941
106	253	1	0	1	28.3440499526
106	254	5	0	5	16.664488666
106	256	58	19	39	5.64770536348
106	257	136	45	91	9.61117588543
106	258	9	8	1	13.1664584744
106	259	1	0	1	22.5861722347
106	260	60	1	59	5.47130679544
106	262	2	0	2	22.0361421129
106	264	9	1	8	15.4585368896
106	274	1	0	1	27.5405711207
106	277	39	17	22	34.2009937786
106	279	1	0	1	27.5192565251
106	281	2	1	1	27.1885616626
106	282	3	1	2	30.847667597
106	284	1	0	1	39.9959524529
106	293	2	0	2	41.08656113
106	303	1	0	1	32.3823633818
106	304	1	0	1	23.0818352632
106	305	4	1	3	22.7371943418
106	307	13	0	13	23.0600513716
106	309	2	0	2	19.0630075755
106	323	1	0	1	58.6621640505
106	338	1	0	1	58.5984215965
106	348	1	0	1	33.3992950518
106	408	0	0	0	105.70622778
106	462	2	0	2	82.5838963493
106	465	0	0	0	86.8626042252
106	471	2	0	2	76.7745108303
106	477	1	0	1	83.8115757193
106	491	1	0	1	86.4283951371
106	496	1	0	1	83.2736232464
106	503	1	0	1	92.5635238376
107	0	5	0	5	41.4681432794
107	1	53	7	46	54.9059294203
107	2	1	0	1	43.8778064267
107	3	0	0	0	37.5580885668
107	4	0	0	0	46.8412364251
107	7	4	0	4	43.3849767712
107	10	1	0	1	41.9580123739
107	11	1	0	1	69.939772107
107	13	6	1	5	39.6818890062
107	15	1	0	1	45.1392378497
107	17	2	0	2	47.0542334651
107	18	0	0	0	36.7178139404
107	19	2	0	2	41.2778916177
107	22	1	0	1	62.9053681243
107	23	1	0	1	50.9849229635
107	24	2	0	2	48.4433188068
107	28	3	0	3	52.5045839596
107	31	1	0	1	27.8761172359
107	32	3	0	3	41.3838078494
107	33	1	0	1	36.1109167897
107	34	2	0	2	36.3154716609
107	36	23	4	19	29.2027828514
107	39	5	0	5	36.430886957
107	41	3	0	3	32.3740295058
107	42	1	0	1	33.485185588
107	47	1	0	1	66.6016948365
107	48	0	0	0	54.1700192254
107	56	0	0	0	57.8619881452
107	65	2	0	2	68.2496640322
107	68	1	0	1	44.5927964762
107	70	91	1	90	18.0395462005
107	71	248	75	173	7.92868847993
107	72	17	0	17	19.74178507
107	73	1252	123	1129	15.8207793016
107	74	199	4	195	11.8941312887
107	75	155	33	122	13.9240704097
107	76	33	3	30	15.4188957015
107	77	7	3	4	19.4362509511
107	78	315	60	255	12.3268224112
107	79	38	0	38	19.2717844759
107	80	2	0	2	17.8655567367
107	81	50	0	50	17.724157994
107	82	55	10	45	14.7210279455
107	83	60	3	57	14.6985431422
107	84	130	92	38	14.413198296
107	85	95	14	81	12.231411812
107	86	166	1	165	8.05538551877
107	87	233	1	232	11.0964295792
107	88	132	78	54	9.16537200283
107	89	15	0	15	26.9407495984
107	90	15	2	13	16.4120001752
107	92	10	0	10	22.9061634257
107	95	50	3	47	22.1880047569
107	96	17	0	17	21.4069277979
107	98	176	96	80	5.87768883375
107	99	4	0	4	19.0033221599
107	100	2	0	2	28.708734146
107	102	4	0	4	32.1248734214
107	103	168	13	155	15.8865168183
107	104	3	1	2	26.0449620443
107	109	6	1	5	20.3338536708
107	110	15	3	12	16.8320958838
107	111	10	1	9	28.2997317289
107	112	68	35	33	18.9949885072
107	113	309	5	304	11.5930327899
107	114	1	0	1	23.6788574601
107	116	7	4	3	15.9351256078
107	117	25	4	21	9.31407910796
107	118	5	2	3	13.1811486039
107	119	14	1	13	11.574162288
107	120	4	0	4	21.977351795
107	121	35	19	16	8.46612043417
107	122	2	0	2	26.3694575795
107	124	1	0	1	33.5881036387
107	127	7	0	7	10.6491347798
107	128	4	1	3	17.7349968352
107	129	7	3	4	23.3052046647
107	131	3	0	3	45.5137983694
107	134	8	1	7	17.4385157499
107	135	1	0	1	24.1709763688
107	136	3	0	3	25.8309304926
107	137	54	26	28	5.93040479349
107	138	2	0	2	27.3768883452
107	140	42	3	39	13.4260422995
107	142	218	3	215	17.3175875903
107	143	2	0	2	24.1596408779
107	144	2	2	0	12.1092885594
107	145	1	1	0	25.1860010469
107	146	89	66	23	5.62731376042
107	147	7	1	6	29.1092351135
107	148	1	0	1	28.766479092
107	151	2	0	2	39.6389643074
107	152	2	0	2	30.6394978383
107	153	1	0	1	31.1517508501
107	154	3	1	2	16.3142454492
107	155	16	0	16	16.6153637366
107	156	6	0	6	20.2620247792
107	157	4	0	4	14.5252975881
107	158	4	0	4	16.2431028877
107	159	1	0	1	18.7261725013
107	160	2	0	2	11.214222922
107	163	2	0	2	23.5357129815
107	164	79	0	79	6.17086829249
107	166	14	1	13	23.9999268845
107	167	1	1	0	23.6688820009
107	168	64	28	36	5.63800853368
107	169	4	0	4	25.7341145652
107	171	61	0	61	11.3885597882
107	172	160	16	144	7.49181480541
107	175	12	5	7	11.0908462699
107	177	74	0	74	11.4460179173
107	178	1	0	1	27.9491084474
107	180	1	1	0	19.4198567839
107	183	1	1	0	105.852043238
107	190	1	0	1	105.707166088
107	208	0	0	0	89.2449840198
107	220	0	0	0	122.57316136
107	225	0	0	0	94.6898762197
107	229	1	0	1	99.9611923069
107	232	0	0	0	89.1694260433
107	242	0	0	0	135.046519015
107	245	5	1	4	37.8649296221
107	247	1	0	1	44.2347856897
107	254	1	0	1	44.0804428662
107	268	1	0	1	89.4314163876
107	275	1	0	1	71.0694612208
107	277	11	0	11	65.8820066657
107	279	1	0	1	60.0425764459
107	281	1	0	1	57.4484588146
107	282	0	0	0	60.0059567612
107	291	1	0	1	76.6975333022
107	303	3	0	3	57.3475853737
107	307	2	0	2	52.8980430193
107	310	1	0	1	55.5051672664
107	314	1	0	1	57.2948546318
107	319	11	0	11	39.5708713974
107	323	3	0	3	31.6978691649
107	326	1	0	1	37.2426384947
107	327	0	0	0	45.3926853435
107	329	14	0	14	31.2946942918
107	338	5	1	4	53.1503520256
107	357	1	0	1	47.5127644439
107	375	1	0	1	81.1112224574
107	377	1	0	1	66.5851037542
107	379	1	0	1	60.0356906821
107	386	0	0	0	60.2469425352
107	392	0	0	0	52.9409539684
107	406	2	0	2	76.2578134058
107	408	1	0	1	76.1043576138
107	411	2	0	2	72.1793559852
107	421	1	0	1	93.1409554422
107	460	1	0	1	52.3867840548
107	464	1	0	1	59.1777188879
107	465	0	0	0	64.0538903712
107	466	1	0	1	70.9621621697
107	469	3	0	3	57.424207247
107	470	1	0	1	48.9065038738
107	472	1	0	1	52.0018460449
107	475	2	0	2	47.3180767766
107	476	2	0	2	49.1059867458
107	477	1	0	1	64.0954868251
107	478	1	0	1	75.3771768941
107	484	1	0	1	73.8434674088
107	485	1	0	1	90.0387676368
107	487	1	0	1	76.859779444
107	492	1	0	1	79.4977078312
107	494	1	0	1	54.5537099315
107	503	3	0	3	65.5214558014
107	507	1	0	1	151.380212532
107	561	0	0	0	81.8526724853
107	563	1	0	1	57.3805693929
107	571	1	0	1	53.4448765211
107	573	11	5	6	42.0778255786
107	576	3	0	3	27.6540395208
107	579	2	0	2	34.8193301859
107	581	6	1	5	27.1475313506
108	0	1	0	1	46.1538615852
108	1	10	0	10	59.0510399529
108	4	1	0	1	55.1523552176
108	13	1	0	1	47.0640772465
108	28	1	0	1	54.8261155854
108	36	1	0	1	38.0994687339
108	48	0	0	0	75.1392298858
108	60	1	0	1	69.6320297795
108	70	77	8	69	13.9017936439
108	71	7	1	6	21.7109479927
108	72	5	1	4	16.8851252987
108	73	159	85	74	21.4806631277
108	74	17	9	8	19.9699272771
108	75	14	0	14	23.0352220081
108	76	20	4	16	14.6499298083
108	77	5	1	4	18.4101088438
108	78	25	0	25	18.322484685
108	79	13	11	2	19.569303826
108	80	0	0	0	18.1209548168
108	81	18	2	16	17.2146302731
108	82	15	2	13	16.7879671653
108	83	6	0	6	19.7895291237
108	84	17	2	15	21.2623087362
108	85	14	0	14	15.8674960615
108	87	3	0	3	23.0539897863
108	88	4	0	4	22.907731965
108	89	14	0	14	18.7468795282
108	90	54	15	39	10.8775025496
108	92	25	1	24	13.5567587986
108	93	5	4	1	11.2770354682
108	94	18	10	8	5.47515496974
108	95	8	1	7	27.4837384754
108	96	358	18	340	6.60078694852
108	97	21	6	15	8.1660458858
108	99	1	0	1	36.3534199631
108	101	3	0	3	14.1123062237
108	102	3	0	3	30.9739602082
108	103	13	2	11	27.2821281191
108	104	2	0	2	26.8540918345
108	105	0	0	0	24.0629624548
108	106	3	0	3	24.3802863588
108	107	2	1	1	27.2678105459
108	109	81	67	14	8.3581586885
108	110	2	0	2	31.5709146738
108	111	8	1	7	13.7763539924
108	112	8	0	8	28.8468016487
108	113	14	0	14	27.6970008548
108	115	5	1	4	10.9637944638
108	116	15	2	13	12.6103896212
108	118	2	1	1	14.169447793
108	119	9	1	8	15.9208907551
108	120	5	0	5	21.621243286
108	121	1	0	1	26.6206380183
108	122	18	5	13	7.75950371522
108	127	1	0	1	34.6964726303
108	128	0	0	0	44.6079517848
108	140	3	0	3	33.7402026312
108	142	10	0	10	42.1233278438
108	143	1	0	1	50.252494843
108	155	4	0	4	16.5856504763
108	156	2	1	1	11.9994798427
108	166	3	0	3	20.9164628482
108	169	5	0	5	6.73348505153
108	177	0	0	0	30.4687578552
108	179	2	0	2	8.18305585301
108	183	0	0	0	85.3777501646
108	214	1	0	1	54.736242967
108	245	7	0	7	22.9779183263
108	247	4	2	2	17.5860108038
108	249	1	0	1	22.77948194
108	250	1	0	1	28.4660908339
108	251	15	3	12	13.558582947
108	253	2	0	2	27.6913493437
108	271	1	0	1	61.6999686626
108	277	4	0	4	47.1713721678
108	279	1	0	1	44.8105640219
108	281	1	0	1	37.3888882213
108	282	1	0	1	38.3564989106
108	293	1	0	1	38.9678741665
108	310	3	0	3	28.8678878339
108	319	1	0	1	41.2663866782
108	329	2	0	2	23.3019638684
108	348	7	4	3	11.1116195451
108	349	1	0	1	30.1210147664
108	351	2	0	2	26.51434558
108	353	2	0	2	21.2559401885
108	358	1	0	1	79.2276265667
108	465	0	0	0	91.1240645235
108	475	1	0	1	74.5847542595
108	551	0	0	0	66.5777950633
108	568	1	0	1	55.4587534561
109	0	6	0	6	39.5056319036
109	1	41	5	36	52.8330788232
109	3	1	0	1	35.2104123869
109	7	1	0	1	43.0812111182
109	13	4	0	4	39.9350018806
109	19	1	0	1	37.9042027915
109	24	3	0	3	50.4294646519
109	27	1	0	1	60.1516034564
109	28	1	0	1	48.9286210812
109	30	1	0	1	45.7766937465
109	32	1	0	1	34.2522751453
109	36	20	1	19	30.4497839426
109	38	1	0	1	40.1385241305
109	39	6	0	6	31.25587336
109	41	2	0	2	36.7758446034
109	42	3	1	2	30.8839497887
109	46	3	0	3	71.2079492638
109	48	1	0	1	66.8023336548
109	50	1	0	1	58.470891235
109	54	1	0	1	50.2187368556
109	59	0	0	0	80.6226813772
109	65	0	0	0	77.3942612702
109	68	1	0	1	57.0294096866
109	70	1218	0	1218	5.7239752718
109	71	60	0	60	13.8274937085
109	72	57	4	53	9.25296296761
109	73	1720	27	1693	13.2169513549
109	74	121	0	121	11.6766252976
109	75	135	1	134	14.6852124841
109	76	364	0	364	6.31936559455
109	77	32	11	21	10.6817113815
109	78	324	80	244	10.0718202123
109	79	97	6	91	11.7825937982
109	80	30	1	29	10.0808030844
109	81	247	21	226	9.13464869409
109	82	230	133	97	8.43108502635
109	83	70	4	66	11.4503814365
109	84	198	0	198	12.9218260105
109	85	386	108	278	8.1997498599
109	86	57	1	56	12.5762444968
109	87	125	57	68	14.7465705609
109	88	57	8	49	14.7524466287
109	89	87	32	55	13.483647412
109	90	297	132	165	5.75376178799
109	92	171	33	138	7.36013388783
109	93	2	1	1	18.471829688
109	94	11	0	11	10.5065972479
109	95	39	5	34	19.7783840122
109	96	638	0	638	6.82099213771
109	97	3	1	2	16.314188103
109	98	1	0	1	14.7906523123
109	99	3	0	3	28.0023400161
109	100	0	0	0	25.2497298135
109	101	5	0	5	13.807219897
109	102	6	0	6	24.9164008813
109	103	68	16	52	18.9733345969
109	104	4	0	4	19.9456278085
109	105	7	0	7	18.2198990587
109	106	5	1	4	19.9736499881
109	107	6	0	6	20.3338536708
109	108	16	14	2	8.3581586885
109	110	3	0	3	23.2342850797
109	111	40	3	37	10.7362432795
109	112	94	23	71	20.6950245835
109	113	165	60	105	19.373066717
109	114	3	1	2	26.0222857474
109	115	8	1	7	11.7650444215
109	116	210	92	118	4.56390895071
109	117	5	0	5	17.1771925299
109	118	21	18	3	7.40793985012
109	119	50	11	39	10.2564286466
109	120	26	0	26	14.3226631551
109	121	3	0	3	18.4709939531
109	122	51	5	46	6.38435454048
109	123	1	0	1	15.8271961936
109	124	2	0	2	48.9195774144
109	128	0	0	0	37.0281371198
109	131	3	0	3	62.5357135206
109	133	0	0	0	34.0498475266
109	137	0	0	0	25.8136245402
109	139	1	0	1	55.9140626085
109	140	4	2	2	25.4492680817
109	142	40	5	35	34.0555003722
109	143	1	0	1	42.3368670869
109	145	3	0	3	39.1987967111
109	146	6	0	6	20.0141387832
109	147	0	0	0	49.0725513286
109	152	1	1	0	48.1954259924
109	154	1	0	1	36.5777694843
109	155	28	5	23	14.872876909
109	156	17	1	16	12.3069977284
109	158	1	0	1	28.6605977667
109	162	2	0	2	16.1522926812
109	164	7	0	7	16.4941993394
109	166	9	1	8	22.0648087817
109	168	8	2	6	21.1035227528
109	169	38	0	38	11.4819793222
109	171	18	0	18	14.1232564617
109	172	13	2	11	25.7775867073
109	175	8	1	7	19.2283215446
109	177	9	5	4	25.9859160683
109	179	5	1	4	15.2123309678
109	181	0	0	0	75.3573667623
109	183	5	0	5	87.8118408235
109	208	1	0	1	68.9390520191
109	212	1	0	1	60.1061130897
109	222	0	0	0	98.8232545135
109	225	1	0	1	74.4738959589
109	241	1	0	1	120.445684308
109	242	0	0	0	115.2099269
109	245	16	1	15	21.4181174059
109	247	6	0	6	23.9808872172
109	250	1	0	1	28.9113819101
109	251	17	0	17	17.4095131183
109	254	2	0	2	25.4000969946
109	257	0	0	0	28.8138021928
109	264	2	0	2	34.4050147897
109	270	1	0	1	55.0337936854
109	274	3	0	3	41.809429932
109	275	1	0	1	54.5914078916
109	276	1	0	1	42.3008754824
109	277	18	0	18	48.4134707179
109	279	2	0	2	44.3920198365
109	281	1	0	1	39.1499436939
109	282	2	0	2	41.0292624437
109	287	1	0	1	50.1803922247
109	294	0	0	0	45.0256920027
109	303	1	1	0	51.6272427586
109	305	1	0	1	41.3268074603
109	307	1	0	1	43.0334191367
109	309	2	0	2	38.5404898665
109	310	3	0	3	37.0963004999
109	319	13	0	13	42.9014218685
109	320	4	1	3	47.6339305251
109	321	3	1	2	35.6854068696
109	323	2	0	2	39.4097696408
109	327	1	0	1	46.5972202582
109	329	19	0	19	26.6755146586
109	332	1	0	1	50.9368740856
109	338	3	0	3	41.9445140801
109	341	2	0	2	45.7780357087
109	347	4	0	4	20.3706366086
109	348	6	0	6	19.4381392872
109	350	4	0	4	30.1521789485
109	351	1	0	1	32.6586581394
109	353	4	0	4	28.5979542553
109	354	0	0	0	25.4266300693
109	364	1	0	1	51.7380528779
109	375	0	0	0	61.955412364
109	377	2	1	1	48.2873167048
109	379	1	0	1	79.5912483453
109	398	1	0	1	109.140847441
109	406	1	0	1	96.5825304119
109	408	1	0	1	96.345367901
109	425	1	0	1	116.410170765
109	464	0	0	0	76.0603745594
109	466	1	0	1	89.9822152882
109	469	0	0	0	76.4466397734
109	472	0	0	0	69.7817014329
109	475	2	0	2	67.4033367357
109	479	1	0	1	73.0239714241
109	480	2	0	2	77.7007801299
109	484	0	0	0	88.5988622157
109	485	1	0	1	108.321189204
109	486	1	0	1	98.1600298709
109	495	0	0	0	91.0293476072
109	496	1	0	1	77.0777342484
109	503	3	0	3	85.7814902477
109	505	2	0	2	102.568355378
109	537	0	0	0	114.180378034
109	556	1	0	1	100.77559126
109	573	7	0	7	57.316892681
109	576	1	0	1	38.4453224359
109	577	1	0	1	46.2863284588
109	581	1	0	1	41.7568143241
110	0	4	0	4	24.8222754533
110	1	70	0	70	38.1144194325
110	2	1	0	1	27.2268639589
110	3	2	0	2	21.1177486948
110	4	1	0	1	30.0802112074
110	5	1	0	1	43.2085628181
110	6	1	0	1	47.0112296549
110	7	6	0	6	26.5586787517
110	9	1	0	1	27.1345298299
110	13	11	0	11	22.8530179386
110	15	6	0	6	28.3189620643
110	18	4	0	4	19.9691783877
110	19	1	0	1	24.9317699766
110	21	1	0	1	38.1697446965
110	23	3	0	3	34.3304599654
110	24	2	0	2	31.7990499814
110	27	1	0	1	39.2748713672
110	28	3	1	2	35.9164235562
110	31	5	1	4	12.1668304764
110	32	2	0	2	26.4068668303
110	33	5	2	3	19.4511563291
110	34	3	1	2	23.5639660909
110	35	2	0	2	22.5532960509
110	36	81	0	81	12.4377691225
110	39	2	0	2	21.0395484188
110	41	11	1	10	15.9226378844
110	42	4	1	3	17.3764343358
110	47	1	0	1	56.2528067359
110	48	1	0	1	43.5691978845
110	50	2	0	2	35.4521332933
110	60	2	0	2	38.1775624625
110	61	1	0	1	56.7418386067
110	65	2	0	2	54.8202712717
110	66	1	0	1	38.1337123532
110	68	2	0	2	33.8031792975
110	70	48	15	33	17.7311893445
110	71	14	4	10	13.0671870017
110	72	6	1	5	15.7081510381
110	73	496	70	426	10.1958490387
110	74	47	0	47	12.2490226876
110	75	131	25	106	8.5651370866
110	76	24	1	23	17.1002223406
110	77	4	1	3	14.2836672624
110	78	64	29	35	13.9377154413
110	79	29	6	23	13.2131100359
110	80	7	2	5	13.8767741811
110	81	36	0	36	14.6496269727
110	82	16	4	12	14.880623847
110	83	14	9	5	11.7841874132
110	84	87	13	74	10.3124598999
110	85	14	5	9	17.5166550407
110	86	16	3	13	15.2199077406
110	87	77	1	76	9.42374809527
110	88	42	15	27	10.7621549078
110	89	15	0	15	19.9567519567
110	90	5	1	4	23.5046527526
110	92	15	4	11	20.0867917921
110	95	68	3	65	8.98504594442
110	96	9	2	7	28.4333239976
110	97	1	0	1	39.2694712129
110	98	4	0	4	18.1353186716
110	99	81	29	52	4.85958555924
110	100	3	0	3	13.6630927523
110	102	7	1	6	18.5031075969
110	103	346	40	306	4.37264004523
110	104	6	1	5	13.6093735032
110	105	3	0	3	17.9820560952
110	107	7	0	7	16.8320958838
110	109	3	0	3	23.2342850797
110	111	5	1	4	24.504816211
110	112	304	107	197	4.68685157944
110	113	512	354	158	5.60807843023
110	114	21	11	10	7.04048538465
110	115	1	0	1	29.6874013552
110	116	7	3	4	19.4744536898
110	117	8	4	4	8.63587217566
110	118	1	0	1	20.1691807337
110	119	5	1	4	21.5226568641
110	120	10	2	8	13.3673744449
110	121	15	3	12	8.69903971101
110	122	1	0	1	26.4266304244
110	124	2	1	1	26.6929959435
110	127	3	1	2	10.7887829292
110	128	4	0	4	21.3729604052
110	129	11	7	4	7.85522225999
110	131	1	0	1	40.9191847929
110	133	6	0	6	11.0389068711
110	134	16	3	13	10.4041839536
110	137	3	1	2	16.6191382053
110	138	0	0	0	14.3397373404
110	140	78	53	25	6.00272089422
110	142	84	0	84	15.1346621582
110	144	2	0	2	17.3263396417
110	145	4	0	4	16.8865458691
110	146	15	7	8	11.2100627368
110	147	1	0	1	33.3674189876
110	148	1	0	1	18.1553495239
110	152	1	0	1	27.8690614789
110	155	2	0	2	29.3761093913
110	160	1	0	1	23.3492119945
110	164	7	0	7	20.703939275
110	166	2	0	2	37.9216185836
110	168	2	0	2	22.3577555772
110	169	1	1	0	33.6252768333
110	171	2	0	2	24.4524128611
110	172	3	0	3	23.7724783428
110	177	1	0	1	28.2683751639
110	179	2	0	2	37.9905011468
110	180	1	0	1	35.1330097915
110	208	1	0	1	87.7181978416
110	220	2	0	2	114.516011303
110	229	0	0	0	95.7460254943
110	241	1	0	1	134.782472768
110	243	1	0	1	123.228116409
110	245	8	0	8	30.2827107252
110	251	1	0	1	36.2681471911
110	254	1	0	1	38.3616970064
110	257	2	0	2	30.9694802758
110	271	1	0	1	75.8104617293
110	274	1	0	1	50.2024595262
110	277	6	0	6	56.7729395303
110	280	1	0	1	64.3164099645
110	282	1	0	1	53.471444797
110	303	5	1	4	41.134636376
110	309	3	2	1	31.2566565916
110	319	2	0	2	55.8089011104
110	329	2	0	2	44.7162745759
110	338	0	0	0	64.0120789128
110	350	2	0	2	52.2405379889
110	375	1	0	1	83.9163707793
110	408	2	0	2	83.2287068255
110	415	2	0	2	73.2462059206
110	465	0	0	0	64.4003012468
110	466	0	0	0	69.9749913937
110	469	2	0	2	56.7431895428
110	472	2	1	1	48.6361409476
110	475	0	0	0	50.9196916089
110	487	1	0	1	69.8011699373
110	490	0	0	0	64.0106262158
110	494	1	0	1	55.7197729471
110	496	1	0	1	60.4928685291
110	503	1	1	0	69.78962181
110	524	1	0	1	99.1387981582
110	563	0	0	0	73.2377108283
110	573	1	0	1	57.6039569079
110	579	1	0	1	51.5154156094
111	0	1	0	1	33.238011334
111	1	45	0	45	45.6675113053
111	5	2	0	2	54.5861581939
111	7	1	0	1	37.325379015
111	9	1	0	1	33.1627220186
111	13	2	0	2	34.735545049
111	19	2	1	1	31.0896753047
111	32	2	0	2	25.9664701484
111	34	1	0	1	46.2661750518
111	36	30	0	30	27.0752255631
111	39	3	1	2	24.2655124927
111	41	1	0	1	34.0916629867
111	42	1	0	1	25.3282233811
111	48	1	0	1	66.575167945
111	50	1	0	1	57.1442837449
111	59	1	0	1	80.4481468134
111	65	1	0	1	74.8202424041
111	70	204	99	105	10.2776820836
111	71	30	1	29	20.5574040279
111	72	99	29	70	9.39176721971
111	73	929	3	926	15.1174274827
111	74	55	6	49	16.90900685
111	75	59	9	50	17.4732552815
111	76	66	29	37	12.9792775357
111	77	31	5	26	10.5026830337
111	78	94	80	14	16.0555740124
111	79	125	4	121	11.4203316479
111	80	21	0	21	11.5183621627
111	81	155	12	143	11.1946374653
111	82	71	19	52	13.6422716655
111	83	23	6	17	14.7729079267
111	84	110	1	109	15.8724091706
111	85	43	5	38	16.5854243713
111	86	22	11	11	20.2881016211
111	87	48	14	34	19.1862118688
111	88	13	0	13	20.2802808048
111	89	351	336	15	5.8497807144
111	90	24	1	23	16.4250427475
111	92	314	3	311	5.4168486007
111	93	1	1	0	17.6068819592
111	94	4	0	4	10.673707104
111	95	34	7	27	17.4126904883
111	96	78	8	70	16.6401337416
111	97	1	0	1	18.3138138355
111	98	2	1	1	23.6362558601
111	99	3	0	3	29.2508838078
111	100	1	0	1	20.3460543754
111	101	48	42	6	4.71554674573
111	102	8	0	8	17.845735998
111	103	53	15	38	20.2921464416
111	104	8	2	6	15.048855197
111	105	16	1	15	11.1010186112
111	106	8	1	7	10.6193949892
111	108	4	3	1	13.7763539924
111	109	49	11	38	10.7362432795
111	110	4	0	4	24.504816211
111	112	60	1	59	20.4122457963
111	113	111	6	105	22.9081563949
111	114	4	0	4	24.2613441512
111	115	44	1	43	5.5515149149
111	116	8	2	6	13.3183652561
111	117	3	0	3	21.9881560617
111	118	4	0	4	17.1205765903
111	119	4	0	4	20.33766878
111	120	20	1	19	11.4518346196
111	121	2	0	2	23.4962944535
111	122	47	8	39	6.07599928251
111	123	17	0	17	5.09991419537
111	124	1	0	1	51.1836424633
111	129	2	0	2	30.7391979743
111	131	1	0	1	65.4215226278
111	140	4	0	4	28.7834872766
111	142	43	0	43	38.3300884617
111	143	1	0	1	46.9394014036
111	146	2	0	2	26.0888416699
111	147	1	0	1	55.2508454265
111	149	1	0	1	66.1744451684
111	154	1	0	1	43.6798217595
111	155	4	2	2	25.6045405012
111	156	2	1	1	22.6739441789
111	162	1	0	1	25.9871749227
111	164	4	0	4	25.9387167043
111	166	4	0	4	32.4700683515
111	168	1	0	1	30.4544214224
111	169	9	1	8	19.8813593291
111	171	2	0	2	24.5345415591
111	172	4	0	4	34.8242067415
111	175	2	0	2	29.5854303925
111	177	2	0	2	35.9189380469
111	183	0	0	0	77.8873808694
111	186	1	0	1	70.8543132736
111	208	3	0	3	63.3705914136
111	212	1	0	1	53.2277696005
111	219	1	0	1	97.6260123359
111	220	2	0	2	94.2877919069
111	224	2	1	1	63.389652638
111	242	0	0	0	106.91424282
111	245	129	1	128	10.6901192611
111	246	30	7	23	7.45735036477
111	247	1	0	1	20.4977518804
111	248	4	0	4	11.8659781224
111	249	1	0	1	18.7971638709
111	250	4	0	4	18.5995095329
111	251	61	14	47	11.8586021833
111	252	2	0	2	21.1486880126
111	253	3	1	2	24.8964410326
111	254	8	1	7	15.7807550157
111	256	2	0	2	16.251348167
111	257	12	1	11	18.4231470612
111	260	7	1	6	14.1662063017
111	261	1	0	1	28.5282648848
111	262	3	0	3	24.7304602092
111	263	1	0	1	20.5456510853
111	274	1	0	1	31.4500274289
111	275	2	0	2	44.046836496
111	276	1	0	1	33.9818605338
111	277	68	0	68	38.142165666
111	279	1	0	1	33.6902627095
111	281	3	0	3	29.2676372693
111	282	4	2	2	31.7062307719
111	286	1	0	1	26.6606495245
111	287	1	0	1	40.8712881997
111	293	2	0	2	37.8901494573
111	296	1	0	1	29.3058095281
111	302	1	0	1	30.6393540177
111	303	1	0	1	43.0001874902
111	305	2	0	2	30.645274443
111	307	3	1	2	33.2190207425
111	317	1	0	1	44.4318957046
111	329	2	0	2	36.3132442906
111	350	2	0	2	28.7664971829
111	352	1	0	1	28.1867359025
111	372	1	0	1	60.0456720176
111	375	1	0	1	59.8890232441
111	415	1	0	1	93.5719948315
111	466	1	0	1	94.2420419178
111	469	0	0	0	80.8764366376
111	473	1	0	1	73.3318984712
111	476	1	0	1	67.0148801221
111	480	1	0	1	80.9296289691
111	488	2	0	2	95.5945817673
111	495	0	0	0	96.4042591395
111	503	2	0	2	92.2575630323
111	545	1	0	1	180.466469939
111	566	0	0	0	76.1554952103
111	573	1	0	1	67.6449770168
112	0	7	0	7	22.7161008783
112	1	154	3	151	36.3528655087
112	2	9	0	9	26.8209251372
112	3	4	0	4	18.6620215616
112	5	1	0	1	42.4515486153
112	6	1	0	1	47.1217128527
112	7	5	0	5	25.1387015875
112	9	1	0	1	24.6263775424
112	11	1	0	1	52.174445281
112	13	15	3	12	21.5335910171
112	15	1	0	1	27.2465316208
112	16	1	0	1	20.8574932742
112	18	3	0	3	18.2166157775
112	19	2	1	1	22.3216474192
112	21	2	0	2	37.5133787049
112	23	1	0	1	33.7971326727
112	24	7	1	6	31.3259309212
112	27	1	0	1	39.9661930077
112	28	5	0	5	33.6362524463
112	31	4	1	3	13.905502888
112	32	6	1	5	22.7175415298
112	33	7	1	6	19.2491509992
112	34	4	1	3	26.3577369546
112	35	7	0	7	23.1056846923
112	36	185	138	47	11.0053689344
112	38	2	2	0	19.5096403053
112	39	17	0	17	17.5536517727
112	41	13	10	3	16.3524319001
112	42	13	4	9	14.5025193068
112	45	1	0	1	58.2234194264
112	46	1	0	1	50.6434111573
112	48	2	0	2	46.6322220471
112	50	2	0	2	37.8632997208
112	53	2	0	2	61.2327574919
112	56	1	0	1	45.7483254505
112	59	1	0	1	60.5172092124
112	65	4	0	4	56.7051634928
112	66	1	0	1	39.7953806502
112	68	1	0	1	36.9772458931
112	70	240	0	240	14.9865549727
112	71	77	2	75	13.3649253245
112	72	39	30	9	12.2302561996
112	73	2076	1142	934	7.57080211905
112	74	135	15	120	11.1665316429
112	75	302	140	162	7.01813449276
112	76	85	9	76	15.0349079437
112	77	26	1	25	10.709691281
112	78	257	0	257	12.6525934175
112	79	175	15	160	9.55558728517
112	80	27	21	6	10.7324319881
112	81	148	36	112	11.6322051935
112	82	89	2	87	12.837550186
112	83	92	5	87	9.62767474968
112	84	364	39	325	8.31121563158
112	85	89	0	89	16.4257032873
112	86	58	0	58	15.2937113425
112	87	190	100	90	9.16165119852
112	88	62	24	38	11.0491705777
112	89	72	0	72	15.530065965
112	90	19	0	19	22.0439968706
112	92	60	0	60	16.4385389226
112	93	1	0	1	37.010745389
112	95	525	280	245	4.32809269103
112	96	19	1	18	26.5608847881
112	98	3	0	3	18.8671287759
112	99	39	7	32	8.97236380151
112	100	17	4	13	9.87210620509
112	101	6	0	6	24.9401172169
112	102	26	7	19	14.1938590644
112	103	773	214	559	3.14835158008
112	104	56	19	37	8.97049549737
112	105	16	3	13	13.2978806476
112	106	5	0	5	18.0945941666
112	107	11	0	11	18.9949885072
112	108	0	0	0	28.8468016487
112	109	25	1	24	20.6950245835
112	110	131	84	47	4.68685157944
112	111	23	0	23	20.4122457963
112	113	801	504	297	7.52065654458
112	114	64	19	45	5.6708521581
112	115	3	0	3	25.764025086
112	116	19	4	15	17.5398933087
112	117	12	0	12	9.78675316068
112	118	1	0	1	19.0906233379
112	119	5	0	5	21.0801356821
112	120	52	40	12	9.02422358528
112	121	8	1	7	10.5371889628
112	122	5	1	4	22.9969334639
112	124	2	0	2	30.873454683
112	128	2	1	1	25.9167328669
112	129	11	0	11	10.483900633
112	131	1	0	1	45.1995158946
112	133	2	1	1	15.0054357257
112	134	10	0	10	15.0724699554
112	135	0	0	0	35.3187561119
112	136	2	0	2	25.7970270979
112	137	2	0	2	20.0098664178
112	138	5	1	4	17.5494462834
112	140	27	5	22	10.480210933
112	141	1	0	1	48.220528505
112	142	76	26	50	19.8126034873
112	143	3	0	3	28.2016046811
112	144	3	0	3	21.5800990694
112	145	3	0	3	21.1621178132
112	146	10	2	8	13.65099698
112	147	1	0	1	38.0072290021
112	151	1	0	1	38.2109325312
112	154	1	0	1	28.8702948369
112	155	12	3	9	29.1160492158
112	156	6	0	6	29.7926489626
112	158	1	0	1	34.9768099988
112	163	1	0	1	37.4406351039
112	164	17	0	17	21.6860170543
112	166	6	0	6	37.7532711899
112	168	10	3	7	24.1690617601
112	169	7	4	3	31.7128627763
112	171	9	4	5	24.6169292292
112	172	19	10	9	26.3453581574
112	175	2	0	2	27.6419538193
112	177	12	2	10	30.3259155563
112	179	1	0	1	35.826923696
112	182	1	0	1	99.2598411451
112	183	3	0	3	91.7689586161
112	198	1	0	1	122.470871283
112	206	1	0	1	75.549139762
112	208	2	0	2	83.3552164985
112	209	1	0	1	81.91039701
112	214	1	0	1	76.1992365704
112	220	2	1	1	109.843293776
112	229	2	0	2	91.1485263024
112	245	14	6	8	25.6416196001
112	246	1	0	1	26.7994422703
112	247	2	0	2	40.7972844256
112	250	1	0	1	34.4465380912
112	251	7	4	3	32.2605939653
112	254	4	0	4	33.7957336332
112	256	4	1	3	18.7865924668
112	257	4	0	4	26.3684276656
112	258	1	0	1	26.328790317
112	260	1	0	1	23.1230364282
112	262	0	0	0	40.1253340606
112	264	1	0	1	31.7598854438
112	266	1	0	1	67.6301043924
112	274	1	0	1	45.5257214424
112	275	2	0	2	56.0212884344
112	276	2	0	2	52.4573762727
112	277	25	4	21	52.1076549827
112	279	2	0	2	44.7033466599
112	281	1	0	1	45.2677373833
112	282	1	0	1	48.8114048257
112	284	1	0	1	57.8197083579
112	293	2	1	1	57.6653813375
112	295	1	0	1	56.9630423999
112	298	0	0	0	64.2334971591
112	303	2	0	2	38.3527924517
112	304	1	0	1	27.197964253
112	305	2	0	2	38.8236638066
112	307	7	0	7	34.6090300038
112	309	2	0	2	27.633921998
112	319	3	0	3	56.6362548126
112	320	1	0	1	59.6246895588
112	323	2	0	2	49.9275446575
112	327	1	0	1	61.7708068659
112	329	2	0	2	44.1927169333
112	338	4	1	3	62.3168067867
112	341	1	0	1	66.4461607805
112	348	0	0	0	39.937144568
112	349	1	0	1	54.4294860808
112	350	2	0	2	48.6665747039
112	353	0	0	0	49.1402296508
112	379	1	0	1	74.681920225
112	387	1	0	1	79.4501564904
112	392	0	0	0	68.3939728516
112	406	1	0	1	86.9496945013
112	408	0	0	0	87.8506443238
112	411	0	0	0	85.0529791848
112	415	1	0	1	77.826651579
112	416	1	0	1	94.0319595927
112	442	1	1	0	107.891100971
112	454	1	0	1	60.0221709671
112	464	1	1	0	58.1337568025
112	465	1	1	0	68.9930815721
112	466	2	0	2	74.4675169814
112	468	1	0	1	46.3410842377
112	469	3	0	3	61.2933816571
112	470	0	0	0	52.1513288606
112	471	1	0	1	60.806839119
112	472	1	0	1	52.9953435395
112	473	1	0	1	54.3706112224
112	475	1	0	1	55.605577494
112	476	2	0	2	46.6133629491
112	480	1	0	1	60.7497257033
112	483	0	0	0	96.0043364622
112	490	0	0	0	67.9020432556
112	491	1	0	1	69.4361684272
112	496	2	0	2	65.1795681045
112	501	0	0	0	84.9570297492
112	503	8	0	8	74.4759433542
112	507	0	0	0	169.766688194
112	524	1	0	1	102.765111804
112	551	0	0	0	73.0078909852
112	555	1	0	1	83.8315903393
112	566	1	0	1	66.0680953912
112	573	8	2	6	60.7129629414
112	576	1	0	1	46.4361391358
112	579	0	0	0	53.7767667492
112	581	2	0	2	46.0834737816
113	0	5	0	5	29.8816031776
113	1	84	7	77	43.3665386917
113	2	5	0	5	32.8052347613
113	3	3	0	3	25.9677293452
113	5	1	0	1	48.7561821342
113	7	3	1	2	31.9108765152
113	12	1	0	1	51.5347008012
113	13	8	0	8	28.2235448991
113	15	3	0	3	33.7783301747
113	17	1	0	1	36.4876301449
113	18	2	0	2	25.1661989244
113	19	1	0	1	29.6995940341
113	21	2	1	1	43.7287400658
113	23	1	0	1	39.9024876784
113	24	2	1	1	37.375653118
113	26	1	0	1	40.1450296942
113	27	1	0	1	44.8284850931
113	28	6	0	6	40.9116037702
113	31	1	0	1	17.6392279106
113	32	2	0	2	30.2016880356
113	33	3	1	2	25.0355852027
113	34	2	1	1	28.3143133674
113	35	4	0	4	28.1486700041
113	36	57	0	57	17.6792678138
113	39	4	0	4	25.0730160103
113	41	4	0	4	21.530652092
113	42	4	0	4	21.930745369
113	45	2	0	2	58.2784264959
113	47	1	0	1	60.5747943078
113	48	1	0	1	47.8874649675
113	49	1	0	1	38.5911681018
113	50	2	0	2	40.354105841
113	53	1	0	1	66.1891022498
113	54	1	0	1	31.225289635
113	59	0	0	0	61.5959107401
113	65	1	0	1	59.9528983947
113	67	1	0	1	55.7218804235
113	68	2	0	2	38.0854387115
113	70	108	24	84	14.3842786358
113	71	101	90	11	7.60796670794
113	72	15	1	14	13.5411951866
113	73	1601	15	1586	7.79987300618
113	74	227	97	130	7.74066056438
113	75	448	312	136	5.43823251645
113	76	51	27	24	13.0548378374
113	77	13	2	11	12.4309224638
113	78	227	119	108	9.42440085566
113	79	43	13	30	11.6435193411
113	80	11	5	6	11.4382217094
113	81	81	4	77	11.9386783352
113	82	69	3	66	10.9940252578
113	83	82	2	80	8.44694834926
113	84	317	7	310	7.12708507621
113	85	91	2	89	12.6286597204
113	86	88	10	78	9.78457617681
113	87	561	370	191	4.65358695422
113	88	153	2	151	5.41973302971
113	89	29	3	26	19.4380537002
113	90	13	0	13	18.6882914097
113	92	37	3	34	17.8531831016
113	94	1	0	1	29.2360146049
113	95	53	14	39	11.2274405886
113	96	20	1	19	23.8253123155
113	98	10	0	10	12.5308322081
113	99	17	4	13	9.35433502262
113	100	2	0	2	17.3782737876
113	102	7	3	4	21.3706235877
113	103	430	100	330	4.58432614818
113	104	12	6	6	15.6005585098
113	105	4	0	4	19.0002452908
113	106	1	0	1	23.7141051514
113	107	33	15	18	11.5930327899
113	109	14	1	13	19.373066717
113	110	56	3	53	5.60807843023
113	111	9	0	9	22.9081563949
113	112	191	26	165	7.52065654458
113	114	17	4	13	12.1282231661
113	116	5	0	5	15.1718678995
113	117	78	0	78	3.06591324319
113	119	8	1	7	16.1743581259
113	120	13	0	13	13.1374839277
113	121	71	61	10	3.17695442615
113	122	0	0	0	23.5753526092
113	124	1	0	1	29.5556839901
113	127	6	0	6	8.87109862432
113	128	3	0	3	20.2450012737
113	129	8	6	2	13.1700764496
113	130	1	0	1	25.3356533755
113	131	2	0	2	43.3258469352
113	133	8	0	8	14.9628095812
113	134	16	0	16	12.0509529418
113	135	1	0	1	29.2407593719
113	136	4	1	3	23.0517542395
113	137	7	6	1	12.6465270931
113	138	1	0	1	18.9736672352
113	140	100	0	100	6.1343382737
113	141	3	0	3	42.4495542648
113	142	195	4	191	15.4413480034
113	143	2	0	2	24.0393675795
113	144	4	1	3	15.185737326
113	145	6	0	6	19.8274129012
113	146	55	5	50	6.13738432698
113	147	6	0	6	32.6552816252
113	154	3	1	2	22.2292892696
113	155	17	4	13	23.8993752766
113	156	2	0	2	25.636264656
113	158	1	0	1	27.7551934043
113	162	1	0	1	30.1226902346
113	163	0	0	0	30.7147283402
113	164	9	5	4	15.1025355404
113	165	1	0	1	27.7500453686
113	166	8	3	5	32.3950205138
113	168	18	2	16	16.9664795336
113	169	3	0	3	28.9749845927
113	171	29	5	24	18.897012072
113	172	23	6	17	18.8533100921
113	173	1	0	1	32.8071264557
113	175	2	0	2	21.0943257997
113	177	20	4	16	23.0157927267
113	179	4	0	4	33.4947372351
113	183	2	0	2	97.8012341956
113	188	1	0	1	98.8180747979
113	190	1	1	0	96.7248488579
113	208	0	0	0	86.2044896536
113	213	1	0	1	92.283685224
113	220	1	0	1	115.409647738
113	223	0	0	0	99.3110146099
113	229	2	0	2	95.1763553377
113	242	0	0	0	129.067203203
113	243	1	0	1	123.561059196
113	245	11	4	7	30.4162176237
113	254	2	0	2	37.9111290098
113	257	1	0	1	32.7404402446
113	260	2	0	2	29.0788361737
113	264	1	0	1	38.3620804504
113	272	1	0	1	69.2775065437
113	277	15	1	14	57.8867965504
113	282	0	0	0	53.5277867556
113	291	0	0	0	71.4908775787
113	292	1	0	1	67.2735890335
113	293	0	0	0	60.7956549699
113	296	1	0	1	51.8234808967
113	303	1	0	1	45.8082291434
113	305	1	0	1	45.5612740469
113	307	7	1	6	42.004792828
113	309	2	0	2	35.1249771278
113	310	1	0	1	56.4552358695
113	313	1	0	1	52.8927740598
113	314	1	0	1	59.6871661008
113	319	4	0	4	50.219024913
113	323	2	1	1	42.9826341755
113	326	1	0	1	45.5277071259
113	329	1	0	1	39.2681022335
113	338	5	0	5	59.0510975185
113	348	1	0	1	38.6643472806
113	349	1	0	1	49.9926624931
113	350	1	0	1	49.2224817582
113	351	1	0	1	48.5542008998
113	353	0	0	0	46.3507041913
113	358	1	0	1	93.0820610159
113	375	3	0	3	81.0418921877
113	379	1	0	1	68.0479961408
113	392	0	0	0	61.5237924806
113	396	1	0	1	74.7111315568
113	405	1	0	1	88.9689035607
113	406	1	0	1	81.5591118588
113	408	3	0	3	82.1260216676
113	415	1	0	1	71.8986932299
113	416	1	0	1	88.7230089039
113	438	1	1	0	106.96755297
113	441	0	0	0	102.03849733
113	452	1	0	1	64.0058174955
113	455	1	0	1	47.1648238581
113	464	1	0	1	56.7677076296
113	465	2	0	2	65.4626483911
113	466	3	0	3	71.5079995589
113	468	2	0	2	43.5148978485
113	469	3	1	2	58.074618357
113	472	3	0	3	50.7500051892
113	478	0	0	0	76.6806497658
113	488	1	0	1	73.9994458283
113	495	0	0	0	73.4964705902
113	503	5	0	5	69.5924133501
113	505	0	0	0	84.2300133433
113	507	1	0	1	162.285970803
113	512	1	0	1	131.199908327
113	520	0	0	0	90.6867891763
113	545	1	0	1	167.909238106
113	561	1	0	1	92.9817166648
113	563	1	0	1	68.6852504449
113	566	1	1	0	58.7484728432
113	571	0	0	0	63.9630777767
113	573	8	0	8	53.1946407187
113	575	1	0	1	60.2347198539
113	576	1	0	1	39.2022129161
113	577	1	0	1	48.1984755525
113	581	1	0	1	38.5901765017
113	583	0	0	0	92.7040025351
114	0	16	1	15	17.8188680752
114	1	407	0	407	31.2393911516
114	2	10	0	10	21.1764624232
114	3	13	2	11	14.0777672602
114	5	3	0	3	36.9030145265
114	6	1	1	0	41.4513631671
114	7	12	4	8	19.8048954803
114	9	2	0	2	20.094044556
114	10	4	0	4	18.7955904268
114	11	1	0	1	46.7120140302
114	13	30	2	28	16.1355062707
114	14	1	0	1	16.7877814999
114	15	22	4	18	21.7694443593
114	17	3	0	3	25.5317441949
114	18	9	6	3	13.0415393731
114	19	4	0	4	17.8961954756
114	21	4	0	4	31.9328161626
114	23	7	3	4	28.1847794205
114	24	3	1	2	25.6989931386
114	27	1	0	1	34.3432239734
114	28	16	0	16	28.8994241296
114	29	1	0	1	39.2467246109
114	31	38	2	36	9.16367225488
114	32	19	6	13	19.858683856
114	33	47	5	42	13.5785149075
114	34	10	5	5	22.0153623568
114	35	51	0	51	17.5018813031
114	36	1172	95	1077	5.55981829059
114	37	1	0	1	23.9232738174
114	38	8	0	8	14.8175128715
114	39	20	1	19	14.3975034076
114	41	53	2	51	10.7788303778
114	42	32	1	31	10.4389574306
114	46	3	0	3	45.1880930551
114	48	8	0	8	42.3150936027
114	49	3	0	3	29.7504331572
114	50	13	2	11	33.0256062103
114	52	1	0	1	30.6976194772
114	54	1	0	1	26.4975508887
114	55	1	0	1	44.8019626717
114	59	7	0	7	56.1868149632
114	60	1	0	1	36.2620286569
114	65	5	2	3	51.4504464704
114	68	3	0	3	32.8679051215
114	69	1	0	1	39.9779148825
114	70	64	0	64	20.299953323
114	71	34	8	26	18.8245244582
114	72	9	0	9	17.1421132769
114	73	854	489	365	13.1243265246
114	74	79	0	79	16.8319969541
114	75	130	11	119	12.6845351391
114	76	28	10	18	20.5925640822
114	77	4	0	4	15.6069009954
114	78	85	5	80	18.3228619707
114	79	53	1	52	14.4410942301
114	80	3	0	3	15.9471478709
114	81	60	18	42	16.888357359
114	82	59	8	51	18.4247504119
114	83	37	24	13	15.2370165172
114	84	110	80	30	13.9609703403
114	85	22	0	22	22.0962437713
114	86	21	0	21	20.8297524337
114	87	97	26	71	14.6893031114
114	88	33	8	25	16.4755576269
114	89	37	10	27	18.7790094625
114	90	11	1	10	27.6758501077
114	92	26	11	15	21.0334539485
114	94	1	0	1	33.6316352117
114	95	261	8	253	6.8631936074
114	96	15	2	13	32.0912336234
114	99	53	4	49	8.32004704345
114	100	46	0	46	7.74399454778
114	101	1	0	1	28.487269549
114	102	30	0	30	13.1932909667
114	103	357	7	350	8.53387679202
114	104	24	2	22	10.1687737063
114	105	5	1	4	15.0935349052
114	106	3	0	3	19.5072481383
114	107	5	1	4	23.6788574601
114	108	2	0	2	34.0004407085
114	109	5	1	4	26.0222857474
114	110	91	65	26	7.04048538465
114	111	16	0	16	24.2613441512
114	112	935	282	653	5.6708521581
114	113	454	12	442	12.1282231661
114	115	3	0	3	29.7826390118
114	116	4	1	3	23.1063984629
114	117	11	1	10	14.8674917339
114	118	3	0	3	24.7597256461
114	119	1	0	1	26.7279397139
114	120	16	0	16	12.9577722118
114	121	2	0	2	15.303890944
114	122	1	0	1	27.6727389658
114	124	1	0	1	28.4872715576
114	125	2	0	2	23.0763500276
114	127	1	0	1	17.5178615683
114	128	1	0	1	27.2848370618
114	129	50	1	49	7.20116170135
114	130	2	0	2	31.3575561751
114	131	1	0	1	42.8570185519
114	133	14	2	12	12.9314627401
114	134	10	0	10	15.2362425247
114	136	1	0	1	24.7029280513
114	137	2	0	2	23.6451506614
114	138	9	0	9	14.0492185804
114	139	1	0	1	40.7395744448
114	140	29	0	29	12.5875903823
114	142	120	10	110	20.4333753509
114	143	1	0	1	28.1220373308
114	144	3	0	3	23.8753989995
114	145	2	0	2	19.3248916128
114	146	8	0	8	18.102397939
114	147	5	0	5	38.6904407597
114	148	2	0	2	18.9475155152
114	151	1	0	1	35.8093303345
114	152	1	0	1	31.3435910672
114	154	3	0	3	31.1750138675
114	155	4	1	3	34.7578995312
114	164	6	0	6	26.9925056958
114	165	1	0	1	39.7258232683
114	166	1	0	1	43.3932757347
114	169	2	1	1	37.2116504388
114	171	5	1	4	30.1801135802
114	172	6	0	6	30.7608518945
114	175	1	0	1	32.985536892
114	177	3	1	2	35.1216949981
114	183	8	1	7	91.435797955
114	186	1	0	1	87.2538496492
114	188	1	0	1	93.9970503064
114	191	0	0	0	112.486416415
114	208	1	0	1	86.0715809049
114	220	0	0	0	110.026413352
114	224	1	0	1	84.1442244347
114	238	1	0	1	84.2982671311
114	244	0	0	0	125.712868528
114	245	9	0	9	27.5351371588
114	249	1	0	1	41.446597691
114	250	1	0	1	35.9185262551
114	254	2	0	2	36.027860467
114	257	1	0	1	26.2876390662
114	262	1	0	1	41.1930742018
114	263	1	0	1	35.3975228085
114	264	1	0	1	31.1316305708
114	276	1	1	0	54.408784021
114	277	14	3	11	52.3343024289
114	281	1	0	1	46.368855904
114	282	2	0	2	50.2347501617
114	293	1	0	1	60.3303760885
114	303	11	3	8	34.1019277073
114	304	2	0	2	23.0498427414
114	305	7	2	5	37.8104404843
114	306	1	0	1	36.5790565748
114	307	4	2	2	31.9991663549
114	309	6	0	6	24.6009690628
114	319	1	0	1	62.0700311019
114	329	1	0	1	49.8618111754
114	338	3	0	3	67.8265949503
114	352	1	0	1	50.7812394959
114	416	1	0	1	94.1767480116
114	455	1	1	0	55.4894163728
114	464	1	0	1	55.2782660023
114	465	0	0	0	67.6478458723
114	466	1	0	1	72.6329744703
114	469	3	0	3	59.760412933
114	471	1	0	1	57.5141648218
114	472	0	0	0	50.8107715488
114	475	2	0	2	55.5183943188
114	476	1	0	1	43.6159415964
114	477	1	0	1	64.3344097095
114	482	1	0	1	84.0772991509
114	485	0	0	0	88.7479772871
114	491	1	0	1	66.9259514646
114	494	1	0	1	59.423711391
114	496	1	0	1	64.8956956845
114	501	1	0	1	83.6170988752
114	503	3	0	3	74.287783427
114	505	1	0	1	85.4340060772
114	551	0	0	0	77.5065356837
114	573	5	2	3	64.6346383785
114	576	1	0	1	51.320742186
114	581	2	0	2	50.4199543621
115	1	19	1	18	50.3977787561
115	13	1	0	1	40.057791271
115	19	1	0	1	36.0688049621
115	24	1	0	1	50.561248967
115	29	1	0	1	66.5096637692
115	32	2	1	1	30.4399757507
115	36	18	0	18	32.6149118783
115	39	2	0	2	29.2875992877
115	42	2	0	2	30.6670225417
115	46	0	0	0	73.3915621312
115	65	1	0	1	80.3413025022
115	70	136	7	129	13.7738611671
115	71	16	0	16	24.1431924958
115	72	27	0	27	14.1260293117
115	73	616	112	504	19.9174073759
115	74	40	3	37	20.8826062519
115	75	29	0	29	22.1695988056
115	76	62	1	61	16.1509575137
115	77	11	0	11	15.4459117443
115	78	63	24	39	19.7263603827
115	79	44	19	25	16.479653575
115	80	12	0	12	16.1715518785
115	81	128	7	121	15.6451757309
115	82	52	9	43	17.3978573635
115	83	29	7	22	19.1927398809
115	84	51	0	51	20.4550379691
115	85	25	6	19	19.2983817055
115	86	19	3	16	23.4495291754
115	87	18	4	14	23.5042981809
115	88	10	0	10	24.2941319165
115	89	106	94	12	11.3467048992
115	90	27	1	26	17.3407471196
115	92	182	50	132	9.74140039671
115	93	6	1	5	12.1582717008
115	94	25	0	25	6.2975999977
115	95	16	0	16	22.9244847811
115	96	149	1	148	15.7948634121
115	97	7	3	4	13.4492232143
115	98	2	0	2	26.2715190849
115	100	1	0	1	25.8220971642
115	101	96	69	27	3.21677845442
115	102	7	2	5	22.9799026474
115	103	30	0	30	25.3907429452
115	104	4	0	4	20.5758058637
115	105	6	2	4	16.4411439201
115	106	3	1	2	15.0721064951
115	107	0	0	0	31.4825532753
115	108	9	0	9	10.9637944638
115	109	66	12	54	11.7650444215
115	110	3	0	3	29.6874013552
115	111	137	90	47	5.5515149149
115	112	39	2	37	25.764025086
115	113	50	0	50	27.5811987786
115	114	5	0	5	29.7826390118
115	116	14	0	14	15.653022147
115	117	1	0	1	26.2818758553
115	118	3	1	2	19.0850072904
115	119	2	0	2	22.0211560404
115	120	13	9	4	16.9019883087
115	122	97	11	86	5.38601206221
115	123	17	11	6	7.50980670899
115	128	1	0	1	47.0690173265
115	131	0	0	0	70.534133384
115	136	1	0	1	50.4851690155
115	140	2	0	2	33.6065401973
115	142	18	0	18	43.0078926304
115	146	3	0	3	30.0516122516
115	149	1	0	1	70.5094408388
115	155	3	0	3	25.7256644157
115	156	2	0	2	21.9332575543
115	164	2	0	2	28.1890682582
115	166	2	0	2	31.4551637428
115	169	4	0	4	17.6579666275
115	171	1	0	1	25.802571945
115	177	2	0	2	37.7475780578
115	179	1	0	1	18.6144202889
115	182	1	0	1	84.4077344626
115	183	2	0	2	76.1492767348
115	208	3	0	3	58.6745058916
115	212	1	0	1	49.0529537243
115	213	1	0	1	64.8787331096
115	220	2	0	2	91.7760636886
115	229	1	0	1	68.5239489469
115	245	128	0	128	12.0894331309
115	246	38	17	21	6.0959069504
115	247	19	18	1	15.036784392
115	248	6	1	5	8.99681327438
115	249	1	0	1	14.8482077213
115	250	1	0	1	17.8283642479
115	251	141	47	94	6.62565712486
115	253	7	1	6	20.7652514189
115	254	15	0	15	13.833952937
115	257	12	6	6	21.1391833084
115	258	1	0	1	26.9103234935
115	260	2	0	2	17.3039085004
115	262	5	0	5	23.630136979
115	263	1	0	1	20.5773374726
115	264	1	0	1	25.9212122181
115	265	1	0	1	50.9321801791
115	271	1	0	1	52.9557489385
115	272	1	0	1	44.1417766891
115	276	1	0	1	30.6329298486
115	277	28	2	26	37.0524028416
115	279	3	0	3	33.9927118558
115	281	1	0	1	27.5639360757
115	282	3	1	2	29.2777581056
115	284	2	0	2	36.6880879911
115	285	0	0	0	45.29727371
115	291	2	0	2	45.2183206803
115	293	1	0	1	33.5034884286
115	296	1	0	1	24.2531401228
115	298	2	1	1	40.0339923294
115	305	2	0	2	32.1161341229
115	307	2	0	2	36.3997104614
115	309	2	0	2	33.7384326467
115	319	1	0	1	52.078482008
115	348	1	0	1	18.405141789
115	350	3	1	2	23.2153211093
115	352	1	0	1	23.1519212179
115	353	1	0	1	30.4724509319
115	357	0	0	0	48.0317725336
115	367	1	0	1	44.5985579309
115	401	0	0	0	111.892175639
115	469	2	0	2	85.6555346062
115	473	0	0	0	77.8955402759
115	476	0	0	0	72.2889823174
115	491	1	0	1	94.7578274742
115	496	1	0	1	87.4494776697
115	504	1	0	1	86.1123163539
115	505	1	0	1	111.811111303
115	524	1	0	1	112.468630677
115	580	1	0	1	60.7673771822
116	1	4	1	3	51.549864502
116	36	3	1	2	27.952706717
116	55	1	0	1	66.807055651
116	70	97	27	70	4.08772449963
116	71	19	0	19	9.26727897512
116	72	7	5	2	7.97086141049
116	73	244	47	197	9.98465207836
116	74	27	1	26	7.4347310414
116	75	24	1	23	10.9499774761
116	76	94	44	50	2.51501158955
116	77	4	0	4	8.98153499933
116	78	60	14	46	5.74932574023
116	79	9	3	6	9.83423371817
116	80	1	0	1	7.7881500325
116	81	27	16	11	6.87645316969
116	82	44	0	44	4.70737936805
116	83	13	9	4	7.92537982655
116	84	28	2	26	9.32192002369
116	85	220	151	69	3.7076780253
116	86	14	10	4	8.04971305196
116	87	24	0	24	10.5186109573
116	88	12	1	11	10.3004116006
116	89	8	1	7	14.2447399457
116	90	21	4	17	4.83428787364
116	92	8	1	7	8.47876976584
116	95	3	1	2	17.454101366
116	96	16	4	12	9.03671573952
116	97	1	0	1	20.7149262736
116	103	10	0	10	15.3959328216
116	104	1	0	1	18.6358733371
116	109	13	1	12	4.56390895071
116	111	1	0	1	13.3183652561
116	112	10	0	10	17.5398933087
116	113	17	4	13	15.1718678995
116	117	1	0	1	12.783208818
116	118	9	0	9	3.84523330026
116	119	4	0	4	7.11679300326
116	120	4	1	3	12.8996831917
116	140	1	0	1	21.1564991247
116	142	4	1	3	29.564039057
116	144	1	0	1	26.7210151142
116	146	1	0	1	15.4552672797
116	155	8	0	8	13.7696349437
116	156	3	0	3	12.7993928183
116	158	0	0	0	25.779559834
116	159	1	0	1	22.891799881
116	162	2	1	1	17.1988502042
116	163	1	0	1	39.4616150008
116	166	11	0	11	21.9371688288
116	168	2	0	2	17.2608503374
116	169	2	1	1	14.216378319
116	171	7	0	7	11.4599546319
116	172	3	0	3	21.7907360984
116	173	1	0	1	31.7295434735
116	175	1	0	1	16.3935252943
116	177	4	0	4	22.6020730312
116	179	1	0	1	18.5162070256
116	183	0	0	0	91.1479403232
116	219	1	0	1	110.31686195
116	245	1	0	1	23.8075103974
116	251	1	1	0	21.6823433208
116	260	1	0	1	25.8284600113
116	277	1	0	1	51.4589522078
116	308	1	0	1	50.5301813058
116	310	0	0	0	41.4717361207
116	319	2	0	2	42.3809706989
116	329	4	1	3	27.5235880508
116	338	3	1	2	44.786869163
116	348	2	1	1	23.4960368881
116	349	1	0	1	37.1990890054
116	350	1	0	1	34.684747252
116	354	1	0	1	27.2667978308
116	358	0	0	0	83.7347788495
116	485	0	0	0	103.827519649
116	488	1	0	1	88.9163211798
116	503	1	0	1	81.2819602711
116	552	0	0	0	90.2788700827
116	557	0	0	0	77.6095076458
116	573	3	0	3	54.3584353829
117	1	21	0	21	46.0364405723
117	2	1	0	1	35.7538822313
117	3	1	0	1	28.443040818
117	5	1	0	1	51.6619638776
117	7	1	0	1	34.6695858453
117	13	2	0	2	31.0028950522
117	28	2	1	1	43.4163978752
117	32	1	0	1	32.0749496441
117	33	0	0	0	27.997062856
117	36	13	0	13	20.4248677189
117	41	2	0	2	24.5471500052
117	46	1	0	1	57.6598572007
117	48	1	0	1	50.6562131951
117	70	74	0	74	12.6637136686
117	71	72	0	72	4.57175250169
117	72	13	0	13	12.6418331544
117	73	997	595	402	7.39871612006
117	74	138	61	77	5.57112286637
117	75	111	48	63	5.0982791969
117	76	23	4	19	10.9094489928
117	77	3	0	3	11.8117061842
117	78	180	0	180	7.10627027041
117	79	13	3	10	11.2702949667
117	80	0	0	0	10.5217980921
117	81	32	0	32	10.7956984289
117	82	40	4	36	9.07330176318
117	83	42	5	37	7.21627086787
117	84	146	25	121	6.25687645576
117	85	49	5	44	9.9024231871
117	86	62	45	17	6.74833877715
117	87	418	208	210	2.80259372202
117	88	167	119	48	2.55395840482
117	89	9	0	9	19.2337553403
117	90	2	0	2	15.9293931612
117	92	5	2	3	16.7029149978
117	95	10	1	9	12.8834587297
117	96	3	0	3	21.1444064711
117	98	3	0	3	9.51231038926
117	99	1	0	1	12.356905417
117	102	1	0	1	22.8909937892
117	103	70	27	43	6.64266270668
117	104	1	0	1	16.8763129052
117	107	10	1	9	9.31407910796
117	109	6	0	6	17.1771925299
117	110	3	1	2	8.63587217566
117	111	1	0	1	21.9881560617
117	112	28	3	25	9.78675316068
117	113	177	66	111	3.06591324319
117	114	1	1	0	14.8674917339
117	116	2	0	2	12.783208818
117	118	0	0	0	12.3566266755
117	119	2	0	2	13.1553635892
117	120	3	0	3	13.4208478621
117	121	29	13	16	1.51125399205
117	126	1	0	1	36.8918771588
117	128	0	0	0	20.858999951
117	131	0	0	0	45.3595596799
117	133	1	0	1	17.7679498856
117	134	1	0	1	14.2737853138
117	140	3	0	3	8.43696598801
117	141	1	0	1	42.7063983777
117	142	27	0	27	16.9607236898
117	143	1	0	1	25.4082071215
117	145	2	0	2	22.2654608525
117	146	10	1	9	4.57495697948
117	148	0	0	0	24.7545468696
117	151	1	0	1	38.774699939
117	154	1	0	1	22.0105746244
117	155	16	5	11	20.8369565786
117	156	3	0	3	22.6663004529
117	163	1	0	1	30.2942229689
117	164	12	0	12	12.158801873
117	165	1	0	1	25.5031474917
117	166	5	1	4	29.3293280632
117	167	1	0	1	32.4762867669
117	168	10	0	10	14.3823363718
117	169	1	1	0	26.2466964088
117	170	1	0	1	31.7215532734
117	171	23	17	6	15.8340343281
117	172	24	0	24	16.7751619819
117	173	1	0	1	30.4300644299
117	174	1	0	1	37.5399818732
117	175	5	2	3	18.159259464
117	177	38	9	29	20.5481452656
117	183	2	0	2	98.1136812802
117	208	1	0	1	84.948593285
117	245	1	0	1	30.3255573271
117	246	1	0	1	29.3647804203
117	256	0	0	0	26.5889245234
117	277	4	0	4	58.1251803908
117	281	0	0	0	50.2346367035
117	305	1	0	1	46.5047133599
117	307	1	0	1	43.6545734598
117	319	17	1	16	47.2811703258
117	320	2	0	2	50.0008029522
117	321	1	0	1	42.493561773
117	325	1	0	1	55.5370221793
117	326	1	0	1	42.4646444885
117	329	9	1	8	36.208081624
117	338	4	0	4	56.139723034
117	339	1	0	1	62.6424314856
117	346	0	0	0	108.834096758
117	347	1	0	1	34.4488503082
117	348	1	1	0	36.2288631801
117	349	5	0	5	46.9550084525
117	350	1	0	1	47.2639525755
117	353	1	0	1	43.5400066004
117	354	1	0	1	37.5832699889
117	367	1	0	1	47.0994719458
117	375	4	0	4	79.089731078
117	385	0	0	0	64.9046135855
117	396	2	0	2	75.0087625808
117	406	1	0	1	81.9222899455
117	408	5	0	5	82.2801815833
117	411	0	0	0	78.8838736483
117	415	1	0	1	71.9372161439
117	426	0	0	0	119.366388813
117	441	0	0	0	101.957748775
117	442	0	0	0	102.458403904
117	475	1	0	1	51.5464727827
117	476	2	0	2	47.9510087236
117	478	0	0	0	78.0661943434
117	495	1	0	1	74.6396338984
117	496	1	0	1	61.2581584081
117	497	1	0	1	59.9558667719
117	523	0	0	0	110.201507642
117	551	0	0	0	63.2800036857
117	563	1	0	1	66.6857240102
117	566	1	0	1	57.461017601
117	568	1	1	0	41.4095912013
117	569	1	0	1	49.8789439139
117	573	13	6	7	51.3307149891
117	579	1	0	1	44.0062753745
117	581	3	0	3	36.4615180001
118	1	5	1	4	54.2361140056
118	4	0	0	0	48.151555363
118	12	1	0	1	63.3255981607
118	15	1	0	1	45.9525645035
118	36	2	0	2	29.9164691926
118	42	1	0	1	31.8574818414
118	56	0	0	0	64.1363972493
118	70	81	3	78	7.73086843663
118	71	20	16	4	8.0330157056
118	72	12	0	12	11.3567815728
118	73	308	51	257	11.8767254034
118	74	38	17	21	8.01357905709
118	75	17	3	14	12.1093354312
118	76	51	9	42	5.35101035701
118	77	2	0	2	12.1112056869
118	78	102	68	34	6.44031086749
118	79	8	5	3	12.770021774
118	80	2	0	2	10.6839651713
118	81	22	9	13	9.89209875344
118	82	31	3	28	6.84487822666
118	83	5	1	4	9.70023452606
118	84	37	4	33	10.8306985086
118	85	185	55	130	2.68018810513
118	86	14	10	4	6.14705842549
118	87	40	0	40	10.7584579057
118	88	16	6	10	9.81666436532
118	89	2	1	1	17.9936543851
118	90	10	1	9	3.63390940107
118	92	7	1	6	12.3193103846
118	94	3	1	2	17.625129853
118	95	2	1	1	19.7805138317
118	96	8	3	5	8.92460050894
118	98	4	3	1	7.45351270153
118	102	1	0	1	27.424504684
118	103	2	0	2	16.5104012387
118	107	4	1	3	13.1811486039
118	109	7	0	7	7.40793985012
118	111	1	0	1	17.1205765903
118	112	9	4	5	19.0906233379
118	113	15	2	13	15.1821389574
118	116	16	3	13	3.84523330026
118	117	2	0	2	12.3566266755
118	119	10	7	3	3.27674611346
118	120	4	0	4	15.9647218652
118	122	1	0	1	13.7432315066
118	134	1	0	1	26.4426987838
118	135	1	0	1	37.3516054551
118	140	1	0	1	20.7395177746
118	142	9	3	6	28.3288385453
118	155	13	3	10	10.5456944913
118	156	2	1	1	10.7267554115
118	158	1	0	1	21.9371515802
118	159	2	1	1	19.2023879238
118	164	2	1	1	9.1057229726
118	166	3	0	3	19.0377763487
118	168	5	2	3	13.7159241843
118	169	2	0	2	13.925810159
118	171	17	0	17	7.6506767178
118	172	6	2	4	18.3707520473
118	173	1	0	1	27.8884037054
118	175	4	0	4	12.5489092895
118	177	5	1	4	18.8390274031
118	186	1	0	1	87.3850862064
118	245	2	0	2	27.6479202196
118	251	1	0	1	24.8119056471
118	274	1	0	1	48.5658295885
118	277	2	0	2	55.2442998352
118	314	0	0	0	45.2369011
118	319	10	1	9	39.0907438504
118	327	1	0	1	43.5963545302
118	328	1	0	1	28.3708708601
118	329	2	0	2	25.1523889495
118	338	3	0	3	43.8913324489
118	341	1	0	1	49.5075548097
118	348	1	0	1	24.3769702054
118	349	1	0	1	35.3594756605
118	375	2	0	2	68.182067296
118	392	0	0	0	64.7870741073
118	466	0	0	0	83.673704973
118	469	0	0	0	70.1204267819
118	475	0	0	0	60.4745102548
118	484	1	0	1	84.1144568221
118	503	1	0	1	78.70035122
118	573	3	1	2	50.530991796
118	581	1	0	1	34.951859852
119	0	4	0	4	43.0893401374
119	1	19	0	19	56.7914021841
119	4	1	0	1	50.3464138978
119	7	2	0	2	45.97972151
119	13	4	0	4	42.4660452081
119	19	1	0	1	42.1067174194
119	23	1	0	1	54.871577526
119	28	1	0	1	53.5102940499
119	31	1	0	1	33.6894612151
119	36	12	1	11	32.0514583765
119	38	1	0	1	38.7159335028
119	39	1	0	1	36.0583201091
119	41	0	0	0	37.1411559825
119	42	1	0	1	34.4186906079
119	44	1	0	1	83.4066959575
119	50	1	0	1	56.4476139304
119	70	220	0	220	10.9793560745
119	71	77	51	26	8.58434346418
119	72	14	4	10	14.4958695044
119	73	1014	3	1011	14.2897788026
119	74	96	53	43	9.94098468501
119	75	64	1	63	14.0742687499
119	76	125	43	82	8.48817983158
119	77	6	0	6	15.1357424857
119	78	328	202	126	8.64792382483
119	79	23	4	19	15.6959910899
119	80	6	2	4	13.6336622256
119	81	51	1	50	12.9095990798
119	82	122	9	113	9.66451862738
119	83	47	0	47	12.1572803751
119	84	106	0	106	13.0766937658
119	85	420	87	333	5.11261682651
119	86	82	68	14	6.41191446964
119	87	110	2	108	12.1908165871
119	88	45	10	35	10.7846595251
119	89	19	2	17	21.2495961562
119	90	144	74	70	5.10604224189
119	92	26	10	16	15.5944171041
119	94	1	0	1	19.9783670911
119	95	12	3	9	22.2611969115
119	96	111	1	110	9.8407968354
119	98	8	0	8	5.71970814959
119	99	2	0	2	25.5112776841
119	102	1	0	1	30.3723780026
119	103	47	23	24	18.2675965318
119	104	1	0	1	24.4366561876
119	105	2	0	2	24.657816567
119	106	1	0	1	27.7710772518
119	107	12	5	7	11.574162288
119	108	1	0	1	15.9208907551
119	109	42	4	38	10.2564286466
119	111	3	0	3	20.33766878
119	112	18	1	17	21.0801356821
119	113	92	0	92	16.1743581259
119	116	33	16	17	7.11679300326
119	117	6	0	6	13.1553635892
119	118	28	26	2	3.27674611346
119	120	6	0	6	18.9122311766
119	121	2	0	2	13.7699900058
119	122	4	1	3	16.640223631
119	128	1	0	1	29.2584929577
119	129	1	0	1	29.3036787372
119	131	1	0	1	56.5510977173
119	134	0	0	0	26.617620429
119	135	0	0	0	35.5548338583
119	140	6	0	6	21.1891564484
119	142	23	0	23	27.9065784245
119	145	2	1	1	34.715051574
119	146	8	4	4	13.6216875977
119	154	3	0	3	27.717435296
119	155	70	0	70	8.03900180161
119	156	18	7	11	9.59334289998
119	157	1	0	1	23.2002605213
119	158	2	2	0	18.6872345984
119	159	1	0	1	16.0348378376
119	162	2	0	2	13.9978875158
119	163	2	0	2	34.2896364139
119	164	23	6	17	6.47022590735
119	165	1	0	1	21.2424530684
119	166	17	1	16	16.675675125
119	168	21	0	21	11.0050045929
119	169	3	1	2	14.258747319
119	170	3	1	2	22.9469479659
119	171	139	64	75	4.39764462507
119	172	23	1	22	15.7690534317
119	173	1	0	1	24.6409819448
119	175	13	9	4	9.27913608672
119	177	27	2	25	15.7428054209
119	179	1	0	1	18.98156262
119	182	1	0	1	106.161228034
119	183	1	0	1	97.9862666594
119	187	1	0	1	96.3811438443
119	208	1	0	1	78.2761769804
119	220	1	0	1	113.795985543
119	231	0	0	0	71.7818898159
119	233	1	0	1	75.7002184037
119	244	1	0	1	124.5176064
119	245	2	0	2	30.9025051811
119	251	1	0	1	27.4920569891
119	252	1	0	1	40.6679266537
119	253	0	0	0	42.230092404
119	254	1	0	1	35.5786288078
119	256	1	0	1	32.1675775956
119	262	0	0	0	44.9727965751
119	277	16	1	15	58.4270394462
119	281	0	0	0	49.3062684356
119	282	2	0	2	51.274902637
119	307	1	1	0	50.2982244808
119	308	1	0	1	57.3685513971
119	310	3	1	2	43.9310883177
119	313	1	0	1	39.0721003574
119	319	21	0	21	36.2362805659
119	326	2	0	2	29.5219000561
119	329	6	1	5	23.22602488
119	331	2	0	2	24.6626807439
119	333	1	0	1	57.419805923
119	338	7	0	7	43.1355472734
119	341	1	0	1	49.5371639195
119	344	1	0	1	51.4367349081
119	345	1	0	1	79.0373806374
119	347	2	0	2	21.6758771989
119	348	2	0	2	25.3323031567
119	349	3	0	3	33.8264726906
119	350	1	0	1	38.2408131556
119	351	1	0	1	32.4477514165
119	353	1	0	1	30.8784352448
119	357	2	0	2	39.8560159056
119	375	2	0	2	69.5555606657
119	379	0	0	0	69.478916976
119	385	1	0	1	65.4285841511
119	391	1	0	1	63.5204332289
119	392	0	0	0	61.9978021021
119	396	1	0	1	80.0326076083
119	401	1	0	1	90.6547393483
119	404	0	0	0	87.3791317157
119	408	4	1	3	86.6408296827
119	411	0	0	0	82.3380738509
119	414	1	0	1	92.4653422643
119	416	1	0	1	94.3528409145
119	437	1	0	1	133.951868645
119	469	1	0	1	68.9749856225
119	472	1	0	1	63.2925021761
119	474	1	0	1	90.2205479782
119	476	1	0	1	59.7733375128
119	477	1	0	1	75.5743646176
119	503	0	0	0	76.7843566165
119	551	0	0	0	56.5123404087
119	555	1	0	1	68.2280908784
119	557	0	0	0	70.6011513966
119	563	0	0	0	61.4884618543
119	566	1	0	1	56.1471298755
119	569	0	0	0	43.7404533007
119	571	0	0	0	59.8866387679
119	573	12	1	11	47.3085857798
119	577	1	0	1	37.4579847983
119	579	1	0	1	37.0933217827
119	581	3	1	2	31.7279926835
119	587	1	0	1	53.3384587403
120	0	3	0	3	25.2474840845
120	1	40	0	40	38.7199023264
120	3	3	0	3	20.9381983952
120	5	1	0	1	46.448261867
120	7	1	0	1	28.7601231885
120	9	2	0	2	26.1202183148
120	13	5	0	5	25.6262580201
120	16	1	0	1	22.0638530758
120	19	1	0	1	23.8053639084
120	23	2	0	2	38.4308710198
120	24	1	0	1	36.1516098246
120	28	1	0	1	35.0457535294
120	32	5	2	3	21.1827022778
120	33	1	0	1	25.1822927003
120	35	1	0	1	29.6945427372
120	36	27	6	21	16.5122533225
120	39	5	0	5	17.3795622604
120	41	1	0	1	23.261640811
120	42	2	1	1	16.5803555924
120	50	2	0	2	45.9762205094
120	59	1	0	1	69.089369694
120	65	1	0	1	64.1450651656
120	68	1	0	1	45.6641049281
120	70	177	75	102	9.04361662155
120	71	38	1	37	14.2952564516
120	72	46	0	46	5.11633233282
120	73	1169	77	1092	6.16878449596
120	74	65	5	60	10.4153908852
120	75	93	0	93	8.32420523597
120	76	49	7	42	10.6751538113
120	77	57	15	42	3.91818826174
120	78	159	54	105	10.8180185678
120	79	236	137	99	3.21732523865
120	80	45	3	42	5.2861479904
120	81	135	35	100	6.08790248448
120	82	49	0	49	9.25542020715
120	83	48	25	23	7.50412287087
120	84	144	131	13	7.56426172922
120	85	58	3	55	13.8163075648
120	86	36	3	33	15.2569281115
120	87	99	6	93	10.9897185246
120	88	31	13	18	12.8216773039
120	89	71	33	38	6.59681876001
120	90	9	7	2	17.7158789782
120	92	39	2	37	8.2088358605
120	95	88	8	80	6.11171301932
120	96	5	0	5	21.009462432
120	98	2	0	2	19.2940145062
120	99	3	0	3	17.9651119746
120	100	1	0	1	10.9295413314
120	101	2	1	1	15.9225108495
120	102	7	0	7	11.465820084
120	103	76	12	64	9.47877105728
120	104	31	6	25	5.74710731069
120	105	22	11	11	6.36671834853
120	106	4	1	3	10.7604663286
120	107	3	0	3	21.977351795
120	109	14	3	11	14.3226631551
120	110	8	1	7	13.3673744449
120	111	11	3	8	11.4518346196
120	112	61	6	55	9.02422358528
120	113	129	2	127	13.1374839277
120	114	2	0	2	12.9577722118
120	115	0	0	0	16.9019883087
120	116	12	3	9	12.8996831917
120	117	2	0	2	13.4208478621
120	118	2	0	2	15.9647218652
120	119	7	0	7	18.9122311766
120	121	2	1	1	14.8350644423
120	122	4	0	4	14.8148183519
120	131	1	0	1	54.2022618641
120	134	0	0	0	23.6478815972
120	140	6	2	4	18.3347004408
120	142	25	0	25	27.9816784876
120	143	1	0	1	36.555377054
120	145	1	0	1	30.1551079599
120	147	1	0	1	45.7131174341
120	154	1	0	1	35.2562410511
120	155	10	0	10	26.4801549215
120	156	0	0	0	25.6402167705
120	163	2	1	1	43.64865727
120	164	3	1	2	22.162538797
120	166	6	0	6	34.8130037107
120	168	4	0	4	25.9219033731
120	169	1	0	1	25.8035891279
120	171	3	0	3	23.1953986183
120	172	9	0	9	29.3681541974
120	175	3	1	2	27.4534669968
120	177	11	4	7	32.0839515524
120	179	1	0	1	29.3266097701
120	183	1	0	1	84.7550474297
120	190	1	0	1	83.9981293009
120	208	2	0	2	74.3714233776
120	211	1	0	1	82.1406643489
120	237	2	0	2	66.099743155
120	245	15	3	12	17.3159151187
120	248	1	0	1	22.3488942803
120	254	1	0	1	25.0956599886
120	256	1	0	1	13.7521125124
120	257	4	1	3	20.1765112235
120	260	1	0	1	16.219583392
120	262	2	0	2	32.1857410483
120	264	1	0	1	25.9710110822
120	270	1	0	1	47.5656559507
120	275	1	0	1	49.4476661146
120	276	1	0	1	43.7933520649
120	277	11	0	11	44.7967074376
120	281	2	0	2	37.2328327558
120	282	1	0	1	40.4963141536
120	284	1	0	1	49.3130508719
120	293	1	0	1	48.7093686942
120	310	1	0	1	48.2436238344
120	319	4	1	3	55.0554232446
120	323	0	0	0	49.7870080655
120	329	4	0	4	40.3637680675
120	338	2	1	1	56.1351211214
120	341	1	0	1	59.0771264811
120	346	1	0	1	98.4596233514
120	347	1	0	1	34.6861848594
120	348	1	0	1	32.4254867026
120	349	1	0	1	49.690696157
120	353	2	0	2	42.7028833134
120	355	1	0	1	56.3652603534
120	375	1	1	0	71.3222142419
120	379	1	0	1	80.9420178241
120	385	0	0	0	78.312289496
120	392	0	0	0	74.2285740543
120	408	1	0	1	95.2631057742
120	411	0	0	0	92.0787130973
120	438	1	0	1	120.060164642
120	465	0	0	0	77.7065618981
120	469	0	0	0	70.0903456309
120	475	2	0	2	63.6987772574
120	477	0	0	0	75.3403660071
120	480	1	0	1	69.7452339988
120	482	1	0	1	96.0976842772
120	495	0	0	0	85.9952677297
120	500	1	1	0	77.2060358098
120	503	3	0	3	82.5550538226
120	505	0	0	0	96.1353310366
120	530	0	0	0	134.475602485
120	571	0	0	0	75.4142193669
120	573	1	0	1	63.8077136942
120	577	1	0	1	55.9964127232
120	581	1	0	1	48.5154757892
121	0	1	0	1	33.0405065331
121	1	22	3	19	46.5407216504
121	7	2	0	2	35.0874734677
121	13	4	0	4	31.3992526687
121	15	1	0	1	36.9458676451
121	32	2	0	2	33.0715961977
121	35	1	0	1	31.1503118884
121	36	16	5	11	20.8560695375
121	39	1	0	1	28.0315854611
121	41	0	0	0	24.5872035354
121	50	2	0	2	42.7048879666
121	53	1	0	1	69.0922962111
121	68	1	0	1	40.0304540138
121	70	67	0	67	14.1036048187
121	71	81	13	68	5.28727021165
121	72	13	0	13	14.153004934
121	73	908	283	625	8.87230131466
121	74	127	74	53	6.97113833157
121	75	130	0	130	6.53450385721
121	76	20	1	19	12.2528959144
121	77	4	0	4	13.3169235768
121	78	197	16	181	8.42956467285
121	79	21	2	19	12.7588449061
121	80	2	0	2	12.033032086
121	81	29	1	28	12.3026340342
121	82	40	2	38	10.4922982051
121	83	43	0	43	8.72579697218
121	84	145	60	85	7.76023822739
121	85	60	8	52	10.9520720665
121	86	65	2	63	7.3914245537
121	87	395	82	313	4.31017503893
121	88	177	87	90	3.72011448261
121	89	8	0	8	20.7210295816
121	90	10	3	7	16.9028713936
121	92	5	0	5	18.2027695185
121	95	14	0	14	13.9304837879
121	96	3	0	3	22.1626334426
121	98	5	2	3	9.58698851887
121	99	4	1	3	11.9245412321
121	100	1	0	1	20.3130332182
121	102	1	0	1	24.0183109881
121	103	88	38	50	7.45488773892
121	104	3	1	2	18.0710797409
121	105	1	0	1	21.0100456859
121	107	16	3	13	8.46612043417
121	109	6	2	4	18.4709939531
121	110	6	0	6	8.69903971101
121	111	3	1	2	23.4962944535
121	112	25	0	25	10.5371889628
121	113	195	139	56	3.17695442615
121	114	2	0	2	15.303890944
121	116	3	1	2	14.0172435067
121	117	73	42	31	1.51125399205
121	118	3	1	2	13.2881357578
121	120	9	3	6	14.8350644423
121	124	0	0	0	30.7265428873
121	127	1	0	1	8.32040867789
121	128	2	0	2	19.3561669828
121	129	2	1	1	15.9792681941
121	131	0	0	0	44.101812232
121	137	2	0	2	10.2712069156
121	138	1	0	1	21.3079961177
121	140	15	0	15	7.47188335693
121	141	1	0	1	41.1973281316
121	142	60	42	18	15.5973277866
121	143	2	1	1	23.9914855125
121	144	1	0	1	13.8915249601
121	145	2	0	2	21.2287258226
121	146	30	5	25	3.26903403159
121	147	1	0	1	31.7558220134
121	148	0	0	0	23.9016707405
121	151	0	0	0	37.5717326041
121	154	2	1	1	20.5239637269
121	155	9	0	9	21.2233577057
121	156	4	1	3	23.3495633533
121	157	1	0	1	22.2437228069
121	160	0	0	0	17.3124853217
121	163	2	0	2	28.8364307392
121	164	8	7	1	12.0350906584
121	166	8	1	7	29.60755721
121	168	6	0	6	13.791263131
121	169	2	0	2	27.2134887174
121	170	1	0	1	31.2997463372
121	171	24	3	21	16.0920121918
121	172	20	1	19	15.8210123722
121	175	2	0	2	18.0043368669
121	177	35	6	29	19.8598850051
121	183	1	0	1	99.5627049941
121	222	0	0	0	111.116496211
121	229	2	0	2	95.9168203673
121	245	3	0	3	31.8099498844
121	268	1	0	1	82.9223706384
121	277	4	0	4	59.5803949864
121	293	1	0	1	61.2146977163
121	303	1	0	1	48.8857295217
121	309	2	0	2	37.9997439504
121	310	0	0	0	55.4870814737
121	316	1	0	1	54.4125013279
121	318	1	0	1	44.7279508733
121	319	16	2	14	47.1141111114
121	323	1	0	1	39.8093528814
121	326	1	1	0	42.8157000307
121	329	3	0	3	36.5925320051
121	334	1	0	1	66.1052700028
121	338	4	1	3	56.8794798248
121	347	1	0	1	35.2719026543
121	349	0	0	0	47.4417667959
121	350	2	0	2	48.5985962839
121	353	2	0	2	44.4074940915
121	385	1	0	1	63.5329857894
121	397	1	0	1	69.7487801521
121	406	1	0	1	80.411988145
121	408	3	0	3	80.7771798781
121	411	1	0	1	77.397766428
121	415	1	0	1	70.4407706172
121	426	0	0	0	117.855742865
121	451	1	1	0	65.2738261438
121	460	1	1	0	56.9404030691
121	466	2	0	2	71.6523928033
121	469	0	0	0	58.1467436665
121	472	2	0	2	51.3107258924
121	476	1	0	1	46.7982148446
121	480	1	0	1	59.2299186052
121	491	1	0	1	68.0299187175
121	502	0	0	0	77.3794284373
121	503	2	0	2	68.7623259267
121	508	1	0	1	151.590866158
121	535	1	0	1	128.967461807
121	551	0	0	0	62.4752339903
121	555	0	0	0	73.3065915814
121	566	1	0	1	56.2045317671
121	573	6	0	6	50.2922526266
121	577	1	0	1	45.028758375
121	581	0	0	0	35.5541645623
122	0	1	0	1	38.6130650853
122	1	16	0	16	51.3647027941
122	9	1	0	1	38.7711847164
122	13	1	0	1	39.7461903569
122	15	0	0	0	45.2610841318
122	19	1	0	1	36.6261753126
122	23	1	0	1	52.4880981589
122	27	0	0	0	60.7918915211
122	28	1	0	1	47.0950741934
122	32	2	0	2	31.8704330787
122	35	2	0	2	44.4678653053
122	36	15	0	15	31.2677374952
122	39	2	0	2	29.8041769926
122	47	1	0	1	82.2400207761
122	48	1	0	1	69.6290911409
122	55	1	0	1	72.4742547793
122	70	229	123	106	9.25092859214
122	71	14	3	11	19.2979369502
122	72	24	3	21	10.7859023381
122	73	428	123	305	16.2875797144
122	74	28	1	27	16.3690627715
122	75	33	1	32	18.3223857184
122	76	48	10	38	11.2828098386
122	77	13	3	10	12.2905988874
122	78	75	2	73	15.0310406001
122	79	53	5	48	13.4413462212
122	80	10	0	10	12.5528812918
122	81	83	2	81	11.8251460376
122	82	49	13	36	12.8458728877
122	83	27	0	27	15.1406671163
122	84	45	0	45	16.5308996717
122	85	40	0	40	14.1391919197
122	86	13	1	12	18.401575352
122	87	31	0	31	19.2129638073
122	88	20	4	16	19.7294560922
122	89	76	28	48	11.0676885747
122	90	49	0	49	11.9721139587
122	91	1	0	1	19.8855905002
122	92	137	8	129	6.63938191249
122	93	4	0	4	14.0632899748
122	94	26	8	18	5.9768515655
122	95	10	3	7	20.897654218
122	96	182	39	143	10.9585897392
122	97	12	2	10	13.4498571746
122	98	1	0	1	21.0162050077
122	99	2	1	1	31.286013208
122	101	11	1	10	7.71115683076
122	102	6	2	4	23.3295042146
122	103	29	0	29	22.0549654079
122	104	4	0	4	19.600602321
122	105	4	1	3	16.4280251167
122	106	4	0	4	16.6353233141
122	107	1	0	1	26.3694575795
122	108	20	3	17	7.75950371522
122	109	117	3	114	6.38435454048
122	110	2	0	2	26.4266304244
122	111	56	3	53	6.07599928251
122	112	20	9	11	22.9969334639
122	113	36	0	36	23.5753526092
122	114	2	0	2	27.6727389658
122	115	28	10	18	5.38601206221
122	116	11	1	10	10.4443416576
122	117	3	0	3	21.9098273784
122	118	4	0	4	13.7432315066
122	119	5	0	5	16.640223631
122	120	14	2	12	14.8148183519
122	123	9	3	6	10.6489088755
122	124	0	0	0	52.9048883176
122	128	1	0	1	42.4553810541
122	131	1	0	1	66.864678251
122	134	1	0	1	35.5886862962
122	135	1	0	1	50.2389525265
122	137	1	0	1	31.6168201157
122	138	1	0	1	40.4936414277
122	140	1	0	1	29.6986612556
122	142	33	0	33	38.8381532853
122	145	1	0	1	43.0828159742
122	155	6	0	6	20.5727988901
122	156	6	2	4	17.1076803104
122	162	1	0	1	20.1139462247
122	164	5	0	5	22.847932555
122	166	3	0	3	26.8254518027
122	169	4	1	3	13.8251433475
122	171	2	0	2	20.4274052068
122	172	3	1	2	32.1008291025
122	177	4	0	4	32.3620844704
122	183	7	0	7	81.5053466052
122	196	0	0	0	91.2412116098
122	208	2	0	2	63.2200211493
122	220	2	0	2	97.1558334278
122	241	1	0	1	114.173771
122	242	1	0	1	108.891392526
122	245	30	8	22	16.0693500739
122	246	2	0	2	11.0093699937
122	247	7	0	7	18.6331884739
122	248	1	0	1	14.3665853892
122	250	3	1	2	22.8740752356
122	251	39	9	30	11.2557603153
122	253	3	0	3	25.8745003888
122	254	3	0	3	19.1283628716
122	255	1	0	1	27.9739394765
122	256	1	0	1	22.2313861479
122	257	4	0	4	24.381171694
122	260	3	0	3	20.1844222383
122	262	1	0	1	28.8093863259
122	263	4	1	3	25.3615779454
122	271	1	0	1	58.3415364113
122	272	0	0	0	49.4899707913
122	275	1	0	1	48.6389121397
122	277	34	13	21	42.2695009405
122	281	1	0	1	32.8804402384
122	282	2	0	2	34.6624530624
122	284	2	0	2	42.0206865149
122	293	1	0	1	38.3858524041
122	294	1	0	1	39.7445639104
122	296	0	0	0	28.5683868959
122	303	1	0	1	49.0068972685
122	307	1	0	1	39.2830259382
122	309	1	0	1	35.6966187999
122	319	4	1	3	47.6301053335
122	323	1	0	1	44.984718782
122	329	2	0	2	30.3314450896
122	338	1	0	1	42.3494062364
122	348	1	0	1	17.7762465849
122	352	1	0	1	23.295253896
122	353	0	0	0	28.8705216004
122	367	1	1	0	41.0774627573
122	441	0	0	0	121.387558293
122	464	0	0	0	80.2234936822
122	466	3	0	3	94.9581198775
122	469	1	0	1	81.469399885
122	475	0	0	0	73.0392789684
122	482	1	0	1	109.158886255
122	484	0	0	0	91.9098929341
122	495	0	0	0	96.4367942598
122	503	1	0	1	91.560891666
123	0	1	0	1	31.477038337
123	1	17	0	17	43.11018708
123	3	2	0	2	27.7219116449
123	5	1	0	1	52.507404491
123	9	1	0	1	30.9326293647
123	13	6	3	3	33.5701074366
123	16	1	0	1	27.3511487174
123	19	1	0	1	29.0474533537
123	28	2	0	2	38.4938654055
123	32	2	0	2	23.071662599
123	36	11	5	6	27.2286590292
123	41	0	0	0	34.3164941789
123	53	1	0	1	74.8451687399
123	55	1	0	1	68.9862077258
123	60	1	0	1	61.1033571513
123	70	124	14	110	14.99058496
123	71	12	0	12	24.9440128948
123	72	39	0	39	13.2531033701
123	73	663	86	577	18.55098695
123	74	27	3	24	21.1160602038
123	75	33	0	33	20.9560316456
123	76	50	11	39	17.7367492547
123	77	15	5	10	13.9939245525
123	78	89	0	89	20.4873254436
123	79	66	0	66	14.6494077484
123	80	13	1	12	15.3238124822
123	81	89	16	73	15.2314918853
123	82	61	8	53	18.0947039897
123	83	31	6	25	18.6677998285
123	84	83	29	54	19.5507650982
123	85	16	0	16	21.4309989032
123	86	9	0	9	24.9045373456
123	87	21	6	15	23.0404121824
123	88	16	3	13	24.3752056085
123	89	341	102	239	7.00451589109
123	90	10	0	10	21.5248597858
123	92	140	0	140	10.0348936465
123	94	1	0	1	13.7669297988
123	95	19	0	19	18.8382777507
123	96	40	0	40	21.5305747618
123	97	1	0	1	20.9034919648
123	98	1	0	1	28.4255235692
123	99	1	0	1	31.4737316661
123	100	1	0	1	20.0776868054
123	101	79	23	56	4.48607366734
123	102	8	0	8	16.3482850292
123	103	28	3	25	23.0364690798
123	104	15	0	15	15.3875186714
123	105	21	5	16	10.6043589152
123	106	13	10	3	7.93503857916
123	107	3	0	3	32.8133094864
123	109	24	6	18	15.8271961936
123	110	3	0	3	26.9590508332
123	111	205	91	114	5.09991419537
123	112	54	0	54	22.5017027914
123	113	63	0	63	26.2752376275
123	114	1	0	1	25.3980404086
123	115	24	0	24	7.50980670899
123	116	9	1	8	18.3087015387
123	118	1	0	1	22.1372291911
123	119	4	1	3	25.3768731853
123	120	23	0	23	13.6011772628
123	122	14	0	14	10.6489088755
123	128	1	0	1	46.4788538627
123	130	0	0	0	51.6094395614
123	133	1	0	1	37.43445251
123	139	0	0	0	63.6690906665
123	140	1	0	1	31.8327095729
123	141	1	0	1	68.5037869708
123	142	25	1	24	41.4789987616
123	146	3	1	2	30.1247716711
123	149	1	0	1	69.5994582239
123	155	2	0	2	30.6855686808
123	156	2	0	2	27.6291474884
123	159	1	0	1	40.5303052843
123	162	0	0	0	30.7622032637
123	164	1	0	1	30.8297782792
123	169	2	1	1	24.3714291666
123	171	3	0	3	29.6071035017
123	172	1	0	1	39.5585670636
123	177	3	0	3	40.8731375562
123	183	7	0	7	73.1080808452
123	208	1	0	1	60.8770570192
123	212	1	0	1	50.1267522381
123	220	2	0	2	89.815805248
123	222	0	0	0	84.4259789725
123	229	2	0	2	68.9573509062
123	239	1	0	1	64.5365818748
123	242	0	0	0	102.891038806
123	245	465	77	388	5.59153513379
123	246	83	29	54	4.48863501508
123	247	3	0	3	20.3075703475
123	248	6	3	3	8.85301936049
123	249	5	0	5	16.1012811661
123	250	6	0	6	13.7737064154
123	251	47	13	34	11.6500175949
123	252	2	0	2	17.0805676241
123	253	4	2	2	22.1338127499
123	254	16	0	16	11.6401249841
123	255	2	1	1	17.5359305899
123	256	5	1	4	13.3397446005
123	257	24	0	24	13.8468514342
123	258	1	0	1	19.4197243026
123	259	1	0	1	22.3536423765
123	260	14	12	2	9.84097310217
123	261	1	0	1	24.0363832989
123	262	6	0	6	19.9218457851
123	263	3	0	3	15.4961904543
123	264	4	1	3	19.0008947616
123	268	1	0	1	56.8629003139
123	271	1	0	1	50.7773376781
123	273	2	0	2	32.5864375514
123	275	3	0	3	39.0024615962
123	276	1	0	1	30.2854323542
123	277	87	1	86	33.2424017194
123	279	2	0	2	28.5915566794
123	280	1	0	1	40.6975720413
123	281	3	0	3	24.6411778921
123	282	8	1	7	27.4141259464
123	284	4	0	4	35.9391824515
123	287	2	1	1	36.5098607109
123	294	1	0	1	39.6113296578
123	295	1	0	1	34.612691824
123	298	1	0	1	41.7330717671
123	302	1	0	1	27.6456217575
123	303	3	1	2	39.5397202504
123	305	4	0	4	25.6544695195
123	306	1	0	1	36.1981109125
123	307	5	0	5	28.9962711388
123	309	4	1	3	26.243028314
123	332	1	0	1	57.5411949788
123	336	1	0	1	44.760316747
123	338	1	0	1	51.2418791048
123	353	0	0	0	37.9787197612
123	365	0	0	0	58.4373830574
123	375	1	0	1	59.197360116
123	385	1	0	1	89.5642866721
123	459	0	0	0	94.0424149636
123	469	1	0	1	83.6914489289
123	470	0	0	0	74.5625028882
123	471	2	0	2	82.8853804495
123	472	0	0	0	75.4953713145
123	473	0	0	0	76.4659090329
123	474	1	0	1	103.06913583
123	475	0	0	0	77.0482064673
123	488	1	0	1	97.4264555498
123	495	1	0	1	99.5547197554
123	503	1	0	1	95.8663392305
124	0	5	0	5	37.2592141697
124	1	302	6	296	45.1026585436
124	2	1	0	1	31.2508038299
124	3	3	0	3	36.2998434927
124	5	3	0	3	43.7812530703
124	7	9	1	8	35.4434796177
124	10	1	0	1	31.9910671389
124	12	2	0	2	48.3040211331
124	13	7	3	4	32.9590217165
124	15	49	0	49	34.9479028557
124	17	3	0	3	29.6618772733
124	18	2	0	2	33.1340898051
124	19	1	0	1	39.3807251889
124	21	2	0	2	39.4455529695
124	24	3	0	3	34.1960567318
124	25	2	0	2	48.6700303836
124	27	2	0	2	32.8163876943
124	28	4	0	4	45.9879625799
124	29	2	1	1	35.4464670285
124	30	12	2	10	19.6250259682
124	31	22	3	19	20.8643434325
124	32	5	0	5	45.0571859516
124	33	18	2	16	27.2271592661
124	34	183	3	180	12.8560249749
124	35	152	17	135	24.8994143002
124	36	154	3	151	29.3263633838
124	37	5	0	5	22.8336079442
124	38	13	5	8	17.3797589194
124	39	2	1	1	40.0257069524
124	41	16	0	16	24.3700891209
124	42	8	0	8	35.4509377343
124	43	1	0	1	41.4248468919
124	45	2	0	2	29.1782103922
124	46	8	0	8	36.3059618623
124	47	2	0	2	33.3492675149
124	48	66	15	51	21.4593813233
124	49	6	0	6	22.9598688841
124	50	56	21	35	19.6212935465
124	51	4	0	4	18.2340192788
124	52	85	7	78	6.62067524278
124	53	2	0	2	50.7061113819
124	54	37	22	15	8.9893277433
124	55	2	0	2	28.7979671497
124	56	1	0	1	29.7454584605
124	57	4	0	4	20.9939462624
124	59	15	3	12	33.8490634259
124	60	18	3	15	19.4659615398
124	62	1	0	1	48.6938493298
124	65	12	3	9	38.1772338127
124	66	2	0	2	26.230772891
124	67	1	0	1	35.2093823878
124	68	88	38	50	13.1229479372
124	69	12	0	12	14.2355278075
124	70	28	3	25	43.8598469966
124	71	8	2	6	35.9187628773
124	72	5	1	4	42.3290350758
124	73	498	2	496	36.6348280098
124	74	35	3	32	37.2503304184
124	75	57	4	53	34.6003046443
124	76	21	0	21	42.6004647182
124	77	3	0	3	40.9453099373
124	78	53	1	52	38.8933591943
124	79	4	0	4	39.8959570792
124	80	1	0	1	40.3976243788
124	81	24	3	21	41.0838613152
124	82	49	5	44	40.5473032075
124	83	15	1	14	37.8308070941
124	84	67	22	45	36.4023120267
124	85	9	1	8	41.6781386518
124	86	11	0	11	37.8592591082
124	87	40	10	30	34.1733555048
124	88	13	1	12	34.3845371444
124	89	6	1	5	46.3893742186
124	90	1	0	1	47.5802719058
124	92	8	2	6	46.7288477705
124	95	12	0	12	34.5395004109
124	96	1	0	1	52.8621541808
124	98	3	0	3	38.5511225334
124	99	37	1	36	21.939883683
124	100	3	0	3	35.7317807248
124	101	1	0	1	55.7792665157
124	102	4	0	4	41.237518289
124	103	75	7	68	30.9912578827
124	107	8	0	8	33.5881036387
124	109	3	1	2	48.9195774144
124	110	26	0	26	26.6929959435
124	111	2	1	1	51.1836424633
124	112	81	8	73	30.873454683
124	113	193	11	182	29.5556839901
124	114	7	1	6	28.4872715576
124	116	1	0	1	44.6241786847
124	117	1	0	1	31.8576540627
124	120	3	1	2	39.8921120492
124	121	3	0	3	30.7265428873
124	125	79	40	39	5.94539133807
124	126	14	6	8	9.99847306669
124	127	5	0	5	23.3508531657
124	128	43	1	42	18.9403169067
124	129	31	0	31	21.288673979
124	130	4	0	4	17.1618193058
124	131	186	2	184	14.3878143576
124	132	3	0	3	21.6022980782
124	133	59	12	47	15.8896451664
124	134	62	7	55	17.5844211865
124	135	7	0	7	23.3549231292
124	136	72	59	13	7.92392899219
124	137	10	1	9	28.3746111305
124	138	28	2	26	14.8277677759
124	139	3	1	2	15.3964092627
124	140	34	1	33	23.4755284578
124	141	4	1	3	29.4985781611
124	142	1591	51	1540	16.2737702055
124	143	69	36	33	12.1545361872
124	144	13	0	13	22.5516815259
124	145	164	3	161	9.82948779042
124	146	10	0	10	30.262076624
124	147	87	5	82	20.4289673401
124	148	97	22	75	9.71454935661
124	149	1	0	1	23.8364851965
124	151	156	30	126	7.35261366468
124	152	72	34	38	7.63205934573
124	153	2	0	2	14.8118545328
124	154	14	0	14	24.6956988911
124	160	2	0	2	29.4869268729
124	164	2	1	1	39.7190038209
124	166	5	0	5	57.4659419444
124	168	3	1	2	38.1573555276
124	171	2	0	2	44.8636000662
124	172	6	0	6	35.8620192619
124	177	3	1	2	41.2491576764
124	179	1	1	0	62.511889665
124	183	2	0	2	118.415538008
124	185	1	0	1	125.499989587
124	194	1	0	1	130.422707103
124	196	0	0	0	140.890587142
124	208	2	0	2	114.201069363
124	220	0	0	0	137.580779795
124	229	1	0	1	121.396865421
124	242	0	0	0	153.17698117
124	245	1	0	1	55.9609757399
124	248	1	0	1	62.1625750116
124	251	2	0	2	62.9610630103
124	253	1	0	1	75.4578851235
124	257	6	0	6	54.3414293237
124	260	1	0	1	52.2022556556
124	262	1	0	1	69.614848337
124	264	1	0	1	58.6224139156
124	277	8	0	8	80.2390645117
124	282	0	0	0	78.7096097575
124	294	0	0	0	92.1583102074
124	295	2	0	2	87.5162248925
124	303	1	0	1	52.7853824176
124	304	1	0	1	44.217182602
124	307	3	0	3	56.333396947
124	319	1	0	1	70.0549380527
124	349	1	0	1	75.9736057319
124	355	1	0	1	77.5857208023
124	375	1	0	1	110.464770707
124	408	1	0	1	64.6588716846
124	415	1	0	1	56.1900015395
124	428	1	0	1	92.7745008693
124	432	1	0	1	87.7596682481
124	464	12	2	10	27.3456769435
124	465	6	2	4	39.6859132705
124	466	19	0	19	44.2114690783
124	468	10	0	10	16.663274553
124	469	84	11	73	31.6455790181
124	470	7	0	7	22.679558592
124	471	12	0	12	30.5289268975
124	472	12	0	12	22.3235495851
124	473	1	0	1	26.7779518646
124	474	1	0	1	49.7815204844
124	475	11	0	11	30.9512143754
124	476	25	11	14	16.1059375415
124	477	2	0	2	35.8517516848
124	479	2	1	1	24.1425671442
124	480	8	0	8	29.9414088828
124	484	3	1	2	40.3274580716
124	485	1	0	1	60.4840679431
124	487	4	1	3	43.7851647935
124	488	10	2	8	44.5258966256
124	491	8	4	4	38.578565944
124	493	1	0	1	59.5483091411
124	494	1	0	1	32.2952753705
124	495	1	0	1	48.6697737293
124	497	1	0	1	40.8701411621
124	501	2	0	2	55.5509485817
124	502	1	0	1	54.9808691566
124	503	2	0	2	48.5308968735
124	504	2	0	2	36.0576118609
124	505	2	0	2	56.9937764331
124	507	1	0	1	160.33258373
124	573	2	0	2	58.7918126255
124	581	1	0	1	49.5681278106
125	0	3	0	3	31.3484150745
125	1	153	24	129	39.6282294224
125	2	4	1	3	25.7158829517
125	3	1	0	1	30.355306743
125	4	2	0	2	29.1720096494
125	5	5	0	5	39.0542994528
125	7	5	0	5	29.6552816337
125	13	11	2	9	27.0745749877
125	14	1	0	1	24.1113905629
125	15	84	34	50	29.2994613235
125	17	3	0	3	24.7032500363
125	18	1	0	1	27.1898139273
125	23	3	0	3	31.0163080975
125	24	2	0	2	28.941167998
125	26	1	0	1	23.8811821609
125	28	3	0	3	40.2799860012
125	29	1	0	1	32.2186361076
125	30	11	6	5	14.3071205911
125	31	21	6	15	15.0421957781
125	32	1	0	1	39.1310508812
125	33	13	2	11	21.3265503053
125	34	173	40	133	7.94548000813
125	35	114	5	109	19.2413078847
125	36	78	0	78	23.5165968276
125	37	1	0	1	18.0929421142
125	38	18	3	15	11.4520977913
125	39	2	0	2	34.1356386046
125	41	10	4	6	18.4247051614
125	42	3	1	2	29.5718170257
125	45	1	0	1	32.5458361711
125	46	3	0	3	34.2901149634
125	47	2	0	2	35.1432926189
125	48	29	7	22	22.5876012233
125	49	4	1	3	19.4745396927
125	50	22	6	16	17.7008891066
125	52	22	0	22	8.21534719089
125	53	1	0	1	48.2307168814
125	54	23	2	21	6.50721295712
125	55	2	0	2	28.4830971826
125	58	1	0	1	40.8585001077
125	59	1	0	1	36.0009090309
125	60	3	0	3	18.7803207459
125	65	6	0	6	37.410557063
125	68	29	22	7	12.9853435656
125	69	3	1	2	17.5318641467
125	70	9	0	9	39.7575911107
125	71	4	0	4	32.7094249467
125	73	136	14	122	32.3222258925
125	74	10	1	9	33.5094294985
125	75	19	1	18	30.4638205239
125	76	3	1	2	38.767707795
125	77	1	1	0	36.4225607305
125	78	9	3	6	35.1985212224
125	79	3	1	2	35.3267482826
125	81	10	0	10	36.7887242991
125	82	8	2	6	36.6282165416
125	83	8	0	8	33.7270559088
125	84	31	6	25	32.2654261386
125	85	3	0	3	38.277251876
125	86	2	0	2	34.7710319103
125	87	14	0	14	30.4259848292
125	88	4	0	4	30.9293223309
125	89	1	0	1	41.3957796606
125	92	2	0	2	42.2293102009
125	95	4	1	3	29.4105015472
125	99	18	3	15	17.307725585
125	101	0	0	0	50.9353881914
125	103	43	9	34	26.5338843594
125	107	1	0	1	31.6161512606
125	109	1	0	1	45.0586499871
125	110	4	0	4	22.1642622537
125	111	4	3	1	46.4232433125
125	112	36	0	36	26.0113719016
125	113	81	4	77	25.7745047893
125	114	4	0	4	23.0763500276
125	115	0	0	0	51.7414269803
125	116	1	0	1	40.9438947448
125	117	1	0	1	28.3754588078
125	119	1	0	1	41.0304640601
125	120	4	0	4	35.0136820794
125	122	0	0	0	48.5881421416
125	124	453	85	368	5.94539133807
125	126	1	1	0	15.7686225279
125	127	1	0	1	20.9949964371
125	128	10	0	10	19.7156183812
125	129	12	0	12	15.9492865496
125	130	1	0	1	19.5325201742
125	131	34	5	29	19.9225740738
125	133	29	2	27	11.1253574208
125	134	19	0	19	14.4372088162
125	135	1	0	1	26.1513314284
125	136	18	3	15	8.68666030826
125	138	31	13	18	9.12198928565
125	140	8	0	8	19.9619920156
125	142	418	0	418	14.9432512672
125	143	14	0	14	14.2368080207
125	144	7	1	6	21.9034086936
125	145	52	16	36	6.43081907339
125	146	3	1	2	27.5380386061
125	147	14	1	13	24.3448770928
125	148	70	21	49	4.14436366628
125	151	14	9	5	12.9148991078
125	152	10	0	10	12.1682720218
125	154	3	0	3	25.7258954098
125	164	1	0	1	37.5614917766
125	169	1	0	1	54.6164448252
125	171	1	0	1	42.5354286008
125	172	4	0	4	35.0665680849
125	173	0	0	0	47.8164927205
125	177	3	0	3	40.5252467754
125	183	0	0	0	112.499001616
125	194	1	0	1	124.758716735
125	208	1	0	1	109.079351797
125	220	0	0	0	131.707813052
125	245	1	0	1	50.6114497639
125	251	2	0	2	58.2665977099
125	277	0	0	0	74.4464401665
125	281	0	0	0	69.1787947361
125	282	1	0	1	73.1711501839
125	292	1	0	1	88.6251761263
125	304	1	0	1	38.3044439625
125	305	1	0	1	58.7499820911
125	375	1	0	1	106.067297504
125	464	1	0	1	32.2369569504
125	465	2	0	2	45.5877582773
125	466	3	1	2	49.9305920039
125	469	15	5	10	37.5280131872
125	470	2	0	2	28.6053427827
125	471	4	0	4	34.8026578454
125	472	6	0	6	27.9339253781
125	474	1	0	1	55.16048802
125	475	4	1	3	36.5941032468
125	476	6	1	5	20.6298623765
125	484	1	0	1	43.5480830421
125	485	1	0	1	65.6724368173
125	487	1	0	1	47.6430113635
125	488	1	0	1	49.2051269835
125	489	1	0	1	57.7634502943
125	491	2	0	2	43.8573185241
125	496	1	0	1	45.0360952705
125	499	1	0	1	51.4762916972
125	503	1	0	1	54.3981163427
125	505	0	0	0	62.6797948778
125	573	1	0	1	61.1118423767
125	585	0	0	0	84.4799927478
126	0	3	0	3	47.0874670941
126	1	16	0	16	55.0826547315
126	3	1	0	1	45.8924778352
126	5	2	0	2	53.4092200002
126	13	2	0	2	42.837243478
126	15	1	0	1	44.9452136265
126	21	1	0	1	49.2168119619
126	25	2	0	2	57.5078626436
126	26	1	0	1	37.2068266018
126	28	1	0	1	55.9791606473
126	31	1	0	1	30.0902201249
126	32	1	0	1	54.4627420708
126	34	6	0	6	22.7950982617
126	35	7	0	7	34.8937986568
126	36	12	2	10	38.4076014302
126	41	1	0	1	34.0325776765
126	46	2	0	2	43.621477384
126	48	10	0	10	25.8250636819
126	49	2	0	2	31.9957070502
126	50	6	1	5	27.6021925019
126	51	1	0	1	27.4080308033
126	52	3	1	2	14.2162786091
126	54	3	1	2	18.3954550958
126	59	1	0	1	35.4604510035
126	60	1	0	1	26.2864964586
126	65	3	0	3	43.9635416238
126	68	7	0	7	20.2827809477
126	69	1	0	1	16.4279005564
126	70	1	0	1	49.4755303955
126	73	66	12	54	42.8090134416
126	74	7	1	6	42.4618048275
126	75	13	0	13	40.5545066609
126	76	2	0	2	47.7908040743
126	78	4	1	3	43.970291766
126	79	1	0	1	46.4152304028
126	80	0	0	0	46.5473467026
126	81	9	3	6	47.1011313501
126	82	9	3	6	45.9432049047
126	83	2	0	2	43.6196900956
126	84	10	0	10	42.2932390865
126	85	9	0	9	46.1739046718
126	87	9	0	9	39.5177821352
126	89	2	0	2	53.5513264628
126	92	3	0	3	52.9775404427
126	95	1	0	1	42.1680287143
126	96	3	0	3	56.9596521808
126	99	5	0	5	29.2569179003
126	102	2	0	2	49.8581803158
126	103	21	0	21	37.5999302015
126	104	2	0	2	46.5074883058
126	107	2	1	1	36.1366060919
126	110	5	0	5	33.5996039706
126	111	1	0	1	57.8355079778
126	112	7	0	7	38.142168704
126	113	29	3	26	35.17545579
126	121	0	0	0	35.5416402512
126	124	78	59	19	9.99847306669
126	125	1	0	1	15.7686225279
126	127	2	0	2	27.3400633666
126	128	21	6	15	18.7860161825
126	129	1	0	1	29.660352056
126	130	5	4	1	14.5390828379
126	131	224	4	220	9.82328457148
126	132	4	1	3	11.7550575178
126	133	2	0	2	23.8289979939
126	134	9	3	6	23.3828353416
126	135	6	0	6	18.6847318814
126	136	4	2	2	12.354845864
126	137	3	0	3	30.3137842758
126	138	2	0	2	23.9972532139
126	139	12	1	11	5.57169561391
126	140	3	0	3	29.1124167023
126	141	2	0	2	20.8272108015
126	142	416	179	237	19.9453821898
126	143	40	22	18	11.9794881597
126	144	6	2	4	24.0646432844
126	145	16	0	16	17.445097243
126	146	3	1	2	34.2117463476
126	147	98	1	97	13.8572030667
126	148	2	0	2	19.0141936166
126	149	3	1	2	14.0229330656
126	150	3	0	3	13.4070196534
126	151	43	9	34	7.11656302881
126	152	47	28	19	5.83184245196
126	153	8	1	7	7.75236854944
126	154	2	1	1	23.1140440369
126	155	1	0	1	52.5559495418
126	163	1	0	1	24.3593239885
126	166	1	1	0	58.9261364718
126	172	1	0	1	36.3531666857
126	175	1	0	1	45.8529672771
126	177	0	0	0	41.3335094954
126	196	1	0	1	148.395274323
126	211	1	0	1	128.980644742
126	220	0	0	0	146.60793381
126	277	1	0	1	89.0292204974
126	283	1	0	1	77.288830996
126	303	1	0	1	62.7680126409
126	304	2	0	2	54.03723836
126	406	1	0	1	52.3814685502
126	408	1	0	1	54.6605213143
126	464	6	0	6	23.2172035262
126	465	2	0	2	30.9169157878
126	466	12	2	10	36.4104736195
126	468	22	4	18	8.34014073037
126	469	28	0	28	23.1512223943
126	470	15	0	15	14.0105775755
126	471	8	2	6	27.887121565
126	472	6	2	4	15.9014040276
126	475	7	2	5	20.9660049477
126	476	20	5	15	14.8552947981
126	477	2	1	1	28.6525920218
126	478	1	0	1	41.8775641109
126	479	1	0	1	22.461778713
126	480	4	0	4	23.8018894521
126	482	2	0	2	51.267143624
126	484	1	0	1	39.5266252225
126	487	1	0	1	41.4494976581
126	488	5	0	5	40.1301179681
126	491	5	0	5	32.5825410418
126	493	1	0	1	52.643204276
126	494	1	0	1	22.793587964
126	495	1	0	1	39.5877127372
126	503	2	0	2	38.6468366133
127	0	1	0	1	34.7862558939
127	1	35	4	31	47.5113049931
127	5	1	0	1	51.2708495239
127	7	1	0	1	35.8482298982
127	12	1	0	1	54.6460694405
127	13	2	1	1	32.1727037282
127	15	1	0	1	37.1717811167
127	20	1	0	1	44.8022704522
127	24	1	0	1	39.7703270474
127	32	1	0	1	37.1821768222
127	33	2	0	2	27.7332978431
127	35	2	0	2	29.5355508648
127	36	36	14	22	22.4327648381
127	39	4	0	4	31.7884654311
127	41	1	0	1	23.7633016453
127	46	3	0	3	53.3582524854
127	47	1	0	1	56.0619929912
127	48	0	0	0	43.5731739941
127	50	1	0	1	37.7104024669
127	53	2	0	2	66.1327250606
127	65	1	0	1	57.6692067932
127	68	2	0	2	33.9587189669
127	70	12	2	10	22.4207635426
127	71	19	7	12	12.9927073069
127	72	3	1	2	22.2104465779
127	73	337	21	316	16.5908069817
127	74	43	0	43	15.2910681721
127	75	54	5	49	14.1897942552
127	76	5	0	5	20.5378842265
127	77	4	0	4	21.2060358002
127	78	36	1	35	16.7135983556
127	79	6	1	5	20.477881651
127	80	1	0	1	20.0832165745
127	81	13	0	13	20.4603308047
127	82	9	0	9	18.8127014552
127	83	11	6	5	16.8752328597
127	84	69	10	59	15.7297386626
127	85	15	2	13	18.8471258442
127	86	17	1	16	14.7372833892
127	87	67	12	55	12.5266329984
127	88	32	8	24	11.978152784
127	89	6	0	6	28.3086905029
127	90	4	0	4	24.5059783711
127	92	13	3	10	26.3981860747
127	95	15	0	15	19.2345044339
127	96	6	0	6	29.7946139763
127	98	8	0	8	15.2090700289
127	99	15	0	15	10.3209406895
127	102	3	1	2	29.1592001592
127	103	84	0	84	12.8380647365
127	104	1	0	1	23.8378699826
127	107	58	1	57	10.6491347798
127	109	2	0	2	26.6830194935
127	110	19	2	17	10.7887829292
127	111	2	0	2	31.6015708682
127	112	29	15	14	14.9887371246
127	113	254	7	247	8.87109862432
127	114	3	0	3	17.5178615683
127	117	14	6	8	9.7636262265
127	120	6	2	4	21.9765065167
127	121	16	4	12	8.32040867789
127	122	1	0	1	31.6584041823
127	124	6	2	4	23.3508531657
127	125	1	0	1	20.9949964371
127	126	1	0	1	27.3400633666
127	128	18	0	18	11.3741343566
127	129	10	4	6	14.4611794327
127	130	3	0	3	16.4930625964
127	131	4	0	4	36.1510166427
127	133	7	0	7	12.45976318
127	134	50	5	45	6.83377163495
127	135	2	0	2	20.484447427
127	136	5	1	4	15.9022205227
127	137	18	0	18	7.12076591753
127	138	3	0	3	17.1292404569
127	139	1	0	1	29.3400246329
127	140	82	13	69	4.93351214616
127	141	3	0	3	33.6193158308
127	142	792	0	792	7.44798588247
127	143	10	4	6	15.6809128497
127	144	17	5	12	6.59136727829
127	145	18	1	17	14.5655281272
127	146	113	69	44	6.98356419415
127	147	19	5	14	23.7867048668
127	148	2	0	2	18.1313838289
127	150	1	0	1	30.5804236859
127	151	1	0	1	29.8399645391
127	152	1	0	1	21.5624898697
127	153	2	0	2	23.8927332149
127	154	3	1	2	13.8970437436
127	155	3	0	3	26.9244672576
127	164	6	0	6	16.5742298091
127	165	1	0	1	24.0908884248
127	168	1	0	1	15.9287426744
127	171	4	0	4	21.6107885134
127	172	7	2	5	15.3877431396
127	175	1	0	1	21.7292052282
127	177	8	0	8	20.6554175023
127	183	0	0	0	106.476370857
127	196	2	0	2	122.407645409
127	208	2	0	2	94.7036730356
127	220	0	0	0	124.220302683
127	225	1	0	1	98.8121426867
127	236	1	0	1	88.9837967883
127	245	1	0	1	39.2775475928
127	247	1	0	1	50.2742611392
127	256	1	0	1	33.7369285116
127	257	2	0	2	41.2078985649
127	277	7	0	7	66.6267846113
127	281	0	0	0	59.2073124945
127	282	0	0	0	62.3988847729
127	310	0	0	0	63.5434970002
127	319	2	0	2	49.6931210776
127	326	1	0	1	47.8759184489
127	329	2	0	2	41.8835867099
127	375	1	0	1	88.6329276445
127	408	1	0	1	73.3062718844
127	415	1	0	1	63.1295121162
127	427	1	0	1	86.548117863
127	455	2	0	2	38.7178564526
127	464	2	0	2	49.7940240708
127	466	4	0	4	63.3466263221
127	469	6	0	6	49.8334139144
127	470	1	0	1	40.9164852646
127	471	2	0	2	53.5914227449
127	475	3	0	3	41.9487806907
127	476	0	0	0	39.2170327225
127	480	1	0	1	51.0998850107
127	484	1	0	1	63.6764020268
127	491	1	0	1	59.895517447
127	494	3	0	3	47.8673419012
127	503	3	0	3	60.7447665437
127	504	1	0	1	50.1280730392
127	573	2	1	1	47.5138316853
128	0	1	0	1	43.0447504228
128	1	29	4	25	54.5828056731
128	3	1	0	1	40.2773885458
128	13	4	0	4	39.7116408038
128	15	1	0	1	43.907001815
128	18	2	0	2	38.0611700026
128	27	1	0	1	48.0269861789
128	28	1	0	1	53.7530156487
128	31	1	0	1	25.291306128
128	32	2	0	2	47.1207438596
128	34	2	1	1	26.9507007036
128	35	1	0	1	34.8045716559
128	36	39	10	29	31.330155828
128	38	1	0	1	26.1978336206
128	41	3	1	2	30.4848859943
128	42	3	1	2	37.4324103294
128	46	1	0	1	54.0039428049
128	48	3	0	3	40.3944255194
128	50	4	1	3	37.3612183716
128	59	2	0	2	52.3612423683
128	61	0	0	0	57.029710815
128	68	1	0	1	31.7683206077
128	69	1	0	1	32.5332477676
128	70	20	5	15	33.3244880525
128	71	8	0	8	23.2309958692
128	72	4	1	3	33.4684706854
128	73	225	19	206	27.9301104386
128	74	16	3	13	26.1880792984
128	75	28	1	27	25.5252163631
128	76	6	0	6	31.18415484
128	78	20	3	17	27.4289298564
128	79	3	0	3	31.8296459529
128	81	9	0	9	31.6531304434
128	82	13	6	7	29.6900999667
128	83	13	0	13	28.0687997811
128	84	56	0	56	27.0041799065
128	85	4	0	4	28.8801876838
128	86	2	0	2	24.5170269627
128	87	20	5	15	23.6613074181
128	88	6	0	6	22.7800067445
128	89	4	0	4	39.6814960468
128	92	7	1	6	37.5586325698
128	95	4	0	4	30.2378305213
128	96	3	0	3	39.0392168649
128	98	6	1	5	23.5390496921
128	99	9	2	7	19.0548377261
128	103	36	2	34	24.0842540246
128	104	1	0	1	34.8795940775
128	105	2	0	2	38.9094271303
128	107	7	2	5	17.7349968352
128	109	1	0	1	37.0281371198
128	110	7	1	6	21.3729604052
128	111	1	0	1	42.8404740877
128	112	25	21	4	25.9167328669
128	113	126	0	126	20.2450012737
128	116	1	0	1	32.4652212086
128	119	1	0	1	29.2584929577
128	121	2	0	2	19.3561669828
128	122	0	0	0	42.4553810541
128	124	16	5	11	18.9403169067
128	125	2	0	2	19.7156183812
128	127	12	1	11	11.3741343566
128	129	6	2	4	22.0900595475
128	130	12	5	7	5.33226605378
128	131	6	0	6	28.4809185882
128	133	3	0	3	17.3274313323
128	134	44	42	2	12.3340124571
128	135	16	9	7	9.5279834612
128	136	10	0	10	11.3376806652
128	137	19	4	15	11.8073836729
128	138	2	1	1	21.0251807618
128	139	2	0	2	19.2787571286
128	140	25	9	16	15.4365223428
128	141	1	0	1	22.32798678
128	142	1383	361	1022	7.22270930867
128	143	54	2	52	7.20586935535
128	144	25	10	15	5.76324698708
128	145	14	7	7	14.605905976
128	146	16	5	11	17.0943463282
128	147	63	3	60	12.427952232
128	148	3	0	3	19.0176651087
128	149	1	0	1	23.4585337395
128	150	3	1	2	19.3259984461
128	151	4	0	4	23.4147561568
128	152	9	0	9	13.7824375571
128	153	1	1	0	13.4325410416
128	154	1	0	1	6.01235972217
128	164	3	0	3	23.6949884039
128	168	1	0	1	20.8991625521
128	171	1	0	1	28.8808846626
128	172	3	0	3	17.6513736183
128	177	11	1	10	22.8086154082
128	208	0	0	0	105.663092405
128	211	1	0	1	113.431442306
128	220	0	0	0	135.539284879
128	242	0	0	0	149.311705853
128	256	1	0	1	44.6808645138
128	257	2	0	2	52.2833594745
128	262	0	0	0	65.5144509301
128	275	1	0	1	81.9380210495
128	277	6	0	6	77.890736559
128	304	1	0	1	49.3679877378
128	307	1	0	1	59.2616776755
128	338	1	0	1	70.0867438829
128	408	4	0	4	62.005284495
128	411	1	0	1	59.1394481491
128	415	1	0	1	51.9158474114
128	423	1	0	1	119.351594611
128	464	2	1	1	42.0017504891
128	465	4	0	4	46.5176065104
128	466	4	0	4	53.2707332051
128	469	11	0	11	39.7220643029
128	470	3	0	3	31.1736004857
128	471	2	0	2	46.5371686447
128	472	2	1	1	34.475411088
128	473	1	0	1	31.2099271255
128	475	7	3	4	30.6889726218
128	476	2	0	2	32.7639281662
128	477	1	0	1	46.3650011592
128	480	1	0	1	42.2576409567
128	482	1	0	1	69.7987568861
128	488	1	0	1	58.8611751085
128	491	2	0	2	50.9287698205
128	496	1	0	1	40.4014098838
128	503	2	0	2	49.4241387214
128	558	1	0	1	62.2322957972
128	573	4	0	4	41.7837716718
128	575	1	0	1	50.7870325645
128	585	0	0	0	64.8234649066
129	0	12	0	12	20.9904815572
129	1	236	0	236	33.1724699547
129	2	1	0	1	20.8693433147
129	3	3	3	0	18.2260399337
129	4	1	0	1	24.0617493799
129	5	1	0	1	36.8920324001
129	7	11	1	10	21.5389554244
129	9	4	0	4	23.8547174469
129	10	1	0	1	19.3802503631
129	12	1	0	1	40.1917799523
129	13	17	7	10	17.9224755169
129	15	18	0	18	22.7331267798
129	16	1	0	1	21.1700847414
129	18	9	2	7	15.987474155
129	19	1	0	1	21.9875128659
129	20	2	0	2	30.7447773848
129	21	3	0	3	31.8195162834
129	23	3	0	3	27.919752604
129	24	5	0	5	25.3806726507
129	27	1	0	1	31.7868196112
129	28	7	0	7	31.8521484411
129	30	4	1	3	15.6301330626
129	31	65	31	34	4.57960250043
129	32	7	2	5	25.6719420373
129	33	26	7	19	13.2723474353
129	34	17	6	11	15.9339800813
129	35	45	0	45	15.4075520959
129	36	678	103	575	9.43717345923
129	37	4	1	3	20.3069389816
129	38	15	2	13	9.46886943008
129	39	8	0	8	20.2461024478
129	41	48	3	45	9.3105760783
129	42	15	8	7	15.7693133181
129	46	1	1	0	41.4470546
129	48	2	0	2	36.1616254574
129	49	1	0	1	25.4667851352
129	50	5	0	5	27.6696286407
129	51	1	0	1	22.5148646519
129	52	2	0	2	23.7525626197
129	59	1	0	1	50.0426561892
129	65	6	1	5	46.9655715053
129	68	2	0	2	26.4934410827
129	70	22	0	22	25.2090871518
129	71	13	1	12	20.7704952895
129	72	1	0	1	22.6961599804
129	73	311	61	250	17.6305541615
129	74	27	0	27	20.0955334597
129	75	58	2	56	16.2957029163
129	76	18	0	18	24.8262173758
129	78	35	3	32	21.7769597732
129	79	22	7	15	20.0352039801
129	80	0	0	0	21.0973079356
129	81	15	0	15	21.9553858791
129	82	24	1	23	22.595063506
129	83	12	2	10	19.4272142895
129	84	44	0	44	17.9737600651
129	85	11	1	10	25.3718507226
129	86	11	1	10	22.9432772461
129	87	37	0	37	17.2723264954
129	88	10	2	8	18.5191854891
129	89	6	0	6	25.5293026708
129	90	3	0	3	31.3528230957
129	92	5	0	5	26.9220008555
129	95	27	0	27	13.500883991
129	96	8	1	7	36.2416297803
129	98	2	0	2	25.5661345732
129	99	133	43	90	4.31951942408
129	100	9	0	9	14.6717864221
129	102	10	4	6	20.1978388105
129	103	138	0	138	11.8792744547
129	104	8	0	8	17.305148424
129	105	5	0	5	22.2118197218
129	106	1	0	1	26.6943838947
129	107	6	0	6	23.3052046647
129	109	2	0	2	30.8339910199
129	110	33	0	33	7.85522225999
129	111	4	0	4	30.7391979743
129	112	134	57	77	10.483900633
129	113	235	21	214	13.1700764496
129	114	42	15	27	7.20116170135
129	116	1	0	1	27.2452045907
129	117	2	0	2	16.2326506442
129	118	1	0	1	28.0235566602
129	119	2	0	2	29.3036787372
129	120	4	1	3	19.2874029335
129	121	1	0	1	15.9792681941
129	122	4	1	3	33.4746417402
129	124	13	1	12	21.288673979
129	125	2	0	2	15.9492865496
129	126	1	0	1	29.660352056
129	127	1	0	1	14.4611794327
129	128	4	0	4	22.0900595475
129	131	3	0	3	35.6641188295
129	133	91	26	65	5.90052743957
129	134	24	1	23	9.78219973965
129	137	3	0	3	21.4687884384
129	138	31	19	12	7.11457372151
129	140	17	1	16	10.0525355033
129	141	1	0	1	43.1747320462
129	142	267	72	195	14.8963738592
129	143	2	0	2	21.7065716708
129	145	15	0	15	12.2184118018
129	146	2	0	2	17.8106284939
129	147	4	1	3	32.6233036031
129	148	9	1	8	11.8066350605
129	151	1	0	1	28.6169050414
129	154	1	0	1	26.8214979025
129	155	3	0	3	37.06922924
129	157	1	0	1	33.8334826771
129	160	1	0	1	27.2714787651
129	164	1	0	1	27.9456609064
129	168	1	0	1	28.9431388821
129	171	3	0	3	32.0343355231
129	172	6	2	4	29.4795867844
129	175	1	0	1	33.8419036082
129	177	5	0	5	34.4539087322
129	183	0	0	0	98.2302611438
129	188	1	0	1	101.059686122
129	190	1	0	1	95.5394376976
129	211	1	0	1	100.8658066
129	220	1	0	1	116.992142885
129	245	2	0	2	34.6974155039
129	256	2	0	2	25.5729219258
129	257	2	0	2	33.341010803
129	258	1	0	1	31.3920741047
129	260	1	0	1	30.9719871806
129	262	1	0	1	48.3812366351
129	275	1	0	1	62.3148675337
129	277	6	1	5	59.3707703144
129	282	2	0	2	57.4353047387
129	291	1	0	1	76.3856916142
129	293	1	0	1	67.3920015212
129	303	2	0	2	37.8187315548
129	305	1	1	0	44.4602609711
129	307	3	2	1	37.6982327277
129	319	3	0	3	62.8132986697
129	321	1	0	1	58.5414556458
129	338	0	0	0	71.8616834051
129	354	0	0	0	53.6230461149
129	375	1	0	1	90.5914144006
129	408	0	0	0	82.0836389478
129	464	1	0	1	48.1844224361
129	465	1	0	1	60.5082048354
129	466	2	0	2	65.4353932671
129	469	4	0	4	52.5956338848
129	470	1	0	1	43.4806545103
129	471	1	0	1	50.5831972105
129	477	1	0	1	57.133624321
129	480	2	0	2	51.1966647249
129	485	1	0	1	81.6093146687
129	487	1	0	1	63.1097384458
129	488	1	0	1	65.1000450564
129	491	0	0	0	59.7637006289
129	496	1	0	1	58.0946353909
129	501	0	0	0	76.4697254276
129	503	1	0	1	67.5093528409
129	505	1	0	1	78.2350835994
129	573	0	0	0	61.8274709956
130	0	2	0	2	46.1202287105
130	1	19	4	15	56.9284143646
130	6	1	0	1	57.6680324157
130	7	1	0	1	45.800792709
130	13	1	0	1	42.5012929278
130	15	1	0	1	46.2415518524
130	16	1	0	1	46.6563383133
130	21	1	0	1	53.1357370478
130	24	1	0	1	47.1194563877
130	27	1	0	1	48.4956950481
130	30	1	0	1	32.9443392521
130	33	2	0	2	36.9995954891
130	34	3	0	3	27.3281716751
130	35	4	0	4	36.6849722939
130	36	30	7	23	34.9214495422
130	39	1	0	1	45.5462019124
130	48	1	0	1	38.157725879
130	50	1	0	1	36.5604236508
130	55	3	0	3	45.9067613234
130	60	1	0	1	36.6269630366
130	65	2	0	2	55.3249241369
130	68	3	1	2	30.2847180065
130	70	22	0	22	38.6298587912
130	71	4	0	4	28.5627668491
130	72	2	0	2	38.6824548608
130	73	242	14	228	33.0836395427
130	74	14	1	13	31.4866522879
130	75	23	5	18	30.6828460808
130	76	6	1	5	36.5096176241
130	77	1	0	1	37.6983097209
130	78	25	1	24	32.7470571002
130	79	5	0	5	36.9665975302
130	80	1	0	1	36.553892592
130	81	9	1	8	36.8942745379
130	82	30	1	29	34.9954381861
130	83	12	4	8	33.3066343879
130	84	42	6	36	32.2059085244
130	85	8	0	8	34.2080466458
130	86	6	2	4	29.841789311
130	87	22	3	19	28.9112443622
130	88	7	2	5	28.083389001
130	89	4	0	4	44.7586345383
130	90	1	0	1	39.1828034037
130	92	3	1	2	42.8145044905
130	95	5	1	4	34.9037807263
130	96	4	0	4	44.2889591653
130	98	2	0	2	28.7644508129
130	99	8	2	6	23.0376591528
130	102	1	0	1	44.2375461355
130	103	37	5	32	28.973410517
130	104	1	0	1	39.5411918759
130	107	8	3	5	22.9211328176
130	109	0	0	0	42.3597981698
130	110	3	1	2	25.9390378786
130	112	37	9	28	30.5774665308
130	113	83	4	79	25.3356533755
130	114	1	0	1	31.3575561751
130	115	1	0	1	52.3602942481
130	116	1	0	1	37.7970781316
130	117	1	0	1	26.1123918509
130	120	7	2	5	38.3411513245
130	121	6	0	6	24.6170249149
130	124	19	1	18	17.1618193058
130	125	3	0	3	19.5325201742
130	126	2	1	1	14.5390828379
130	127	16	10	6	16.4930625964
130	128	89	42	47	5.33226605378
130	129	5	2	3	25.5018836399
130	131	14	1	13	24.3623154631
130	132	1	0	1	21.1856471298
130	133	12	4	8	20.127442225
130	134	27	4	23	16.1233556271
130	135	16	3	13	6.67506982874
130	136	5	0	5	10.8855030754
130	137	8	0	8	16.9960457957
130	138	2	0	2	23.0604617185
130	139	1	0	1	14.2019565302
130	140	29	7	22	20.1649707294
130	141	7	5	2	17.80631562
130	142	830	126	704	10.9369695213
130	143	72	30	42	5.29734340658
130	144	17	1	16	11.0850046682
130	145	11	1	10	15.8481840686
130	146	10	5	5	22.4204402793
130	147	259	13	246	7.42977330605
130	148	1	0	1	19.961101593
130	149	2	1	1	18.1498909611
130	150	1	0	1	14.0880376529
130	151	2	1	1	20.1412431824
130	152	16	4	12	10.501474329
130	153	7	4	3	8.28002305618
130	154	9	0	9	8.57549090701
130	155	1	0	1	38.7813108535
130	163	1	0	1	11.9581615274
130	164	2	0	2	28.7690122637
130	166	1	0	1	44.6749476208
130	168	1	0	1	25.6843684035
130	171	1	0	1	33.9059479129
130	172	5	0	5	22.016018505
130	175	1	0	1	31.7565720325
130	177	4	2	2	26.8522023008
130	183	1	0	1	122.325168936
130	208	1	0	1	110.976007262
130	214	0	0	0	103.469209011
130	242	0	0	0	154.361452448
130	245	0	0	0	55.6556599419
130	257	1	0	1	56.9055944239
130	275	1	0	1	86.515267528
130	277	1	0	1	82.6751043439
130	281	0	0	0	75.5467968495
130	282	0	0	0	78.8279311544
130	329	1	0	1	51.8719906158
130	357	1	0	1	66.7656611002
130	401	1	0	1	62.4519699144
130	455	1	0	1	24.8460171676
130	465	1	0	1	41.210443203
130	466	4	1	3	48.0410394427
130	468	1	0	1	21.7798663952
130	469	14	0	14	34.5053326143
130	470	0	0	0	26.1024283019
130	471	2	0	2	42.4186665089
130	472	1	0	1	29.7812311455
130	474	1	0	1	55.9215556289
130	475	8	0	8	25.4577270957
130	487	1	0	1	55.967925112
130	491	1	0	1	46.0309165619
130	494	2	0	2	31.8016529879
130	503	1	0	1	44.2569734932
130	573	0	0	0	41.7482628632
131	0	5	0	5	50.1363693794
131	1	117	14	103	55.938973043
131	2	2	0	2	42.691606973
131	4	1	0	1	45.7838929443
131	5	4	1	3	52.42037171
131	7	3	1	2	47.6750879638
131	9	1	0	1	53.3444816514
131	13	6	0	6	45.719109186
131	14	1	0	1	42.3153675018
131	15	9	1	8	46.6455884156
131	17	1	0	1	39.6168068152
131	18	1	0	1	46.4639576478
131	19	2	0	2	52.5208025174
131	21	4	0	4	48.852480639
131	22	2	0	2	60.4427241539
131	23	2	0	2	46.1547664577
131	24	2	0	2	44.6941712397
131	26	4	0	4	35.8587601462
131	28	4	0	4	57.6811710884
131	29	1	0	1	40.8529180379
131	30	5	1	4	31.1728467527
131	31	2	0	2	34.9412124191
131	33	2	0	2	40.1933878821
131	34	24	7	17	24.5669270914
131	35	16	0	16	36.9782619717
131	36	36	1	35	43.408425553
131	37	1	0	1	32.8487122704
131	39	1	0	1	53.8829567997
131	41	1	0	1	37.8791344645
131	42	1	0	1	49.3584954698
131	43	3	0	3	37.0809878271
131	45	8	3	5	19.2048687046
131	46	7	2	5	38.7967947172
131	47	5	0	5	26.9525058244
131	48	102	16	86	19.2808861809
131	49	6	0	6	30.4095988575
131	50	31	2	29	24.7146584401
131	51	2	1	1	26.4829036971
131	52	12	0	12	13.9857585054
131	54	7	1	6	19.2079859646
131	55	5	0	5	28.3197178186
131	57	8	0	8	13.6870340714
131	58	1	0	1	43.3178502366
131	59	40	0	40	26.479061397
131	60	19	3	16	22.1127929798
131	61	1	0	1	35.7985026574
131	62	1	0	1	46.0848450851
131	64	3	0	3	44.6048935336
131	65	17	0	17	37.5155233114
131	68	64	0	64	17.5366291166
131	69	48	31	17	9.88769220446
131	70	18	1	17	57.7093336421
131	71	15	2	13	49.1025552377
131	72	1	0	1	56.4314879991
131	73	241	1	240	50.6785710519
131	74	30	3	27	50.8792838752
131	75	32	1	31	48.5489258245
131	76	10	0	10	56.2463415564
131	78	25	0	25	52.4638969355
131	79	2	0	2	54.0685497568
131	80	0	0	0	54.4482484231
131	81	7	0	7	55.0875871636
131	82	16	0	16	54.2826933171
131	83	8	0	8	51.7282111208
131	84	38	0	38	50.3348814664
131	85	4	1	3	54.9485791927
131	86	5	0	5	50.8882899343
131	87	18	2	16	47.8482680979
131	88	5	0	5	47.8177151567
131	89	5	0	5	60.7279736554
131	90	3	0	3	60.6560404696
131	92	4	1	3	60.8349961976
131	95	3	1	2	48.918468985
131	96	2	0	2	65.9428449379
131	98	2	2	0	50.969817088
131	99	9	2	7	36.2373675019
131	100	0	0	0	50.0084352036
131	102	4	0	4	55.4881743809
131	103	38	1	37	45.154468093
131	107	2	0	2	45.5137983694
131	108	1	0	1	70.7218924351
131	109	1	1	0	62.5357135206
131	110	13	0	13	40.9191847929
131	111	2	0	2	65.4215226278
131	112	20	1	19	45.1995158946
131	113	113	0	113	43.3258469352
131	115	1	0	1	70.534133384
131	117	2	0	2	45.3595596799
131	120	2	0	2	54.2022618641
131	122	1	0	1	66.864678251
131	124	159	26	133	14.3878143576
131	125	5	0	5	19.9225740738
131	126	60	0	60	9.82328457148
131	127	5	2	3	36.1510166427
131	128	16	2	14	28.4809185882
131	129	2	0	2	35.6641188295
131	130	4	2	2	24.3623154631
131	132	12	1	11	12.9823210448
131	133	3	0	3	30.2557478693
131	134	15	0	15	31.2814247443
131	135	6	1	5	28.1903457398
131	136	7	3	4	20.3539954763
131	137	4	0	4	39.7893182917
131	138	3	0	3	29.0365613651
131	139	9	1	8	12.4702706229
131	140	16	4	12	37.191520852
131	141	2	0	2	27.447946364
131	142	496	15	481	28.7091413715
131	143	21	0	21	21.4588619467
131	144	5	1	4	33.557045409
131	145	14	4	10	24.0486703981
131	146	2	0	2	43.1231610443
131	147	109	1	108	22.8988528311
131	148	4	2	2	23.9672414778
131	149	6	0	6	18.638366611
131	150	4	0	4	20.1836065667
131	151	142	106	36	7.04770050054
131	152	36	3	33	14.8830299508
131	153	3	1	2	17.145844957
131	154	16	0	16	32.9373252327
131	163	0	0	0	33.7299060029
131	164	4	0	4	51.6662467083
131	165	1	0	1	51.1977258082
131	166	2	0	2	68.6171170815
131	171	1	0	1	56.893900457
131	172	1	0	1	46.1073751415
131	177	3	0	3	51.1338526503
131	183	1	0	1	132.035808892
131	188	2	0	2	135.954091045
131	193	1	0	1	147.540325937
131	208	0	0	0	128.551919841
131	220	0	0	0	151.422340798
131	229	1	0	1	135.759887119
131	242	0	0	0	167.30074614
131	245	1	0	1	70.3474261452
131	246	1	0	1	71.9989578256
131	253	2	0	2	89.812212079
131	255	1	0	1	76.352792275
131	256	1	0	1	60.9045104791
131	258	1	0	1	65.5376210644
131	260	1	0	1	66.5209703007
131	276	1	0	1	97.2516648486
131	277	8	0	8	94.320135077
131	282	0	0	0	93.0534277344
131	290	1	0	1	106.654767434
131	303	1	0	1	64.5442397922
131	307	2	0	2	69.5320132708
131	338	0	0	0	98.4706220157
131	348	1	0	1	81.3858739962
131	349	1	0	1	87.0358018488
131	357	1	0	1	91.0753078435
131	391	1	0	1	47.010923103
131	408	1	0	1	55.0673142157
131	411	1	0	1	55.5820478852
131	424	1	0	1	100.044170648
131	460	0	0	0	36.9265131135
131	464	154	6	148	13.6746838662
131	465	19	11	8	26.3743962509
131	466	135	0	135	30.0578735055
131	467	3	0	3	30.2019940868
131	468	119	6	113	5.98236458065
131	469	314	47	267	18.2875939188
131	470	42	34	8	10.4287377553
131	471	53	1	52	18.078460985
131	472	151	48	103	8.01893711537
131	473	1	1	0	16.5627183678
131	474	1	0	1	35.3984382577
131	475	59	14	45	23.2322491789
131	476	361	115	246	5.93575081724
131	477	14	4	10	21.5517376961
131	478	3	0	3	36.2725447674
131	479	38	1	37	12.7287110528
131	480	40	9	31	15.5589216846
131	481	1	0	1	40.252788061
131	482	1	0	1	42.3561169224
131	484	10	1	9	29.7676422859
131	485	6	1	5	46.173352017
131	486	2	0	2	37.1799844026
131	487	14	0	14	31.6543715272
131	488	13	0	13	30.8536799784
131	489	2	0	2	41.9893802947
131	490	1	0	1	24.6537901799
131	491	43	4	39	24.2456108966
131	493	2	1	1	45.1606739903
131	494	9	1	8	20.6952585686
131	495	5	0	5	35.5942720551
131	496	4	0	4	29.0174289986
131	499	2	0	2	33.1986800307
131	500	3	0	3	28.8103601902
131	501	6	0	6	41.8765484987
131	503	7	0	7	37.7062928708
131	504	1	0	1	25.0987810394
131	505	3	0	3	42.772735827
131	506	3	1	2	60.0784498968
131	507	1	0	1	156.232349409
131	513	0	0	0	112.053474608
131	555	1	0	1	84.1226694188
131	568	1	0	1	47.756370943
131	573	2	0	2	61.7489821583
132	0	2	0	2	58.8177349237
132	1	11	0	11	66.4270438758
132	5	1	0	1	64.0511573107
132	13	4	0	4	54.5455309177
132	21	1	0	1	60.1113933291
132	24	1	0	1	55.3329130817
132	26	1	1	0	47.5756020962
132	32	2	0	2	66.1893349659
132	34	1	0	1	34.1577851459
132	36	4	0	4	50.0785320631
132	43	1	0	1	49.4001799666
132	45	1	0	1	29.9320894906
132	48	6	0	6	32.2593385964
132	49	1	0	1	42.1888814976
132	50	2	0	2	36.9919732704
132	52	1	0	1	24.548845774
132	54	1	0	1	29.3493777074
132	60	1	0	1	34.7858514609
132	61	1	0	1	48.5598220898
132	68	7	0	7	29.5946410991
132	69	2	0	2	22.8291050371
132	70	4	0	4	59.2535248152
132	71	2	0	2	49.4907877987
132	72	1	0	1	58.8328970734
132	73	57	0	57	53.0711330162
132	74	3	1	2	52.1180351577
132	75	5	1	4	50.7297596996
132	76	1	0	1	57.3087273467
132	78	8	1	7	53.4976952431
132	79	1	0	1	56.8252113971
132	81	2	0	2	57.186753067
132	82	9	1	8	55.6416905945
132	83	1	0	1	53.6255849231
132	84	6	0	6	52.3915344092
132	87	3	0	3	49.3388584575
132	88	3	1	2	48.7713199165
132	92	1	0	1	63.1239177974
132	96	2	1	1	65.4688498022
132	99	2	0	2	40.3841839452
132	100	0	0	0	55.8241851727
132	102	0	0	0	61.3371869851
132	103	4	0	4	48.2146441966
132	107	1	0	1	44.1059539896
132	110	1	0	1	44.4501992943
132	112	2	0	2	49.0904703208
132	113	32	2	30	45.291702466
132	124	17	0	17	21.6022980782
132	126	13	1	12	11.7550575178
132	127	1	0	1	36.832851175
132	128	3	0	3	26.4381882897
132	129	2	0	2	41.1698385176
132	130	3	0	3	21.1856471298
132	131	100	60	40	12.9823210448
132	133	1	0	1	35.285621699
132	134	1	0	1	34.0574944766
132	135	6	1	5	21.8336868198
132	136	1	0	1	23.4813653389
132	137	2	0	2	38.1816918739
132	139	26	1	25	7.58086576712
132	140	3	0	3	39.4502476231
132	141	9	0	9	15.9735970527
132	142	141	2	139	29.8581628049
132	143	8	2	6	21.252422729
132	145	3	0	3	28.9739920001
132	146	1	0	1	43.3040326686
132	147	210	0	210	15.9713758452
132	149	33	6	27	6.61258339637
132	150	4	1	3	10.0475825149
132	151	4	4	0	16.4423277032
132	152	3	2	1	16.8285069465
132	153	5	1	4	13.0374427637
132	154	4	0	4	28.7670849117
132	163	1	0	1	26.2969876439
132	173	0	0	0	49.0552055441
132	175	1	0	1	52.5088327159
132	177	0	0	0	46.8492571043
132	179	1	1	0	74.5149885644
132	183	0	0	0	139.329432355
132	190	0	0	0	136.184206151
132	220	0	0	0	158.161227199
132	225	1	0	1	135.092271571
132	245	2	0	2	74.7294092963
132	277	1	0	1	100.504443515
132	307	0	0	0	77.7243950776
132	324	1	0	1	78.4712254345
132	348	0	0	0	80.9991150053
132	367	1	0	1	79.7130973251
132	392	1	0	1	38.2439725435
132	406	1	0	1	40.7872105466
132	408	1	0	1	43.3401207238
132	411	1	0	1	43.1727664552
132	415	2	0	2	35.5856076409
132	426	1	0	1	76.6564027895
132	452	1	0	1	30.2107825743
132	459	1	0	1	36.5564166928
132	464	9	2	7	20.69878817
132	465	9	2	7	20.2023184394
132	466	48	6	42	26.858789281
132	467	3	0	3	17.3462300921
132	468	47	1	46	7.00992942325
132	469	152	4	148	13.3449495268
132	470	63	0	63	6.05994813514
132	471	7	1	6	26.4709482314
132	472	18	1	17	12.114644039
132	473	17	0	17	5.33987512787
132	474	2	0	2	34.9948900713
132	475	196	0	196	10.332548696
132	476	5	0	5	18.6737104604
132	477	5	2	3	20.5122667055
132	478	1	0	1	31.4900687071
132	480	8	1	7	18.0818307627
132	482	1	0	1	44.7908276188
132	484	1	0	1	39.0380962148
132	487	1	0	1	38.936502943
132	488	5	2	3	35.0626718167
132	490	2	1	1	31.330370559
132	491	8	1	7	25.9029117913
132	493	1	0	1	43.7668301492
132	494	13	1	12	11.2808212336
132	495	3	0	3	28.3269528749
132	496	4	0	4	17.6057670975
132	497	2	1	1	19.9017340212
132	499	2	0	2	24.5076552123
132	500	2	0	2	19.7546724037
132	501	0	0	0	36.0177333858
132	502	1	0	1	33.7674737364
132	503	9	0	9	26.929559872
132	504	4	0	4	14.5481067753
132	506	1	0	1	51.2450753529
132	555	1	0	1	72.6426027845
132	566	1	0	1	45.310899901
132	573	0	0	0	51.2917643891
132	578	1	0	1	38.883708425
133	0	5	0	5	25.9937254251
133	1	133	3	130	37.2580131914
133	2	2	0	2	24.0503893998
133	3	7	0	7	23.6593039639
133	4	1	0	1	27.476273891
133	5	3	0	3	39.6685705621
133	6	4	0	4	41.3760812194
133	7	13	1	12	25.8651478877
133	10	1	0	1	23.20107332
133	12	1	0	1	43.3816119195
133	13	6	0	6	22.4547424908
133	14	1	0	1	20.7740426546
133	15	12	4	8	26.590172458
133	16	1	0	1	26.6533287968
133	18	3	0	3	21.1036617453
133	19	1	0	1	27.3126701827
133	21	1	0	1	34.6564488014
133	23	1	0	1	30.7834138886
133	24	1	1	0	28.313361295
133	26	1	0	1	27.6315607158
133	28	3	0	3	36.5025310209
133	29	2	0	2	36.962521877
133	30	4	0	4	15.9559904937
133	31	63	17	46	8.00693906546
133	33	26	8	18	17.130730285
133	34	28	11	17	13.6845946863
133	35	24	1	23	17.7969532109
133	36	278	0	278	15.1710000868
133	37	1	0	1	20.8375539387
133	38	9	6	3	9.64721122295
133	39	3	0	3	26.0679485412
133	41	25	18	7	13.1680290808
133	42	6	0	6	21.5435399027
133	46	3	0	3	40.9873030726
133	48	5	0	5	32.9247217039
133	49	1	0	1	24.953963742
133	50	4	0	4	25.7677838156
133	52	1	0	1	19.2977291012
133	53	1	0	1	53.6747449147
133	54	5	0	5	16.2634707233
133	59	1	0	1	46.6518166283
133	60	4	0	4	28.005995413
133	65	2	0	2	45.6340129509
133	68	2	1	1	23.1226666991
133	70	22	3	19	28.6753796394
133	71	10	3	7	22.2677326943
133	73	291	57	234	21.2062358546
133	74	20	4	16	22.6231082193
133	75	77	17	60	19.397112614
133	76	17	4	13	27.7948774793
133	77	4	0	4	25.3041824938
133	78	32	1	31	24.3270992106
133	79	12	0	12	24.2149489298
133	80	1	0	1	24.911845776
133	81	24	3	21	25.6707764381
133	82	17	2	15	25.6237372503
133	83	16	9	7	22.6596117976
133	84	61	17	44	21.1917779021
133	85	9	0	9	27.5863228406
133	86	12	2	10	24.407329183
133	87	31	1	30	19.56732405
133	88	9	0	9	20.293882676
133	89	11	1	10	30.5040223478
133	90	2	0	2	33.6441579419
133	92	8	0	8	31.1108009729
133	95	26	22	4	18.6669576608
133	96	4	0	4	38.7863942435
133	98	2	0	2	26.2424169021
133	99	198	9	189	6.18345655132
133	100	1	0	1	20.5391226323
133	102	6	0	6	26.0562094877
133	103	119	1	118	15.4090132402
133	104	1	0	1	22.8070334169
133	107	6	2	4	22.7463062223
133	109	3	1	2	34.0498475266
133	110	39	22	17	11.0389068711
133	111	2	0	2	35.3823488441
133	112	95	2	93	15.0054357257
133	113	220	2	218	14.9628095812
133	114	14	0	14	12.9314627401
133	116	2	0	2	30.0425261827
133	117	3	1	2	17.7679498856
133	120	4	0	4	24.0296536058
133	121	1	0	1	17.024685176
133	124	43	3	40	15.8896451664
133	125	6	0	6	11.1253574208
133	127	6	0	6	12.45976318
133	128	18	1	17	17.3274313323
133	129	188	106	82	5.90052743957
133	131	9	2	7	30.2557478693
133	134	108	3	105	5.94855923813
133	136	12	1	11	11.8911353941
133	137	5	2	3	19.4912708445
133	138	80	5	75	4.67020888794
133	140	46	1	45	9.68443372523
133	142	713	1	712	10.1722963134
133	143	14	3	11	15.9960719819
133	144	5	1	4	16.3392028675
133	145	50	17	33	6.39918112631
133	146	11	0	11	17.8342706656
133	147	11	1	10	27.0456012889
133	148	44	1	43	7.15435436545
133	151	2	0	2	23.239172427
133	152	5	0	5	18.4635295211
133	154	1	0	1	22.63143241
133	156	1	0	1	40.3718041396
133	164	2	0	2	28.1992678142
133	169	1	0	1	43.937615164
133	171	4	0	4	32.8419174643
133	172	3	2	1	27.8121052466
133	177	1	0	1	33.1134538207
133	179	1	0	1	48.450081325
133	182	0	0	0	111.234459706
133	183	1	0	1	104.130786015
133	186	0	0	0	100.164003641
133	220	0	0	0	122.87650591
133	236	1	0	1	89.5648293823
133	247	2	0	2	55.6538711049
133	277	12	0	12	65.2304806235
133	282	0	0	0	63.0766068347
133	291	1	0	1	81.931272916
133	294	0	0	0	76.38557529
133	297	1	0	1	80.6452721905
133	303	1	0	1	42.7576826245
133	304	4	0	4	32.576511038
133	305	1	0	1	50.3571948186
133	307	3	0	3	43.4100882925
133	309	1	0	1	35.7820280924
133	319	3	0	3	62.1247449588
133	421	1	0	1	89.9199053745
133	464	1	0	1	43.1298925793
133	465	1	0	1	54.7203472134
133	466	2	0	2	59.8071642411
133	467	1	0	1	44.8513282176
133	468	1	0	1	31.7860890774
133	469	8	1	7	46.850925592
133	474	3	1	2	65.6534677887
133	475	2	0	2	42.9640899859
133	476	2	0	2	31.6372801493
133	477	0	0	0	51.5980458639
133	480	2	0	2	45.8146480069
133	485	1	0	1	76.3723708542
133	488	3	1	2	60.2133809934
133	495	0	0	0	63.4096533519
133	503	2	0	2	61.6133836699
134	0	6	0	6	30.7702601236
134	1	128	7	121	42.6882373283
134	2	1	0	1	29.778062631
134	3	2	0	2	27.9434852051
134	7	5	0	5	31.1366128275
134	13	8	3	5	27.5879515779
134	15	7	2	5	32.0968346528
134	17	1	0	1	31.620261533
134	18	4	1	3	25.7696043657
134	19	1	0	1	31.7342302454
134	20	1	0	1	38.6985919284
134	24	1	0	1	34.1188602448
134	28	3	0	3	41.5842328959
134	31	17	3	14	13.3488803608
134	32	4	0	4	34.9354248907
134	33	6	1	5	22.5743459824
134	34	7	0	7	18.9666479639
134	35	5	1	4	23.6537481585
134	36	154	44	110	19.0050731963
134	38	5	0	5	15.5942030505
134	39	8	0	8	29.4586333031
134	41	7	2	5	18.5537241538
134	42	6	0	6	25.1624402821
134	46	3	0	3	46.5677464544
134	48	7	0	7	37.0039309832
134	50	10	1	9	30.8798413374
134	52	1	0	1	22.4792390877
134	54	2	0	2	20.5294983851
134	57	2	0	2	38.1889183678
134	59	8	0	8	50.4210557017
134	60	1	0	1	32.7184515747
134	65	4	0	4	50.8373834647
134	66	2	0	2	35.2721325491
134	68	4	0	4	27.3070353196
134	70	35	4	31	26.4299637858
134	71	18	10	8	18.4123572186
134	72	3	1	2	25.2683674898
134	73	562	18	544	19.4789099949
134	74	42	16	26	19.68664889
134	75	100	5	95	17.2892552536
134	76	21	13	8	25.0480602949
134	77	1	0	1	23.99140964
134	78	53	25	28	21.3174804061
134	79	17	4	13	23.0354149853
134	80	0	0	0	23.2384828012
134	81	41	1	40	23.8412401646
134	82	46	1	45	23.0331577071
134	83	32	9	23	20.4490316736
134	84	116	17	99	19.0652372603
134	85	15	7	8	24.1182740723
134	86	25	0	25	20.4198426284
134	87	82	0	82	16.6216780792
134	88	23	0	23	16.8050215381
134	89	3	0	3	30.2420692196
134	90	6	2	4	30.066097516
134	92	17	2	15	29.6586116541
134	95	32	11	21	19.3063431473
134	96	6	1	5	35.3324628332
134	98	6	0	6	21.5920603483
134	99	87	1	86	6.91659372802
134	100	2	0	2	22.9179786262
134	101	1	1	0	39.1473411479
134	102	2	0	2	28.2118578847
134	103	132	35	97	14.2300456285
134	104	1	0	1	23.866727705
134	105	3	1	2	28.3661136341
134	106	0	0	0	33.1534947666
134	107	25	8	17	17.4385157499
134	109	5	2	3	31.3629630899
134	110	38	14	24	10.4041839536
134	111	1	0	1	34.455498774
134	112	80	0	80	15.0724699554
134	113	438	5	433	12.0509529418
134	114	9	0	9	15.2362425247
134	115	1	0	1	39.3941317369
134	116	3	1	2	27.0418505525
134	117	4	1	3	14.2737853138
134	119	2	0	2	26.617620429
134	120	2	0	2	23.6478815972
134	121	4	1	3	13.1707497485
134	124	29	6	23	17.5844211865
134	125	2	0	2	14.4372088162
134	126	2	0	2	23.3828353416
134	127	48	13	35	6.83377163495
134	128	31	18	13	12.3340124571
134	129	30	2	28	9.78219973965
134	130	2	1	1	16.1233556271
134	131	12	4	8	31.2814247443
134	132	0	0	0	34.0574944766
134	133	52	18	34	5.94855923813
134	135	5	1	4	21.7776325377
134	136	28	1	27	11.0915823663
134	137	21	5	16	13.664774667
134	138	12	4	8	10.5288777921
134	140	188	11	177	5.92216713075
134	141	3	0	3	33.9275595646
134	142	2412	1286	1126	5.2289199389
134	143	27	1	26	13.161807211
134	144	15	10	5	10.4742819644
134	145	48	42	6	8.10004343179
134	146	44	10	34	13.1020355438
134	147	30	0	30	23.4606146929
134	148	5	0	5	11.3338527938
134	149	1	0	1	32.9955050475
134	151	6	0	6	24.5686004974
134	152	4	1	3	17.5894950765
134	154	4	0	4	17.1129252272
134	155	4	0	4	33.4375749571
134	156	2	0	2	36.1873748604
134	160	2	1	1	18.2810941158
134	164	6	2	4	23.2242118991
134	166	0	0	0	41.3150378282
134	168	5	1	4	22.7624297598
134	169	1	0	1	40.3660478141
134	171	7	2	5	28.1279323826
134	172	6	0	6	21.9930315541
134	175	1	0	1	28.5292434901
134	177	16	13	3	27.3526138078
134	178	1	0	1	32.8855894436
134	183	1	0	1	106.440062203
134	188	2	0	2	108.500462663
134	196	2	0	2	125.071141929
134	198	1	0	1	137.28992026
134	208	2	0	2	97.8168219397
134	211	0	0	0	105.597812904
134	212	1	0	1	87.3642907557
134	220	0	0	0	124.760324963
134	229	1	0	1	106.117470538
134	242	0	0	0	139.232508174
134	244	1	0	1	139.601872507
134	245	7	0	7	40.6851212255
134	246	1	0	1	41.367588846
134	251	0	0	0	46.0187378042
134	256	1	0	1	33.3107120264
134	262	0	0	0	55.1893245922
134	272	1	0	1	79.6808262922
134	277	14	2	12	67.0031152143
134	279	1	0	1	59.25357512
134	285	0	0	0	78.2499830256
134	286	1	0	1	59.633601558
134	294	1	0	1	75.1555310744
134	296	0	0	0	63.6399201293
134	303	3	0	3	47.5996764985
134	307	2	0	2	47.0598301956
134	308	1	0	1	54.690006969
134	309	1	0	1	39.5362954267
134	319	2	0	2	56.4725170474
134	329	2	0	2	48.5514462415
134	338	1	0	1	69.699271788
134	361	0	0	0	67.9997839493
134	379	0	0	0	61.4389041646
134	406	2	1	1	72.1473464658
134	408	1	0	1	73.2810819085
134	464	2	0	2	44.7206949375
134	465	4	0	4	54.0588263786
134	466	2	0	2	59.79298185
134	467	0	0	0	41.4863642257
134	468	1	0	1	31.6916554475
134	469	23	1	22	46.4717234949
134	470	3	1	2	37.3612050149
134	471	4	0	4	48.1090822658
134	472	3	1	2	38.7667272551
134	474	1	0	1	66.3475556419
134	475	4	0	4	40.6230545229
134	476	5	0	5	33.6825156651
134	477	0	0	0	51.9471389678
134	480	5	0	5	46.6474229371
134	484	2	0	2	57.6738400281
134	488	1	0	1	61.9553298528
134	491	3	0	3	55.4282205581
134	492	1	1	0	66.2752002244
134	494	2	1	1	45.3217342672
134	495	2	0	2	62.3840307508
134	500	1	0	1	53.6708801964
134	503	3	0	3	59.4773686804
134	505	1	0	1	72.5656610243
134	507	1	0	1	159.779015927
134	573	3	1	2	52.5505022125
134	577	0	0	0	51.6672380731
134	581	2	1	1	39.8804697489
135	0	1	0	1	52.3093228865
135	1	7	1	6	63.4242892386
135	3	0	0	0	49.6797131366
135	7	1	0	1	52.1904970406
135	13	2	0	2	48.8206936258
135	19	1	0	1	53.4416936569
135	21	1	0	1	59.7851145171
135	29	1	0	1	58.3050768082
135	31	1	0	1	34.3747570472
135	34	2	2	0	33.984335597
135	35	0	0	0	43.2719883368
135	36	12	2	10	40.7786288103
135	41	0	0	0	39.5028682176
135	48	1	0	1	43.7527307713
135	50	1	0	1	42.9268780727
135	65	2	0	2	61.3146471063
135	68	1	0	1	36.4089502608
135	70	14	2	12	41.3725106953
135	71	7	2	5	30.9875310766
135	72	2	0	2	42.010721978
135	73	191	136	55	36.7045101905
135	74	15	0	15	34.3822416444
135	75	32	3	29	34.3131597258
135	76	8	0	8	39.0029143604
135	78	17	2	15	35.4139431223
135	79	6	0	6	40.6133041228
135	80	1	0	1	39.9034282355
135	81	22	5	17	40.1043417995
135	82	17	2	15	37.7800303264
135	83	5	1	4	36.5706664322
135	84	26	0	26	35.6490945879
135	85	4	0	4	36.2256556277
135	86	2	0	2	31.874883959
135	87	14	0	14	32.1689767864
135	88	3	2	1	30.9921468157
135	89	2	0	2	48.5529404044
135	90	1	0	1	40.5320226191
135	92	3	0	3	45.8926184547
135	95	3	0	3	39.622481771
135	96	1	0	1	45.3612968548
135	98	5	0	5	29.989547422
135	99	4	0	4	28.5669951541
135	100	2	0	2	44.3044169817
135	103	35	6	29	33.3204188162
135	107	7	2	5	24.1709763688
135	109	1	0	1	44.4131758291
135	110	4	1	3	30.835062507
135	111	1	0	1	51.2698703163
135	112	17	0	17	35.3187561119
135	113	84	2	82	29.2407593719
135	116	2	0	2	39.9209229707
135	117	1	0	1	29.3973649972
135	119	1	0	1	35.5548338583
135	124	13	1	12	23.3549231292
135	126	4	0	4	18.6847318814
135	127	3	0	3	20.484447427
135	128	30	4	26	9.5279834612
135	129	3	0	3	31.4564022331
135	130	17	2	15	6.67506982874
135	131	6	1	5	28.1903457398
135	132	1	0	1	21.8336868198
135	133	3	1	2	26.3685411989
135	134	4	0	4	21.7776325377
135	136	2	1	1	17.5424541716
135	137	8	3	5	18.6254914234
135	139	3	0	3	16.3492074218
135	140	10	1	9	24.8577839881
135	141	12	2	10	13.3217587384
135	142	356	8	348	16.5733111383
135	143	15	3	12	11.9289375054
135	144	5	0	5	14.0677974684
135	145	6	1	5	22.4702705395
135	146	7	1	6	25.182371386
135	147	451	6	445	5.87592348108
135	148	1	0	1	26.6275562502
135	149	3	1	2	16.9906325385
135	150	2	0	2	12.5397299388
135	152	5	2	3	16.1092670511
135	153	12	0	12	11.0467239278
135	154	22	0	22	7.8571695841
135	155	1	0	1	38.5590814308
135	163	15	0	15	5.75822121242
135	164	3	1	2	29.3376073219
135	166	2	0	2	43.3650649181
135	168	3	0	3	25.5131674642
135	171	1	0	1	34.1544322334
135	172	11	0	11	21.1279013129
135	174	1	0	1	8.23672312509
135	176	2	0	2	11.6626079442
135	177	6	0	6	25.0858963296
135	179	1	1	0	53.8691708585
135	183	0	0	0	126.960122453
135	220	0	0	0	144.648324939
135	245	1	0	1	59.6078111634
135	276	1	0	1	85.2492267959
135	277	2	0	2	87.1030336769
135	307	1	0	1	68.7806836504
135	309	1	0	1	61.2919215716
135	323	0	0	0	40.3208595479
135	324	1	1	0	56.9463507701
135	385	1	0	1	38.783572004
135	396	3	0	3	45.6163533078
135	408	5	0	5	52.9097963551
135	415	1	0	1	42.659336023
135	416	1	0	1	59.7681067915
135	426	0	0	0	90.0018703568
135	427	1	0	1	66.3922530665
135	442	1	0	1	73.0752148074
135	455	3	0	3	18.7222288902
135	456	1	0	1	12.4287186456
135	460	0	0	0	29.0847160869
135	464	2	0	2	40.6283043032
135	465	0	0	0	40.7544719844
135	466	1	0	1	48.2001360174
135	467	1	0	1	21.1453721571
135	469	15	8	7	34.9568399125
135	471	3	0	3	45.8550980927
135	472	1	0	1	32.2849396472
135	474	1	0	1	56.7443810519
135	475	16	1	15	23.2306476105
135	476	1	0	1	33.5283220159
135	477	2	0	2	42.3411256763
135	484	1	0	1	57.9177735147
135	487	1	0	1	59.2048748053
135	495	1	0	1	47.3308759392
135	497	1	0	1	30.7687028573
135	501	1	0	1	55.58683418
135	503	0	0	0	41.3692365066
135	504	1	0	1	32.208004276
135	573	4	0	4	35.4495555938
135	576	1	0	1	34.0747677771
135	586	1	0	1	70.8435241662
136	0	1	0	1	36.962598953
136	1	47	2	45	46.8024316574
136	2	1	0	1	32.9547012498
136	3	0	0	0	35.1192719888
136	5	1	0	1	47.2022666175
136	7	2	0	2	36.0652923196
136	10	1	0	1	32.933594925
136	13	2	0	2	33.0157451499
136	15	4	1	3	36.1930885872
136	17	1	0	1	32.7734937727
136	18	2	0	2	32.2990868329
136	19	1	0	1	38.6145288487
136	24	1	0	1	36.613033455
136	26	1	1	0	32.4727880918
136	28	1	0	1	46.8354703666
136	30	1	0	1	22.2169739538
136	31	10	1	9	19.093018336
136	33	3	0	3	27.3178598784
136	34	15	0	15	16.4435067704
136	35	11	1	10	26.3555690495
136	36	51	0	51	26.9673288874
136	38	5	1	4	17.7602248854
136	39	3	0	3	37.894610262
136	41	2	0	2	23.7322212258
136	45	1	0	1	36.8632590203
136	46	1	0	1	42.8123486298
136	48	3	1	2	29.2824402232
136	50	6	1	5	26.1082605843
136	51	1	0	1	23.482506705
136	52	5	0	5	14.2682306677
136	53	2	0	2	56.8733386777
136	54	2	0	2	14.8300758617
136	56	1	0	1	36.3346512027
136	59	1	0	1	41.7660290929
136	60	2	0	2	26.6570451621
136	65	6	0	6	45.4429872263
136	66	1	0	1	32.0959622446
136	68	6	0	6	20.4445389496
136	69	2	1	1	22.0778241339
136	70	12	7	5	37.4271012323
136	71	11	1	10	28.7803827045
136	72	1	0	1	36.3596726788
136	73	192	5	187	30.568801485
136	74	13	9	4	30.5391052501
136	75	19	1	18	28.3612759923
136	76	5	1	4	35.9037499968
136	78	17	2	15	32.1142784455
136	79	8	2	6	34.1156980794
136	80	2	0	2	34.325487255
136	81	16	4	12	34.9160378092
136	82	16	6	10	33.9630660557
136	83	10	0	10	31.4892417752
136	84	44	8	36	30.1258396644
136	85	5	0	5	34.6163277847
136	86	4	0	4	30.6119834464
136	87	24	1	23	27.5232917553
136	88	4	0	4	27.4637942592
136	89	3	0	3	41.1973167944
136	90	2	0	2	40.3812289261
136	92	2	0	2	40.7483929195
136	95	4	1	3	29.8586970777
136	96	3	0	3	45.67303777
136	98	2	0	2	30.9796348857
136	99	15	0	15	16.9542652315
136	100	2	0	2	32.3864793329
136	101	1	1	0	50.2174664413
136	103	35	1	34	25.2674523355
136	104	1	0	1	34.2532887998
136	107	10	0	10	25.8309304926
136	110	14	2	12	21.2447593535
136	111	1	0	1	45.5331572154
136	112	27	0	27	25.7970270979
136	113	94	19	75	23.0517542395
136	115	2	0	2	50.4851690155
136	116	1	0	1	37.7641938212
136	120	3	0	3	34.6027878341
136	121	4	0	4	23.7484758005
136	122	2	0	2	46.6262463647
136	124	146	75	71	7.92392899219
136	125	8	4	4	8.68666030826
136	126	4	0	4	12.354845864
136	127	8	3	5	15.9022205227
136	128	33	1	32	11.3376806652
136	129	10	2	8	17.7910086078
136	130	7	1	6	10.8855030754
136	131	33	12	21	20.3539954763
136	132	1	0	1	23.4813653389
136	133	21	0	21	11.8911353941
136	134	57	3	54	11.0915823663
136	135	5	0	5	17.5424541716
136	137	9	0	9	20.4934455521
136	138	4	0	4	13.3165473055
136	139	2	0	2	16.040689232
136	140	32	10	22	16.9301301676
136	141	1	0	1	26.676658665
136	142	1197	25	1172	8.55827516217
136	143	73	36	37	5.61948190304
136	144	10	2	8	14.6277652919
136	145	86	21	65	5.902179234
136	146	6	0	6	22.8844161125
136	147	43	5	38	16.3774223264
136	148	7	0	7	9.34857558345
136	149	1	0	1	23.4911199237
136	150	2	0	2	20.7542899342
136	151	6	2	4	13.9392236116
136	152	14	4	10	6.67931805276
136	153	1	0	1	12.4814496339
136	154	4	0	4	17.2837801867
136	155	1	0	1	42.4390630104
136	160	2	0	2	21.6897492714
136	166	1	1	0	49.6134763384
136	167	1	0	1	32.8816236232
136	172	3	1	2	27.9415753722
136	177	3	0	3	33.3370494431
136	183	1	0	1	116.02032273
136	196	1	0	1	136.040579594
136	208	1	0	1	108.879429661
136	220	0	0	0	134.723309262
136	226	1	0	1	116.103708036
136	245	3	1	2	51.4110666436
136	252	1	0	1	64.9137515057
136	258	1	0	1	49.1747684214
136	262	1	0	1	65.659733949
136	270	1	0	1	75.61850379
136	276	1	0	1	78.2543534759
136	277	5	0	5	77.0360861435
136	281	1	0	1	70.8300279303
136	282	0	0	0	74.5144724982
136	303	1	0	1	53.3962688449
136	338	1	0	1	78.9755598398
136	406	1	0	1	62.9440843673
136	464	2	1	1	33.94004889
136	465	4	1	3	43.2076778103
136	466	7	0	7	48.7470069057
136	468	2	0	2	20.6224475424
136	469	21	0	21	35.5014833662
136	470	1	0	1	26.3645871697
136	471	2	1	1	37.6946662318
136	472	7	1	6	27.6994785491
136	474	1	0	1	55.2629370883
136	475	3	0	3	31.1245132639
136	476	3	1	2	23.3467180766
136	480	1	0	1	35.5963507115
136	487	1	0	1	51.1433451332
136	488	2	0	2	51.171498386
136	491	2	0	2	44.3879590132
136	495	1	0	1	51.7293789371
136	499	0	0	0	47.9850853397
136	501	1	0	1	59.1793048699
136	503	2	0	2	49.7261226853
136	504	1	0	1	37.8547410428
136	573	0	0	0	52.4322551469
136	581	1	0	1	42.259933156
137	0	2	1	1	41.3085274454
137	1	23	1	22	54.3037735262
137	3	1	0	1	37.716174321
137	7	2	0	2	42.6469596196
137	13	3	1	2	38.9481460894
137	21	1	0	1	53.2704035956
137	23	1	1	0	49.3679285412
137	24	1	0	1	46.8332119734
137	28	1	0	1	52.408195424
137	32	2	0	2	42.7148596844
137	33	1	0	1	34.7149525235
137	35	2	1	1	36.6447222029
137	36	26	0	26	28.8861179136
137	37	1	0	1	40.324202417
137	41	2	0	2	30.7784109492
137	42	1	0	1	33.9823282217
137	46	1	0	1	60.1917239333
137	48	0	0	0	49.3724217118
137	59	0	0	0	62.2102542421
137	65	1	0	1	64.2082750942
137	70	22	13	9	22.8369794444
137	71	43	25	18	12.4179653802
137	72	4	1	3	23.8462362626
137	73	325	106	219	19.0201033784
137	74	41	1	40	16.0132870066
137	75	58	1	57	16.758622873
137	76	9	1	8	20.4034833808
137	77	3	0	3	23.2387030344
137	78	70	0	70	16.895271906
137	79	10	0	10	22.8248039319
137	80	1	0	1	21.8010276214
137	81	19	0	19	21.870536505
137	82	19	4	15	19.2926864005
137	83	11	0	11	18.4666622512
137	84	53	0	53	17.7765357606
137	85	20	3	17	17.6163513826
137	86	30	3	27	13.2539602816
137	87	69	2	67	14.2225459085
137	88	31	0	31	12.7258658139
137	89	5	1	4	30.760525907
137	90	7	0	7	22.2429690025
137	92	5	1	4	27.4903055984
137	95	12	1	11	23.8733203555
137	96	8	0	8	27.3036232421
137	98	42	27	15	11.7713947528
137	99	9	2	7	17.2281059925
137	103	69	9	60	17.223797465
137	105	2	0	2	31.2812380978
137	107	298	198	100	5.93040479349
137	109	1	0	1	25.8136245402
137	110	4	1	3	16.6191382053
137	112	34	0	34	20.0098664178
137	113	140	21	119	12.6465270931
137	114	3	0	3	23.6451506614
137	116	2	0	2	21.3032001558
137	117	11	0	11	11.6609082336
137	118	2	0	2	18.8935910616
137	119	3	0	3	17.4867756682
137	120	6	0	6	25.0817421622
137	121	10	4	6	10.2712069156
137	124	7	0	7	28.3746111305
137	126	1	0	1	30.3137842758
137	127	25	4	21	7.12076591753
137	128	21	0	21	11.8073836729
137	129	1	0	1	21.4687884384
137	130	1	0	1	16.9960457957
137	131	2	0	2	39.7893182917
137	133	1	0	1	19.4912708445
137	134	16	1	15	13.664774667
137	135	3	2	1	18.6254914234
137	136	2	0	2	20.4934455521
137	138	1	0	1	24.1452314372
137	140	28	1	27	11.5343844953
137	141	0	0	0	31.8728449998
137	142	445	198	247	12.2140573192
137	143	3	0	3	18.3597871854
137	144	14	1	13	6.24932146001
137	145	8	2	6	20.685041455
137	146	56	12	44	7.09930652113
137	147	9	3	6	23.3207446245
137	149	1	0	1	34.7510744379
137	151	0	0	0	34.1017562242
137	152	1	0	1	24.9071084918
137	154	4	0	4	10.8468901431
137	155	6	0	6	22.2635177818
137	156	2	0	2	26.1252808469
137	157	1	0	1	12.6872168992
137	158	4	1	3	18.4922502029
137	160	10	2	8	7.05966824706
137	163	1	0	1	18.7633999884
137	164	18	6	12	11.9379174369
137	165	1	0	1	16.9718723911
137	166	5	0	5	29.1287441248
137	167	2	1	1	21.3635769416
137	168	11	6	5	9.78277175291
137	171	14	1	13	17.1555811528
137	172	77	3	74	8.32926366258
137	173	1	0	1	22.3027083432
137	175	4	2	2	15.9583204858
137	177	35	10	25	13.704341755
137	183	0	0	0	109.734807055
137	196	1	0	1	122.852956878
137	220	0	0	0	126.882033008
137	237	1	0	1	88.4844754194
137	255	1	0	1	52.1551654172
137	256	0	0	0	38.0672314722
137	257	2	0	2	45.1309849092
137	262	0	0	0	56.8000317579
137	264	1	0	1	50.8340727234
137	277	6	1	5	69.7366914479
137	281	0	0	0	61.6816335607
137	303	2	0	2	57.7470469463
137	310	0	0	0	61.412960514
137	319	1	0	1	42.8807554752
137	320	1	0	1	44.1302571306
137	323	1	0	1	34.1363147811
137	329	2	0	2	36.452496591
137	367	1	0	1	46.1052002159
137	375	1	0	1	86.9814910523
137	392	1	0	1	49.1471904926
137	408	2	0	2	71.1241205485
137	411	1	0	1	67.486076381
137	455	1	0	1	35.2702038647
137	465	1	0	1	58.1577674082
137	466	2	0	2	65.0358790575
137	469	2	0	2	51.4959667577
137	471	0	0	0	57.7001084654
137	476	1	0	1	43.5750685129
137	482	1	0	1	81.5114624397
137	488	1	0	1	70.442112294
137	491	0	0	0	62.6830590586
137	495	0	0	0	65.3952639968
137	501	1	0	1	73.5284874496
137	503	3	0	3	59.9789894924
137	573	6	0	6	40.9897752163
137	576	1	0	1	29.27460144
137	577	1	0	1	38.1934537745
137	581	6	1	5	27.0710509673
138	0	14	6	8	23.6533431812
138	1	205	5	200	33.8681502559
138	2	2	0	2	20.2677582344
138	3	6	0	6	21.9965105089
138	4	1	0	1	23.7638003597
138	5	2	0	2	35.5158233496
138	7	9	2	7	22.8390884318
138	9	1	0	1	26.8178457996
138	10	1	0	1	19.8461567109
138	13	23	8	15	19.7101732548
138	15	19	1	18	23.1815596375
138	16	1	1	0	25.0038675406
138	17	3	0	3	21.3310447855
138	18	9	0	9	19.0552428291
138	19	3	1	2	25.3822823837
138	20	1	0	1	28.374183686
138	21	2	1	1	30.5625716967
138	23	2	1	1	26.7366268609
138	27	1	0	1	28.0882007206
138	28	5	0	5	33.6038152904
138	29	1	0	1	32.3025786125
138	30	9	0	9	11.3436397098
138	31	182	79	103	6.09758621822
138	32	3	0	3	30.4657402933
138	33	28	1	27	14.0495097581
138	34	95	30	65	9.34106438578
138	35	56	9	47	13.7836843084
138	36	513	119	394	14.5124295175
138	37	1	0	1	16.2128963038
138	38	73	2	71	5.21618297873
138	39	7	0	7	25.3053792295
138	40	1	0	1	30.0503461546
138	41	49	18	31	10.417399251
138	42	11	3	8	20.715575792
138	46	10	2	8	36.3522790272
138	48	2	0	2	29.2398246491
138	49	1	0	1	20.3015919106
138	50	13	0	13	21.4045777021
138	52	3	0	3	16.6716891885
138	53	2	0	2	49.0085326729
138	54	4	0	4	12.7859800607
138	55	4	0	4	33.2380980276
138	59	1	0	1	43.090776747
138	60	5	0	5	23.902543396
138	65	4	1	3	41.1578768049
138	66	0	0	0	25.0427544859
138	68	3	0	3	19.4984242738
138	70	16	2	14	32.0340709155
138	71	8	1	7	26.467545491
138	72	4	0	4	29.7077468379
138	73	289	0	289	24.4597317721
138	74	16	0	16	26.4343148101
138	75	54	3	51	22.9024847822
138	76	9	0	9	31.4271114365
138	77	0	0	0	28.2102615164
138	78	34	2	32	28.1405233714
138	79	12	0	12	27.0723006268
138	80	0	0	0	28.0333556345
138	81	29	1	28	28.8610708514
138	82	12	1	11	29.2137696096
138	83	11	2	9	26.1221080416
138	84	51	27	24	24.6511674776
138	85	5	0	5	31.5618494755
138	86	9	0	9	28.6325874384
138	87	41	17	24	23.4501883955
138	88	9	0	9	24.3833194484
138	89	10	0	10	32.624390007
138	90	2	0	2	37.613727153
138	92	8	0	8	33.9774719048
138	94	1	0	1	46.451087119
138	95	21	3	18	20.5875634592
138	96	6	0	6	42.6613115716
138	98	2	0	2	30.6890963017
138	99	71	2	69	9.67588322271
138	100	3	0	3	20.9737725848
138	102	4	0	4	26.4529232388
138	103	104	1	103	18.6291226387
138	104	2	1	1	24.2171692464
138	105	1	0	1	29.1425431948
138	107	7	0	7	27.3768883452
138	109	4	0	4	37.5724506335
138	110	27	0	27	14.3397373404
138	111	4	0	4	37.8534031717
138	112	73	0	73	17.5494462834
138	113	200	46	154	18.9736672352
138	114	12	5	7	14.0492185804
138	115	0	0	0	43.2738167171
138	116	1	0	1	33.7705054095
138	117	1	0	1	21.9110513992
138	118	2	0	2	34.1474474484
138	119	1	1	0	35.0430648147
138	120	4	0	4	26.4015685657
138	121	1	0	1	21.3079961177
138	123	0	0	0	39.3817519701
138	124	39	0	39	14.8277677759
138	125	5	0	5	9.12198928565
138	126	1	0	1	23.9972532139
138	128	3	1	2	21.0251807618
138	129	73	17	56	7.11457372151
138	131	4	0	4	29.0365613651
138	133	85	5	80	4.67020888794
138	134	14	0	14	10.5288777921
138	135	2	0	2	29.5760182004
138	136	1	0	1	13.3165473055
138	137	2	0	2	24.1452314372
138	140	27	1	26	14.1593287726
138	141	1	0	1	39.9155131602
138	142	246	0	246	14.151822558
138	143	5	1	4	18.3516092794
138	144	1	0	1	20.7258101496
138	145	27	8	19	7.45288372763
138	146	6	0	6	22.3603785215
138	147	3	0	3	29.4774631096
138	148	71	2	69	5.11365289239
138	151	1	0	1	22.0115668229
138	155	3	0	3	42.4929129336
138	163	2	0	2	34.0190015423
138	168	1	0	1	32.8960343624
138	171	4	1	3	37.2824842018
138	172	5	0	5	32.470524769
138	175	1	0	1	38.3749782048
138	177	1	0	1	37.781310508
138	183	2	0	2	103.721223258
138	208	3	0	3	100.119625514
138	220	1	0	1	122.792346277
138	229	1	0	1	106.783145752
138	232	0	0	0	95.3778317271
138	245	3	0	3	41.5579659463
138	257	5	1	4	39.5292856992
138	260	1	0	1	37.501326297
138	277	7	0	7	65.4113779158
138	282	1	0	1	64.0514964032
138	303	3	0	3	40.1068288901
138	305	1	0	1	49.9105597634
138	307	2	0	2	42.0600857872
138	309	1	0	1	34.4257197506
138	319	2	0	2	66.7915905492
138	321	1	0	1	63.2229188194
138	323	1	0	1	58.2759736048
138	329	2	0	2	57.8319480213
138	349	0	0	0	68.7406927018
138	408	2	0	2	77.794351949
138	414	1	0	1	78.3209894848
138	415	1	0	1	68.6463834384
138	464	2	0	2	41.2379867349
138	465	0	0	0	54.4681823117
138	466	2	1	1	59.0097222441
138	469	4	0	4	46.4533382125
138	471	2	0	2	43.5044112857
138	472	1	0	1	37.0412299
138	474	1	0	1	64.2722807224
138	475	2	0	2	44.1598663476
138	476	2	0	2	29.5682432392
138	479	1	0	1	36.9678186079
138	480	1	0	1	44.4812768079
138	488	1	0	1	58.0656303125
138	490	1	0	1	50.5914156393
138	494	1	0	1	46.7683624767
138	495	1	0	1	63.3825068775
138	496	3	0	3	53.0646350943
138	501	1	0	1	70.3631634124
138	503	1	1	0	62.4840332375
138	540	1	0	1	129.731617824
138	573	0	0	0	62.511479929
138	576	1	0	1	53.3528386765
139	0	1	0	1	52.1019410381
139	1	13	5	8	60.4878924396
139	7	1	0	1	50.6083546386
139	12	0	0	0	63.5563583324
139	13	1	0	1	47.9197572838
139	15	1	0	1	50.2559460617
139	18	1	0	1	47.6903755325
139	21	1	0	1	54.7517927357
139	24	2	0	2	49.5888545196
139	26	1	0	1	42.7781922302
139	34	4	0	4	28.2483758443
139	36	16	0	16	42.8658063984
139	37	1	0	1	38.1315957506
139	39	1	0	1	53.7912234423
139	41	1	0	1	38.9391488029
139	42	1	0	1	49.2115515842
139	46	1	0	1	48.8820822178
139	48	2	0	2	30.522023046
139	50	2	0	2	33.0662626899
139	54	1	0	1	23.9551693633
139	57	1	0	1	25.9710030085
139	59	2	0	2	38.94252961
139	60	1	0	1	31.5655074955
139	63	0	0	0	41.7615166931
139	65	1	0	1	48.8124707089
139	68	1	0	1	25.6974234619
139	69	2	0	2	20.9277016673
139	70	7	0	7	51.7545018352
139	71	2	0	2	42.0963593506
139	73	128	6	122	45.505684709
139	74	7	0	7	44.6310718398
139	75	14	0	14	43.1705042755
139	76	1	0	1	49.8547296597
139	78	7	0	7	46.03628964
139	79	1	0	1	49.2510292309
139	81	3	0	3	49.6417238583
139	82	7	1	6	48.1521368777
139	83	4	0	4	46.0875138645
139	84	20	3	17	44.8414307906
139	87	7	1	6	41.8214691294
139	88	2	0	2	41.3035366765
139	90	1	1	0	53.1048793601
139	92	2	0	2	55.5754396617
139	95	2	0	2	45.6995076054
139	96	1	0	1	58.2792154791
139	98	1	0	1	42.8078787168
139	99	1	0	1	32.8658801781
139	103	20	1	19	40.6338918928
139	107	2	0	2	37.0137333566
139	110	4	0	4	36.8822044324
139	111	2	0	2	60.6214531254
139	112	26	5	21	41.5298304596
139	113	51	2	49	37.7334924925
139	114	1	0	1	40.7395744448
139	120	1	0	1	50.0986413483
139	124	27	0	27	15.3964092627
139	126	34	9	25	5.57169561391
139	127	2	0	2	29.3400246329
139	128	22	4	18	19.2787571286
139	129	1	0	1	33.8124379468
139	130	14	1	13	14.2019565302
139	131	149	0	149	12.4702706229
139	132	26	1	25	7.58086576712
139	133	2	0	2	27.9133209961
139	134	12	3	9	26.4846332286
139	135	10	0	10	16.3492074218
139	136	8	0	8	16.040689232
139	137	1	0	1	31.0853511948
139	138	1	0	1	28.6905951926
139	140	14	1	13	31.8726172292
139	141	17	0	17	15.6331052688
139	142	295	1	294	22.2939191078
139	143	16	5	11	13.7026204725
139	144	2	0	2	24.9716889684
139	145	7	0	7	21.6893104585
139	146	3	0	3	35.9091265214
139	147	477	2	475	10.6914594351
139	148	2	1	1	23.8824286251
139	149	24	7	17	8.4679386642
139	150	18	0	18	8.1559852831
139	151	18	4	14	12.2793134307
139	152	21	4	17	9.48923795605
139	153	44	18	26	5.93115488344
139	154	8	1	7	22.343912924
139	157	1	1	0	32.7387854386
139	163	0	0	0	21.609693202
139	164	0	0	0	42.93960304
139	166	2	0	2	58.7388275087
139	177	3	1	2	40.6939202866
139	183	1	0	1	132.037243356
139	194	1	0	1	142.358489827
139	207	0	0	0	120.456437871
139	242	0	0	0	165.601624068
139	245	1	0	1	67.1642697924
139	251	1	0	1	71.8805532074
139	277	2	0	2	93.0678020695
139	304	2	1	1	59.0283685805
139	319	5	0	5	66.9303625749
139	406	1	0	1	47.3062682051
139	408	1	0	1	49.3774181363
139	432	0	0	0	73.5873149016
139	455	0	0	0	25.5094522336
139	464	14	1	13	24.2818965412
139	465	2	1	1	27.7310391172
139	466	18	3	15	34.0856535588
139	467	2	0	2	20.1460770657
139	468	49	16	33	8.06064387741
139	469	70	5	65	20.5377302337
139	470	15	0	15	11.9063609874
139	471	7	2	5	29.5780256866
139	472	7	0	7	15.9716814882
139	473	3	0	3	12.8416590153
139	474	1	0	1	41.7403353757
139	475	49	16	33	15.6274122111
139	476	13	1	12	18.2739117986
139	477	2	0	2	27.0997671183
139	479	2	0	2	24.9761025874
139	480	4	0	4	23.38573582
139	484	0	0	0	41.8041260758
139	487	0	0	0	42.8640617856
139	488	1	0	1	40.3272212291
139	491	5	0	5	31.8721941988
139	493	0	0	0	50.8208202366
139	494	2	1	1	18.8376022071
139	495	2	0	2	35.9009688415
139	499	1	0	1	31.9902225366
139	500	1	0	1	27.2358300801
139	501	2	0	2	43.5896497496
139	503	5	1	4	33.8083684978
139	551	0	0	0	65.6352276259
139	573	3	0	3	49.2880159531
140	0	5	0	5	29.9151384402
140	1	51	0	51	42.7814894866
140	3	0	0	0	26.4903433487
140	5	1	0	1	46.9312983663
140	7	2	0	2	31.1207431035
140	13	4	0	4	27.4264718525
140	15	3	0	3	32.5589291918
140	18	1	0	1	24.93501015
140	19	1	0	1	30.3358378517
140	21	1	0	1	41.8586252058
140	23	1	0	1	37.9615693975
140	24	2	0	2	35.4205576262
140	28	2	0	2	40.9955491075
140	30	1	0	1	24.9346190252
140	31	4	0	4	14.5641522952
140	32	7	0	7	32.3037795314
140	33	4	0	4	23.2194780654
140	34	5	2	3	23.3632323537
140	35	5	0	5	25.4197046868
140	36	80	26	54	17.5311234784
140	39	1	0	1	26.8912403868
140	41	1	0	1	19.3227333293
140	42	2	0	2	23.0250639322
140	46	3	0	3	50.4521169662
140	47	2	0	2	55.0003353338
140	48	1	0	1	42.3491536933
140	50	2	0	2	35.4505231984
140	51	1	0	1	30.7883589601
140	52	1	0	1	28.1268148527
140	57	1	0	1	43.9195167082
140	59	1	0	1	55.933067891
140	60	1	0	1	37.6517890004
140	68	0	0	0	32.5710942013
140	69	1	0	1	37.2682388051
140	70	57	0	57	20.5183904106
140	71	47	0	47	12.7590794595
140	72	11	1	10	19.4994228336
140	73	823	15	808	13.7033077154
140	74	108	33	75	13.7757571934
140	75	192	2	190	11.445356905
140	76	29	4	25	19.1320071922
140	77	3	0	3	18.2833179858
140	78	124	86	38	15.4191757087
140	79	27	9	18	17.3855852936
140	80	5	3	2	17.4349914069
140	81	25	0	25	17.9978185422
140	82	51	11	40	17.1109909254
140	83	46	33	13	14.5595967178
140	84	174	25	149	13.1989453416
140	85	28	0	28	18.3338106043
140	86	43	21	22	14.8505627176
140	87	166	21	145	10.7038998932
140	88	71	29	42	10.9881092225
140	89	22	0	22	24.8712879951
140	90	6	1	5	24.3390148189
140	92	20	1	19	23.8652698622
140	95	33	9	24	14.8024852592
140	96	12	3	9	29.5736647877
140	98	6	3	3	16.5599353519
140	99	45	0	45	5.74618937355
140	100	1	0	1	19.6359209984
140	101	1	0	1	33.4933744025
140	102	5	0	5	24.5004912326
140	103	262	7	255	8.86994497231
140	104	4	1	3	19.4451191066
140	105	3	0	3	23.5741511103
140	107	24	0	24	13.4260422995
140	109	9	1	8	25.4492680817
140	110	68	50	18	6.00272089422
140	111	3	0	3	28.7834872766
140	112	145	10	135	10.480210933
140	113	981	103	878	6.1343382737
140	114	7	0	7	12.5875903823
140	115	1	0	1	33.6065401973
140	116	4	0	4	21.1564991247
140	117	39	22	17	8.43696598801
140	118	1	0	1	20.7395177746
140	119	4	0	4	21.1891564484
140	120	12	0	12	18.3347004408
140	121	35	0	35	7.47188335693
140	122	2	0	2	29.6986612556
140	124	8	0	8	23.4755284578
140	125	2	0	2	19.9619920156
140	126	1	0	1	29.1124167023
140	127	30	12	18	4.93351214616
140	128	18	5	13	15.4365223428
140	129	12	0	12	10.0525355033
140	130	2	0	2	20.1649707294
140	131	6	0	6	37.191520852
140	133	13	13	0	9.68443372523
140	134	87	16	71	5.92216713075
140	135	2	0	2	24.8577839881
140	136	7	0	7	16.9301301676
140	137	19	4	15	11.5343844953
140	138	2	0	2	14.1593287726
140	141	3	0	3	37.7461866102
140	142	635	93	542	9.65074682007
140	143	7	1	6	18.2473545178
140	144	9	0	9	11.3586315451
140	145	10	1	9	13.8305110187
140	146	54	10	44	8.20641686745
140	147	16	0	16	27.5880096025
140	148	6	1	5	16.4400063293
140	150	1	0	1	34.0966415996
140	151	3	0	3	30.4906219337
140	152	3	0	3	23.2870743236
140	154	2	1	1	18.6885123179
140	155	7	0	7	28.4062385555
140	156	3	0	3	30.7814393243
140	157	1	0	1	24.116030696
140	160	1	0	1	17.8218887961
140	163	0	0	0	27.2437760601
140	164	5	0	5	18.5819512167
140	165	1	0	1	28.3441061966
140	166	5	0	5	36.589218307
140	168	8	1	7	19.0444346166
140	169	1	0	1	34.6569237723
140	171	15	0	15	23.1593553409
140	172	11	7	4	19.4305548557
140	173	1	0	1	33.6382754812
140	175	2	0	2	24.2796784583
140	177	15	1	14	24.4184919888
140	179	2	0	2	39.2563950601
140	183	2	0	2	102.237779459
140	188	1	0	1	103.791315735
140	208	1	0	1	92.1477605469
140	211	1	0	1	99.9312505797
140	213	1	0	1	98.154965984
140	220	0	0	0	120.222531829
140	239	0	0	0	96.2756075638
140	245	3	1	2	35.5961925419
140	254	2	0	2	43.4091986391
140	257	1	0	1	36.8475781919
140	274	2	0	2	55.9027853684
140	277	9	0	9	62.5202786093
140	282	0	0	0	58.8050922476
140	303	1	0	1	46.5191126102
140	307	2	0	2	44.4057528675
140	310	1	0	1	62.54493278
140	314	0	0	0	65.6536895215
140	319	2	0	2	52.9961170165
140	320	2	0	2	54.9031818394
140	326	1	0	1	49.8655739989
140	329	2	0	2	43.7079742355
140	336	1	0	1	62.0957657098
140	338	1	0	1	64.3221951111
140	353	0	0	0	51.8791591561
140	355	1	0	1	58.1564831547
140	399	1	0	1	74.4423877084
140	408	2	0	2	77.3937069576
140	415	2	1	1	67.3483345367
140	465	3	0	3	59.5697950537
140	466	1	0	1	65.4895533365
140	468	1	0	1	37.4464129937
140	469	4	0	4	52.0966884131
140	470	0	0	0	43.0261023664
140	471	3	0	3	54.0044243311
140	472	0	0	0	44.6294187688
140	475	1	0	1	45.3956909013
140	476	2	0	2	39.5806105498
140	491	2	0	2	61.3105008711
140	501	1	0	1	75.4610145394
140	503	5	0	5	64.2634798901
140	505	1	0	1	78.2347852131
140	551	0	0	0	65.761020627
140	563	1	0	1	68.0635639569
140	573	3	1	2	52.3408460512
140	581	0	0	0	38.6051365051
141	1	18	3	15	73.435894031
141	13	1	0	1	59.6172706778
141	18	1	0	1	58.6461928343
141	21	1	0	1	68.6388178494
141	25	1	0	1	78.0704443376
141	27	1	0	1	62.2832357536
141	30	1	0	1	48.4209959331
141	34	3	0	3	41.9946671872
141	36	38	12	26	52.611770027
141	41	0	0	0	50.2805956644
141	42	1	0	1	58.9185073374
141	43	2	1	1	64.5279031323
141	45	1	0	1	45.7183540027
141	46	1	0	1	64.4386104854
141	48	1	0	1	46.1163563576
141	50	4	0	4	48.3668771439
141	52	1	0	1	34.8762781326
141	53	1	0	1	79.0585155831
141	54	1	0	1	38.4698841816
141	59	1	0	1	53.6505263934
141	60	1	0	1	47.1046206428
141	65	4	1	3	64.4270047802
141	68	2	0	2	41.0971966519
141	69	1	0	1	36.4993926353
141	70	29	1	28	54.6726669491
141	71	17	13	4	44.272032359
141	72	1	0	1	55.328355852
141	73	661	0	661	49.9884148894
141	74	36	6	30	47.7008602037
141	75	60	11	49	47.5913928468
141	76	14	0	14	52.2748431663
141	77	3	2	1	54.5098876504
141	78	63	0	63	48.7155215179
141	79	11	0	11	53.8990985576
141	80	3	1	2	53.2187523733
141	81	23	2	21	53.425323965
141	82	61	2	59	51.0887079017
141	83	30	1	29	49.8884011138
141	84	81	4	77	48.9530898447
141	85	4	1	3	49.4108830338
141	86	6	1	5	45.0871450959
141	87	16	0	16	45.4835059705
141	88	9	0	9	44.3130679369
141	89	3	0	3	61.823954516
141	90	5	0	5	53.4651273627
141	92	6	0	6	59.2125510985
141	95	7	1	6	52.5465840386
141	96	2	0	2	58.1270744713
141	98	3	0	3	42.9796964807
141	101	1	0	1	69.1962148142
141	102	1	0	1	62.0166226418
141	103	42	19	23	46.4034286517
141	107	6	0	6	37.2507802005
141	109	2	1	1	57.5715500624
141	110	11	1	10	43.632047785
141	111	2	0	2	64.5914788639
141	112	29	3	26	48.220528505
141	113	111	0	111	42.4495542648
141	116	2	0	2	53.115668821
141	117	2	0	2	42.7063983777
141	119	1	0	1	48.415851903
141	120	2	0	2	55.5839860168
141	121	1	0	1	41.1973281316
141	122	1	0	1	63.4806128906
141	123	0	0	0	68.5037869708
141	124	3	1	2	29.4985781611
141	126	4	1	3	20.8272108015
141	127	9	0	9	33.6193158308
141	128	22	7	15	22.32798678
141	130	17	2	15	17.80631562
141	131	22	0	22	27.447946364
141	132	4	0	4	15.9735970527
141	133	3	0	3	37.5971085956
141	134	12	0	12	33.9275595646
141	135	37	1	36	13.3217587384
141	136	5	0	5	26.676658665
141	137	2	1	1	31.8728449998
141	139	1	0	1	15.6331052688
141	140	8	2	6	37.7461866102
141	142	509	0	509	28.7406696834
141	143	12	0	12	21.6505715551
141	144	4	1	3	27.3348567162
141	145	7	1	6	32.464590293
141	146	4	1	3	38.5034279096
141	147	606	217	389	10.5555540894
141	148	1	0	1	35.9390986889
141	149	24	9	15	9.36196092561
141	150	22	14	8	7.47814730825
141	151	1	0	1	27.8433918684
141	152	3	1	2	22.0525522061
141	153	8	3	5	14.7711068491
141	154	21	3	18	21.0293370014
141	155	2	0	2	50.602269008
141	157	1	0	1	27.1905250807
141	160	1	0	1	26.3004960012
141	163	20	7	13	14.4730840082
141	164	3	0	3	42.0536790557
141	165	1	0	1	33.5248607272
141	166	2	0	2	54.3303844305
141	168	6	1	5	37.9202104231
141	169	0	0	0	61.7592851484
141	171	3	1	2	46.6014248843
141	172	5	0	5	33.2595782096
141	174	3	1	2	5.59749112989
141	175	3	1	2	43.0118940052
141	176	7	1	6	10.0005880383
141	177	11	0	11	36.2733445964
141	178	5	2	3	16.4929718856
141	195	1	0	1	162.143565657
141	208	0	0	0	126.495736378
141	229	1	0	1	136.911537182
141	245	1	0	1	72.8566560522
141	247	0	0	0	81.4812548413
141	254	2	0	2	80.1198110266
141	277	3	0	3	100.215416456
141	282	1	0	1	95.8901812019
141	284	1	0	1	104.384557476
141	293	1	0	1	101.859637692
141	319	3	0	3	57.7789658478
141	323	1	0	1	47.4360073278
141	338	0	0	0	83.9537467765
141	350	1	0	1	86.6162545835
141	357	1	0	1	73.3737855482
141	375	1	0	1	117.549287238
141	379	3	1	2	28.5361309615
141	380	1	0	1	19.3278577807
141	384	1	0	1	24.0280952803
141	385	1	0	1	29.648954947
141	392	3	0	3	24.6885048529
141	394	1	0	1	31.8269699114
141	396	3	0	3	32.3025851137
141	397	1	0	1	28.55155886
141	401	1	0	1	44.6937140296
141	406	4	0	4	39.2297596488
141	407	2	0	2	34.383198347
141	408	34	0	34	39.6880868704
141	409	1	0	1	40.9767698669
141	411	7	0	7	36.932866468
141	414	2	0	2	44.0825927535
141	415	18	5	13	29.6151334245
141	417	1	0	1	31.995875885
141	419	2	0	2	50.0407794989
141	426	2	0	2	76.6801357911
141	433	1	0	1	77.9736484431
141	444	1	0	1	62.628552813
141	454	1	0	1	12.6839663737
141	455	24	10	14	9.90194545078
141	456	8	8	0	4.40950740687
141	457	2	0	2	20.4046201184
141	460	8	4	4	15.9560110168
141	464	2	0	2	36.6605813272
141	465	4	0	4	30.4686271363
141	466	44	1	43	38.5201481294
141	467	45	1	44	7.82787806229
141	468	3	0	3	21.8467924606
141	469	170	0	170	26.5267555869
141	470	5	1	4	21.8869732233
141	471	9	1	8	42.444106666
141	472	4	0	4	28.0881539289
141	473	7	0	7	17.1473841714
141	474	1	0	1	47.8229774
141	475	348	111	237	11.7075321289
141	476	3	0	3	33.3832282635
141	480	2	0	2	33.5410516155
141	481	1	0	1	59.5713793892
141	484	1	0	1	55.0116867703
141	487	1	0	1	54.7315076655
141	488	2	0	2	50.1321125306
141	491	4	0	4	40.4703563979
141	493	1	0	1	55.3350146122
141	494	8	0	8	21.1618205827
141	495	3	0	3	35.6467243664
141	496	3	0	3	20.4081333474
141	497	1	0	1	17.6003220708
141	501	1	0	1	43.9902512573
141	503	14	2	12	28.3914309298
141	504	9	1	8	20.8341062796
141	505	1	0	1	49.3790299398
141	540	0	0	0	93.5069419744
141	554	1	0	1	54.1440984827
141	563	0	0	0	48.5319631386
141	566	3	0	3	29.8077711718
141	568	1	0	1	22.1213547201
141	569	1	0	1	41.6171234918
141	573	5	2	3	35.351893661
141	576	1	0	1	41.1358852409
141	578	1	0	1	22.939276768
141	579	1	0	1	41.6043199982
141	581	1	1	0	33.3925602315
141	585	1	0	1	63.4985717365
142	0	15	2	13	35.827015902
142	1	507	253	254	47.4190299724
142	2	2	0	2	34.1911615828
142	3	5	1	4	33.1111627775
142	5	6	0	6	49.6563328234
142	6	1	0	1	50.7609470625
142	7	18	4	14	35.9722255272
142	8	1	0	1	65.2776286791
142	10	2	0	2	33.3689663603
142	12	1	0	1	53.4720543274
142	13	30	0	30	32.4949323015
142	14	2	0	2	30.9411759967
142	15	20	3	17	36.7593100453
142	17	2	0	2	35.472607264
142	18	9	0	9	30.8490095472
142	19	4	0	4	36.8832345713
142	20	2	1	1	42.496436117
142	21	8	1	7	44.6830531073
142	23	2	1	1	40.8349689771
142	24	9	2	7	38.3931384399
142	26	2	0	2	36.6543197242
142	27	3	0	3	41.8254245255
142	28	11	1	10	46.533357
142	30	5	2	3	25.2662443439
142	31	50	3	47	18.0899758214
142	32	15	0	15	40.1635324787
142	33	33	8	25	27.2819249731
142	34	37	14	23	21.1757456472
142	35	35	0	35	27.8452220943
142	36	510	30	480	24.207845769
142	37	3	0	3	30.0285384421
142	38	11	0	11	19.3675383048
142	39	18	0	18	34.6864677677
142	41	38	1	37	23.2937471727
142	42	22	0	22	30.3883330185
142	45	1	0	1	45.3866829446
142	46	27	3	24	48.7654685418
142	48	30	4	26	37.1602794363
142	49	4	0	4	33.182137593
142	50	39	0	39	32.468540979
142	51	2	0	2	28.833608058
142	52	9	3	6	22.1701091432
142	53	2	0	2	62.2263346783
142	54	7	2	5	21.4376771464
142	55	3	0	3	43.4250452074
142	56	1	0	1	42.5059239182
142	57	2	0	2	37.26671019
142	58	1	1	0	55.5057823153
142	59	32	11	21	50.0451393561
142	60	12	6	6	33.7234200897
142	64	1	0	1	52.7770223157
142	65	22	0	22	52.3146382085
142	66	2	0	2	37.6098929762
142	68	18	0	18	27.8255169081
142	69	0	0	0	30.50858981
142	70	216	6	210	29.5880130765
142	71	98	11	87	20.4330755325
142	72	17	6	11	28.9800758255
142	73	2982	40	2942	23.2130859086
142	74	204	4	200	22.5317159959
142	75	404	4	400	20.8772124047
142	76	79	1	78	27.8488720208
142	77	22	6	16	27.8319749336
142	78	301	165	136	24.0267344867
142	79	86	2	84	26.9773804341
142	80	16	0	16	26.8795694047
142	81	248	47	201	27.3633915302
142	82	213	1	212	26.0273346946
142	83	164	10	154	23.8248063943
142	84	518	44	474	22.5570664134
142	85	81	5	76	26.2875118548
142	86	80	0	80	22.1817929931
142	87	323	66	257	19.6252189779
142	88	115	0	115	19.3075893435
142	89	51	1	50	34.521858332
142	90	13	2	11	31.9475124768
142	92	76	24	52	33.2904470763
142	93	1	0	1	52.4555362974
142	95	78	4	74	24.1195407305
142	96	47	19	28	37.2337299436
142	98	49	4	45	22.42294844
142	99	176	43	133	12.1180840567
142	100	9	0	9	28.0778147858
142	101	0	0	0	43.0454130794
142	102	11	1	10	33.3109118404
142	103	518	11	507	18.5077162579
142	104	16	0	16	28.7366190689
142	105	7	0	7	33.0759375618
142	106	2	0	2	37.8837804011
142	107	115	2	113	17.3175875903
142	108	1	0	1	42.1233278438
142	109	16	0	16	34.0555003722
142	110	101	0	101	15.1346621582
142	111	10	3	7	38.3300884617
142	112	343	17	326	19.8126034873
142	113	1389	153	1236	15.4413480034
142	114	13	4	9	20.4333753509
142	115	4	0	4	43.0078926304
142	116	15	1	14	29.564039057
142	117	18	1	17	16.9607236898
142	118	9	0	9	28.3288385453
142	119	16	4	12	27.9065784245
142	120	31	0	31	27.9816784876
142	121	38	24	14	15.5973277866
142	122	4	0	4	38.8381532853
142	123	1	0	1	41.4789987616
142	124	214	63	151	16.2737702055
142	125	11	0	11	14.9432512672
142	126	10	6	4	19.9453821898
142	127	130	50	80	7.44798588247
142	128	365	2	363	7.22270930867
142	129	60	1	59	14.8963738592
142	130	23	4	19	10.9369695213
142	131	109	22	87	28.7091413715
142	132	1	0	1	29.8581628049
142	133	165	21	144	10.1722963134
142	134	562	10	552	5.2289199389
142	135	23	0	23	16.5733111383
142	136	117	84	33	8.55827516217
142	137	89	2	87	12.2140573192
142	138	41	4	37	14.151822558
142	139	3	0	3	22.2939191078
142	140	357	26	331	9.65074682007
142	141	19	9	10	28.7406696834
142	143	211	17	194	8.61453215367
142	144	156	102	54	7.04398356541
142	145	257	33	224	8.8013642171
142	146	142	47	95	14.4140436923
142	147	265	57	208	18.3229649569
142	148	32	0	32	13.0938596118
142	149	7	0	7	28.243470966
142	150	4	0	4	24.5706728352
142	151	28	0	28	22.4776969174
142	152	41	24	17	14.1419233373
142	153	3	0	3	17.1791088508
142	154	31	14	17	12.5028179266
142	155	21	4	17	33.9063379173
142	156	1	0	1	37.2441859384
142	157	1	0	1	21.7207180729
142	158	2	1	1	30.1756783297
142	160	6	0	6	14.9317217892
142	161	1	0	1	21.0543066846
142	163	1	0	1	20.2632172321
142	164	37	0	37	23.4607497849
142	165	1	0	1	27.8425881872
142	166	6	0	6	41.210949207
142	168	13	6	7	21.9695454005
142	169	3	0	3	42.0650383594
142	171	29	5	24	28.6292636513
142	172	43	0	43	20.1265388093
142	175	2	1	1	28.0887382659
142	177	82	23	59	25.5845483112
142	179	1	0	1	46.7738724698
142	180	1	0	1	27.9249635298
142	182	1	0	1	118.847671022
142	183	24	0	24	111.461185561
142	184	1	0	1	104.763033614
142	186	1	0	1	106.595011988
142	187	0	0	0	114.549988025
142	188	3	0	3	113.301189693
142	190	5	0	5	109.464908847
142	196	1	0	1	129.151611258
142	207	1	0	1	98.1814590277
142	208	12	2	10	101.645725299
142	211	3	0	3	109.429383938
142	213	1	0	1	107.714267218
142	214	1	0	1	94.2564646535
142	217	1	0	1	126.906455573
142	220	3	0	3	129.650471025
142	222	0	0	0	123.238794256
142	224	2	0	2	101.466266874
142	225	1	0	1	105.326039007
142	229	2	0	2	110.436043084
142	236	1	0	1	95.0649305504
142	242	1	0	1	143.896523208
142	243	2	0	2	138.303641587
142	244	1	0	1	144.141492463
142	245	23	1	22	45.2173964977
142	246	2	0	2	45.4556536467
142	247	1	0	1	57.4713130732
142	251	3	1	2	49.6184258584
142	252	1	0	1	58.4676442797
142	253	2	1	1	63.2098350709
142	254	2	0	2	53.0599297064
142	257	5	0	5	46.0469683634
142	258	1	0	1	45.2185446863
142	260	2	1	1	42.9290691217
142	262	1	0	1	59.8860268263
142	266	1	0	1	87.1839533012
142	274	1	0	1	65.3367488429
142	276	2	0	2	71.7507348539
142	277	78	0	78	71.9048766939
142	281	1	0	1	65.0081597576
142	282	4	1	3	68.4302046895
142	291	1	0	1	86.7048330864
142	293	2	0	2	76.2197903721
142	294	0	0	0	78.5753609689
142	296	1	0	1	67.2326068401
142	303	8	0	8	52.6525165783
142	304	4	0	4	42.1849231479
142	305	5	2	3	58.1085246307
142	307	16	1	15	52.2887325592
142	309	4	0	4	44.7633233418
142	319	7	1	6	54.7426361243
142	325	1	0	1	60.7873257206
142	329	2	0	2	48.529739924
142	334	1	0	1	79.6236491072
142	338	9	0	9	70.4385634743
142	346	1	0	1	125.609690171
142	353	2	0	2	58.6919664889
142	359	1	0	1	75.772371311
142	375	1	0	1	96.0096313559
142	377	0	0	0	82.1697727713
142	385	1	0	1	55.2727854457
142	392	1	0	1	50.6291458571
142	408	18	1	17	68.1876184262
142	409	1	0	1	68.1572695857
142	411	3	0	3	65.6735305108
142	415	2	0	2	58.3242048175
142	416	2	0	2	74.2287328601
142	417	1	0	1	60.7095259671
142	427	0	0	0	80.9805024633
142	437	1	0	1	120.165896579
142	438	1	0	1	93.6968657043
142	442	2	0	2	88.1617760063
142	444	1	0	1	90.0879077533
142	455	0	0	0	35.2917785943
142	460	0	0	0	44.6629462514
142	463	0	0	0	63.1773312336
142	464	13	1	12	42.3607746127
142	465	22	0	22	50.0215684438
142	466	60	4	56	56.1247284225
142	468	5	0	5	28.2658773045
142	469	189	0	189	42.6584235962
142	470	2	0	2	33.6598799258
142	471	13	0	13	46.233262025
142	472	16	10	6	35.7494105011
142	474	7	3	4	63.127006631
142	475	46	14	32	35.8112488963
142	476	18	5	13	31.9031520555
142	477	6	1	5	48.5726865842
142	478	1	0	1	61.2420862077
142	479	2	0	2	40.0449695238
142	480	14	4	10	43.6699230634
142	482	5	0	5	70.9855181412
142	483	0	0	0	79.680136801
142	484	5	0	5	56.5396614548
142	485	3	1	2	74.2665371981
142	486	3	0	3	65.2871891219
142	487	1	1	0	59.6979466437
142	488	9	1	8	59.5628212441
142	489	2	0	2	70.0318826718
142	490	1	0	1	53.123325724
142	491	18	0	18	52.4679657918
142	492	1	0	1	63.3875806052
142	493	1	0	1	72.5510954128
142	494	4	0	4	41.0338749612
142	495	5	0	5	58.104876327
142	499	1	0	1	53.9734534476
142	501	2	0	2	65.8757810996
142	503	13	0	13	54.6842140875
142	504	1	0	1	43.57475884
142	505	8	0	8	68.8199374781
142	506	1	0	1	79.9513753427
142	507	1	0	1	154.929543095
142	508	1	0	1	146.842459316
142	520	0	0	0	80.079483451
142	552	1	0	1	89.4932318138
142	563	1	0	1	64.1272643958
142	565	1	0	1	115.745501942
142	566	1	0	1	50.4954829919
142	567	3	1	2	59.8936349601
142	568	1	0	1	35.440444163
142	573	8	0	8	48.3603425003
142	575	1	0	1	57.0548910473
142	581	2	1	1	36.4693151965
143	0	4	3	1	41.7960394542
143	1	46	6	40	52.1291804605
143	3	1	0	1	39.6427529959
143	4	1	0	1	41.8677096305
143	5	2	0	2	52.7862728005
143	13	5	0	5	38.0071527878
143	18	1	0	1	36.9980062852
143	20	1	0	1	45.0510704407
143	24	1	0	1	42.1067258291
143	28	1	0	1	51.9513103919
143	31	7	1	6	23.7583515486
143	32	1	0	1	47.3785069856
143	33	1	0	1	32.3944199243
143	34	10	6	4	22.0560505495
143	35	2	0	2	31.7573548969
143	36	63	0	63	31.1195801458
143	39	2	0	2	41.9473324151
143	41	2	0	2	28.6565042968
143	42	2	0	2	37.472998448
143	45	1	0	1	39.5090254089
143	48	7	0	7	33.4705314601
143	50	1	0	1	31.3420783025
143	52	1	0	1	18.7748518882
143	54	1	0	1	20.139667572
143	55	3	0	3	40.9507150286
143	59	6	2	4	45.1982566342
143	60	4	1	3	31.5541806356
143	61	1	0	1	50.3119306964
143	63	1	0	1	46.2073606812
143	65	4	0	4	50.3085892186
143	68	2	0	2	25.2349414405
143	69	1	0	1	25.3749148141
143	70	19	2	17	38.0704111819
143	71	13	3	10	28.5605852963
143	72	5	0	5	37.5805527811
143	73	369	0	369	31.821990892
143	74	22	1	21	30.9611428204
143	75	39	10	29	29.4775021681
143	76	8	1	7	36.2182517935
143	78	47	0	47	32.3943563287
143	79	6	0	6	35.5919125723
143	80	2	0	2	35.4745558742
143	81	28	0	28	35.9397737573
143	82	24	5	19	34.4776973156
143	83	13	0	13	32.3849270929
143	84	51	1	50	31.1411540106
143	85	11	3	8	34.386685734
143	86	6	1	5	30.1362499163
143	87	45	8	37	28.1267660111
143	88	11	0	11	27.6588588899
143	89	5	3	2	43.1122938898
143	90	3	0	3	39.8055280767
143	92	11	0	11	41.8746722076
143	95	9	2	7	32.4606474777
143	96	2	0	2	45.0452844031
143	98	3	0	3	29.764562499
143	99	17	0	17	19.9111427318
143	100	1	0	1	35.8639549962
143	101	1	0	1	51.6549259707
143	102	1	0	1	41.2521194508
143	103	61	0	61	27.0766065366
143	104	1	0	1	37.0284935881
143	105	1	0	1	41.4990037362
143	107	10	0	10	24.1596408779
143	109	1	0	1	42.3368670869
143	110	10	0	10	23.5171126596
143	111	3	0	3	46.9394014036
143	112	48	16	32	28.2016046811
143	113	161	6	155	24.0393675795
143	114	1	0	1	28.1220373308
143	115	1	1	0	51.5772989089
143	117	3	1	2	25.4082071215
143	118	1	0	1	36.2399952768
143	119	1	0	1	35.4318332986
143	120	4	1	3	36.555377054
143	121	1	0	1	23.9914855125
143	124	57	13	44	12.1545361872
143	125	2	0	2	14.2368080207
143	126	5	0	5	11.9794881597
143	127	14	2	12	15.6809128497
143	128	107	0	107	7.20586935535
143	129	6	0	6	21.7065716708
143	130	27	5	22	5.29734340658
143	131	37	2	35	21.4588619467
143	133	17	0	17	15.9960719819
143	134	69	9	60	13.161807211
143	135	8	2	6	11.9289375054
143	136	22	5	17	5.61948190304
143	137	6	0	6	18.3597871854
143	138	4	0	4	18.3516092794
143	139	4	0	4	13.7026204725
143	140	34	1	33	18.2473545178
143	141	4	0	4	21.6505715551
143	142	2112	40	2072	8.61453215367
143	144	22	6	16	12.113751422
143	145	51	27	24	10.9519073575
143	146	10	0	10	22.3962994006
143	147	146	22	124	11.1419331124
143	148	3	0	3	14.852973276
143	150	1	0	1	16.4598447788
143	151	6	0	6	16.2090705808
143	152	39	2	37	6.62226853361
143	153	8	3	5	8.64382282285
143	154	7	2	5	12.6165880291
143	155	1	0	1	40.6202675608
143	164	1	0	1	30.2780161336
143	166	1	0	1	47.1890794031
143	167	0	0	0	27.7095645126
143	168	4	0	4	27.8451746869
143	171	4	0	4	35.5039455142
143	172	5	0	5	24.8151341849
143	177	6	1	5	30.0102950164
143	191	1	0	1	139.519659475
143	208	1	0	1	110.234344498
143	220	1	0	1	137.913370608
143	245	1	0	1	53.7415176281
143	254	1	0	1	61.6463475581
143	257	1	0	1	54.1882142865
143	262	1	0	1	68.3266777086
143	277	7	0	7	80.1566873196
143	282	0	0	0	76.9513787288
143	290	1	0	1	93.097687694
143	293	1	0	1	84.8295503773
143	296	0	0	0	75.7786486617
143	332	1	0	1	88.4694846026
143	349	1	0	1	65.6441766546
143	350	1	0	1	72.4847087326
143	392	1	0	1	45.1458971552
143	406	1	0	1	59.0861910871
143	408	3	0	3	60.4005599297
143	415	2	0	2	50.8361400885
143	416	1	0	1	66.0742671745
143	453	1	0	1	47.0819825133
143	464	6	0	6	35.0762433491
143	465	2	0	2	41.4329136255
143	466	6	0	6	47.6658041257
143	467	0	0	0	28.8570315458
143	468	4	1	3	20.1071095207
143	469	25	1	24	34.1552836881
143	470	2	1	1	25.2466172731
143	471	2	0	2	39.4559519928
143	472	1	0	1	27.8668311236
143	475	15	0	15	27.4709099933
143	476	5	0	5	25.575413104
143	479	1	0	1	33.6216213197
143	480	3	0	3	35.7468180476
143	482	1	0	1	63.2408031013
143	485	1	0	1	66.1463466182
143	491	3	0	3	44.5050421457
143	492	1	0	1	55.4402945078
143	495	0	0	0	49.4912044061
143	502	1	0	1	54.3039843501
143	503	0	0	0	46.3173243613
143	505	1	0	1	60.3125480881
143	507	2	0	2	150.753751406
143	581	1	0	1	37.4152756437
144	0	2	0	2	40.716993192
144	1	53	18	35	53.0248883478
144	3	1	0	1	37.5483723979
144	4	1	0	1	43.6066082791
144	5	1	0	1	55.99267057
144	7	1	0	1	41.4122577422
144	10	0	0	0	39.1094477675
144	13	1	0	1	37.8015901019
144	15	2	0	2	42.4925870649
144	18	1	0	1	35.6980837822
144	24	1	0	1	44.5927229014
144	28	2	0	2	51.688073904
144	31	1	0	1	23.7699497959
144	32	1	0	1	43.6568960447
144	33	1	0	1	32.9702239376
144	34	2	0	2	28.1979930406
144	35	4	1	3	34.1159103303
144	36	41	1	40	28.5254365508
144	39	1	0	1	38.2330952646
144	41	3	0	3	28.948186544
144	42	1	0	1	34.2809838234
144	46	2	1	1	55.8079246229
144	48	6	0	6	43.8222632486
144	50	1	0	1	39.4965693442
144	52	1	0	1	28.7841594519
144	57	1	0	1	43.3661403987
144	59	3	0	3	56.3851411623
144	60	1	0	1	40.6617499666
144	65	2	0	2	59.3093797277
144	67	1	0	1	55.7255982675
144	68	2	0	2	34.669262029
144	70	24	7	17	27.6934313878
144	71	12	0	12	17.5077177574
144	72	2	1	1	28.0440313557
144	73	285	56	229	22.6535622165
144	74	23	1	22	20.587286069
144	75	41	5	36	20.2569692847
144	76	5	0	5	25.4917517191
144	77	1	0	1	27.1855238573
144	78	35	10	25	21.7666105785
144	79	10	1	9	26.5642802721
144	80	3	0	3	25.92453278
144	81	22	3	19	26.1768281532
144	82	16	3	13	24.0638054359
144	83	9	3	6	22.6117611244
144	84	60	8	52	21.6317357585
144	85	9	2	7	23.1235528803
144	86	9	0	9	18.7568555455
144	87	36	0	36	18.1961153858
144	88	17	0	17	17.1741083682
144	89	6	2	4	34.4928589184
144	90	3	0	3	28.1557351579
144	92	10	1	9	32.0378003507
144	95	9	0	9	25.8194850658
144	96	4	1	3	33.3101616929
144	98	6	0	6	17.8449623607
144	99	8	1	7	16.1346684261
144	100	1	0	1	30.985436426
144	101	1	0	1	42.0218477159
144	102	1	0	1	35.7467992375
144	103	40	5	35	19.3684045273
144	104	2	0	2	30.412987211
144	105	0	0	0	34.1400213496
144	107	46	6	40	12.1092885594
144	109	2	0	2	31.2820842943
144	110	9	0	9	17.3263396417
144	112	37	15	22	21.5800990694
144	113	154	2	152	15.185737326
144	114	2	1	1	23.8753989995
144	115	1	0	1	41.4609313797
144	116	1	0	1	26.7210151142
144	117	2	0	2	15.4027760419
144	118	1	0	1	24.6889801573
144	119	2	0	2	23.5583171658
144	120	8	1	7	28.3133581552
144	121	7	3	4	13.8915249601
144	124	9	0	9	22.5516815259
144	125	4	0	4	21.9034086936
144	126	1	0	1	24.0646432844
144	127	29	1	28	6.59136727829
144	128	67	3	64	5.76324698708
144	129	8	0	8	19.879408336
144	130	5	0	5	11.0850046682
144	131	6	0	6	33.557045409
144	132	1	0	1	32.190597653
144	133	7	2	5	16.3392028675
144	134	49	11	38	10.4742819644
144	135	2	1	1	14.0677974684
144	136	3	1	2	14.6277652919
144	137	38	3	35	6.24932146001
144	138	3	2	1	20.7258101496
144	139	1	0	1	24.9716889684
144	140	36	11	25	11.3586315451
144	142	1593	861	732	7.04398356541
144	143	22	0	22	12.113751422
144	145	11	3	8	15.8444977029
144	146	15	0	15	11.4185563196
144	147	34	15	19	17.9390526285
144	148	4	0	4	20.1236631947
144	151	3	0	3	27.9769921685
144	152	1	1	0	18.679872469
144	153	1	0	1	19.1686746996
144	154	2	2	0	7.33131149014
144	155	1	0	1	28.5065162645
144	160	2	1	1	7.96293048188
144	163	1	1	0	15.8966990522
144	164	4	0	4	18.182622569
144	165	1	0	1	20.8004840153
144	166	1	0	1	35.2085414071
144	168	4	0	4	15.8224926422
144	169	1	0	1	37.7948523654
144	171	4	1	3	23.4035372071
144	172	11	0	11	13.3289098259
144	177	32	3	29	18.75388552
144	183	1	0	1	112.965731291
144	187	1	0	1	114.739771824
144	208	4	0	4	99.9923311559
144	220	1	0	1	130.583658711
144	242	0	0	0	144.067982196
144	245	3	0	3	45.5410684318
144	257	1	0	1	47.7621602748
144	277	8	0	8	73.0696753746
144	281	1	0	1	65.4812642744
144	282	0	0	0	68.5557631245
144	293	1	0	1	74.9628270708
144	296	2	0	2	65.3324654543
144	305	1	0	1	60.3882436648
144	319	1	0	1	47.8127062523
144	329	1	0	1	42.5232441577
144	349	2	0	2	53.7073441945
144	392	1	0	1	46.8675780594
144	396	1	0	1	59.633250359
144	408	2	0	2	66.9752954836
144	464	0	0	0	47.1885634858
144	465	1	0	1	52.2808075882
144	466	3	0	3	59.0083445386
144	469	5	0	5	45.456494578
144	471	1	0	1	51.5004211202
144	475	3	0	3	36.2831365845
144	476	3	0	3	37.4404433416
144	480	0	0	0	47.7456960246
144	495	0	0	0	59.7482882164
144	496	1	0	1	45.9923259586
144	501	1	0	1	67.8027470009
144	503	1	0	1	54.9199535446
144	505	0	0	0	71.4632799791
144	511	1	0	1	156.117079933
144	520	1	0	1	76.2375692699
144	563	0	0	0	57.8779677103
144	568	1	0	1	29.7755401638
144	573	2	0	2	42.0845107322
145	0	7	2	5	31.0726014557
145	1	86	0	86	41.1793602076
145	2	1	0	1	27.4268493771
145	3	2	0	2	29.2257598447
145	5	1	1	0	42.159062183
145	6	1	0	1	42.4894991968
145	10	1	0	1	27.2186370843
145	12	0	0	0	46.2463620049
145	13	3	0	3	27.1624462543
145	15	8	1	7	30.5204370307
145	18	1	0	1	26.3970042941
145	19	1	0	1	32.7124668732
145	21	1	0	1	37.3244024684
145	23	1	0	1	33.5893722749
145	24	3	0	3	31.2727953688
145	26	1	0	1	28.2451405686
145	27	1	0	1	33.4290482401
145	28	5	0	5	41.0434647816
145	30	3	0	3	17.2603965189
145	31	26	12	14	13.1967342436
145	32	4	2	2	37.417530599
145	33	6	1	5	21.4960176495
145	34	45	1	44	12.4676370549
145	35	24	3	21	20.8465610395
145	36	111	50	61	21.1806420284
145	38	9	0	9	12.1587635937
145	39	2	1	1	32.1096711892
145	41	9	4	5	17.8519466154
145	46	7	1	6	39.9740879937
145	47	1	0	1	41.5317866918
145	48	14	2	12	29.009800154
145	49	1	0	1	24.5000196068
145	50	11	0	11	23.6843904386
145	52	4	0	4	14.3795959756
145	53	1	0	1	53.5352476855
145	54	6	0	6	12.7890859847
145	55	4	0	4	34.7958757372
145	59	1	0	1	42.3384228927
145	60	3	1	2	25.0926496084
145	65	3	1	2	43.5716932236
145	66	2	0	2	28.8517959383
145	68	9	1	8	19.4093354437
145	70	28	2	26	34.0662847354
145	71	18	0	18	26.4920764061
145	72	4	1	3	32.5001512097
145	73	367	105	262	26.8074917185
145	74	20	1	19	27.5565322346
145	75	51	28	23	24.79076806
145	76	10	0	10	32.8817747528
145	77	2	0	2	31.1201369275
145	78	30	0	30	29.2213093064
145	79	3	0	3	30.0761716333
145	80	3	0	3	30.5690601718
145	81	27	2	25	31.2595683885
145	82	21	0	21	30.797295254
145	83	14	0	14	28.0308863002
145	84	49	24	25	26.5947568674
145	85	7	0	7	32.1526305513
145	86	12	3	9	28.5148939656
145	87	36	0	36	24.4702323759
145	88	15	3	12	24.8136749443
145	89	8	2	6	36.6919564692
145	90	5	0	5	38.1315132406
145	92	12	0	12	36.9005731068
145	95	15	0	15	24.9789988922
145	96	9	0	9	43.384949858
145	98	1	0	1	29.6319294077
145	99	59	10	49	12.192541962
145	102	4	0	4	32.4152629415
145	103	91	4	87	21.1668318103
145	104	4	0	4	29.1862345794
145	105	2	0	2	34.0034998987
145	107	11	2	9	25.1860010469
145	110	27	11	16	16.8865458691
145	111	1	0	1	41.3901738956
145	112	52	5	47	21.1621178132
145	113	192	3	189	19.8274129012
145	114	5	0	5	19.3248916128
145	115	0	0	0	46.5556057736
145	116	1	0	1	34.9678589305
145	117	4	0	4	22.2654608525
145	118	1	0	1	34.5151188825
145	120	5	1	4	30.1551079599
145	121	5	0	5	21.2287258226
145	122	1	0	1	43.0828159742
145	124	237	159	78	9.82948779042
145	125	22	9	13	6.43081907339
145	126	3	1	2	17.445097243
145	127	12	1	11	14.5655281272
145	128	57	12	45	14.605905976
145	129	57	8	49	12.2184118018
145	130	1	0	1	15.8481840686
145	131	17	0	17	24.0486703981
145	133	137	25	112	6.39918112631
145	134	87	26	61	8.10004343179
145	135	3	0	3	22.4702705395
145	136	39	2	37	5.902179234
145	137	9	0	9	20.685041455
145	138	32	0	32	7.45288372763
145	140	30	1	29	13.8305110187
145	141	1	0	1	32.464590293
145	142	1555	892	663	8.8013642171
145	143	34	0	34	10.9519073575
145	144	12	2	10	15.8444977029
145	146	15	9	6	21.1661113837
145	147	33	0	33	22.046602717
145	148	80	2	78	4.42339974338
145	149	1	0	1	29.3498212
145	151	11	0	11	17.098317439
145	152	10	1	9	12.2016534246
145	154	3	0	3	20.5327313136
145	155	1	0	1	41.4415307132
145	160	1	0	1	23.6882041225
145	164	1	0	1	31.135451753
145	171	4	0	4	36.1261211063
145	172	5	1	4	28.8130418926
145	176	1	0	1	34.1032928145
145	177	11	0	11	34.2682968508
145	183	1	0	1	110.369475164
145	208	0	0	0	104.516498536
145	220	3	0	3	129.199874587
145	236	1	0	1	95.9632415588
145	243	1	0	1	138.611224047
145	245	1	0	1	46.518204416
145	246	1	0	1	47.9582657768
145	254	1	0	1	54.8456391384
145	257	2	0	2	45.5567043305
145	258	1	0	1	43.4831218965
145	262	1	0	1	60.4913250303
145	266	1	0	1	85.8177577596
145	268	1	0	1	93.4169089823
145	271	1	0	1	91.0095618029
145	277	7	1	6	71.5891176983
145	282	0	0	0	69.4675626616
145	294	0	0	0	82.3449691748
145	304	1	0	1	37.875764649
145	305	1	0	1	56.5607162196
145	319	1	0	1	63.461691872
145	338	1	0	1	77.7766459077
145	353	1	0	1	65.5570827661
145	408	2	0	2	70.4932476357
145	414	1	1	0	71.4198106505
145	464	7	0	7	37.1737543411
145	465	7	0	7	48.3233073805
145	466	9	0	9	53.4364622097
145	468	2	0	2	25.3909307277
145	469	32	9	23	40.4524726152
145	470	2	0	2	31.3186320974
145	471	6	1	5	40.2742709719
145	472	3	1	2	31.8369684081
145	474	1	0	1	59.4148896312
145	475	2	0	2	36.9629424969
145	476	6	1	5	25.8798584575
145	477	1	0	1	45.2729264908
145	480	1	0	1	39.5907317071
145	482	3	1	2	66.132334383
145	484	1	0	1	49.603367123
145	485	1	0	1	70.2185052881
145	486	1	0	1	58.9724901402
145	488	3	1	2	54.3535603742
145	491	2	0	2	48.293300333
145	503	3	1	2	55.4749948985
145	505	1	0	1	66.2462947684
145	569	0	0	0	58.377334665
145	573	1	0	1	56.3891210921
145	581	1	0	1	45.1030549747
146	0	10	0	10	35.914144659
146	1	64	3	61	49.3058214211
146	5	1	0	1	54.3029103114
146	7	1	0	1	37.7677568629
146	12	1	0	1	57.2570073427
146	13	2	0	2	34.062836871
146	14	1	0	1	34.0966803503
146	15	2	0	2	39.5120274326
146	16	1	0	1	34.415906261
146	18	1	0	1	31.1297216778
146	26	1	0	1	44.6791035283
146	28	1	0	1	46.9745780017
146	31	1	0	1	22.390121694
146	32	6	3	3	36.2817361032
146	33	0	0	0	30.4996857764
146	34	1	0	1	31.515829343
146	35	1	0	1	33.1883193504
146	36	40	6	34	23.6059266221
146	39	1	0	1	31.1945960113
146	41	1	0	1	26.7901583328
146	42	3	0	3	28.0586723308
146	46	4	1	3	58.6548420958
146	48	2	0	2	50.1033458133
146	49	1	0	1	42.5789895233
146	50	3	0	3	43.588200516
146	55	1	0	1	55.255949755
146	60	1	0	1	45.6699737528
146	68	1	0	1	40.3884041996
146	70	70	13	57	16.2795298624
146	71	132	76	56	6.18820431183
146	72	9	7	2	16.8817584954
146	73	1237	451	786	11.9217380784
146	74	168	0	168	9.20767240552
146	75	177	2	175	9.66600679075
146	76	29	4	25	14.0898122716
146	77	8	1	7	16.1943386811
146	78	216	68	148	10.3481748402
146	79	24	0	24	15.7418396491
146	80	6	0	6	14.8014124371
146	81	54	1	53	14.9433733281
146	82	54	21	33	12.6545044516
146	83	51	1	50	11.4573947794
146	84	187	1	186	10.6940998028
146	85	59	16	43	11.9906876066
146	86	101	71	30	7.77843635632
146	87	282	121	161	7.14087232168
146	88	155	66	89	5.80980956859
146	89	19	3	16	23.6917644416
146	90	11	0	11	17.5351290896
146	92	28	1	27	20.711289207
146	94	1	0	1	30.4673056301
146	95	55	8	47	17.176682481
146	96	6	0	6	22.819878317
146	98	32	6	26	8.4989002629
146	99	10	1	9	13.5477838444
146	100	1	0	1	23.487557503
146	102	3	1	2	27.2795743687
146	103	173	0	173	10.6342921926
146	104	1	0	1	21.3401119936
146	107	185	42	143	5.62731376042
146	109	11	0	11	20.0141387832
146	110	10	3	7	11.2100627368
146	111	8	0	8	26.0888416699
146	112	78	21	57	13.65099698
146	113	455	1	454	6.13738432698
146	114	6	0	6	18.102397939
146	115	1	0	1	30.0516122516
146	116	7	1	6	15.4552672797
146	117	51	33	18	4.57495697948
146	118	1	0	1	13.9220853631
146	119	7	1	6	13.6216875977
146	120	7	0	7	17.9901677481
146	121	78	39	39	3.26903403159
146	122	1	0	1	25.3636817386
146	123	1	0	1	30.1247716711
146	124	6	2	4	30.262076624
146	125	1	0	1	27.5380386061
146	127	35	14	21	6.98356419415
146	128	10	0	10	17.0943463282
146	129	10	3	7	17.8106284939
146	130	3	0	3	22.4204402793
146	131	1	0	1	43.1231610443
146	133	3	0	3	17.8342706656
146	134	15	9	6	13.1020355438
146	135	1	0	1	25.182371386
146	136	2	0	2	22.8844161125
146	137	40	5	35	7.09930652113
146	140	53	1	52	8.20641686745
146	142	308	280	28	14.4140436923
146	143	3	0	3	22.3962994006
146	144	11	0	11	11.4185563196
146	145	4	1	3	21.1661113837
146	147	7	0	7	29.3540945339
146	153	1	0	1	30.2764964838
146	154	3	0	3	17.6324807302
146	155	14	0	14	20.3645118712
146	156	2	0	2	23.1344872949
146	158	1	0	1	21.8692168538
146	160	2	1	1	14.0975065567
146	163	0	0	0	25.8033379995
146	164	13	0	13	10.3770583388
146	165	2	0	2	21.6468042351
146	166	7	0	7	28.4198247155
146	167	1	0	1	27.9951297814
146	168	9	0	9	11.2115278786
146	169	4	0	4	27.6722687061
146	171	24	0	24	15.0702483023
146	172	27	6	21	12.7227070817
146	173	1	0	1	26.7538670684
146	175	4	0	4	16.1073573997
146	177	30	0	30	17.0584535649
146	179	2	0	2	32.3731524384
146	183	0	0	0	102.641488392
146	186	1	0	1	96.4977790796
146	188	1	0	1	103.095812554
146	200	1	0	1	106.920679954
146	208	0	0	0	88.5793355648
146	209	1	0	1	88.099095935
146	213	0	0	0	94.8928062745
146	214	1	0	1	81.0568400213
146	220	2	0	2	119.850944295
146	229	0	0	0	98.4437641251
146	242	0	0	0	132.95409155
146	245	7	0	7	34.7828555261
146	253	1	0	1	50.7452207445
146	254	2	0	2	41.6853393159
146	266	1	0	1	79.0650541745
146	270	1	0	1	65.3607278234
146	272	1	0	1	73.1432037371
146	277	12	2	10	62.645617018
146	280	1	0	1	70.2138534102
146	282	2	0	2	57.5373110756
146	291	1	0	1	74.9229689201
146	293	1	0	1	63.5551005978
146	294	1	0	1	64.9653108243
146	297	1	0	1	70.0621797388
146	305	1	0	1	51.066450569
146	307	1	0	1	48.0009139628
146	310	1	0	1	56.6578655928
146	319	4	0	4	45.0026946607
146	323	1	0	1	37.3053420754
146	326	1	0	1	41.7060032025
146	329	6	2	4	35.582549929
146	338	3	0	3	56.6106906546
146	340	1	0	1	74.8911961259
146	341	0	0	0	63.1328957114
146	347	0	0	0	35.2922510742
146	348	1	0	1	38.296866933
146	349	1	0	1	46.608926105
146	357	2	0	2	52.0574752469
146	361	1	0	1	55.5194353077
146	385	0	0	0	60.3298477969
146	392	0	0	0	56.2399069964
146	408	2	1	1	77.9717635072
146	411	1	0	1	74.4672827681
146	415	2	0	2	67.5779815377
146	426	1	0	1	115.183064693
146	442	1	0	1	98.1598829579
146	444	1	1	0	101.111726612
146	460	1	0	1	54.13770295
146	464	5	0	5	56.7725537856
146	465	0	0	0	63.4779753485
146	466	1	0	1	69.9883530062
146	469	5	0	5	56.4458112625
146	471	1	0	1	60.5685258294
146	472	2	0	2	50.0868659927
146	475	1	0	1	47.7013336895
146	477	0	0	0	62.7018638471
146	485	1	0	1	88.5160666596
146	489	1	0	1	84.2850661989
146	491	1	0	1	66.7910634142
146	493	1	0	1	86.6192698473
146	494	1	0	1	54.1705953946
146	495	0	0	0	71.0981353361
146	496	1	0	1	57.4097657284
146	501	1	0	1	79.1055937055
146	503	0	0	0	66.3113740389
146	507	1	0	1	156.24054016
146	523	0	0	0	105.665882073
146	540	0	0	0	116.347807855
146	551	0	0	0	59.4585607268
146	554	0	0	0	74.5537752698
146	563	1	0	1	62.5533244624
146	569	0	0	0	46.0050224258
146	573	4	1	3	47.0860716137
146	577	1	0	1	42.279254635
146	580	1	0	1	38.1921133672
146	581	1	0	1	32.4557958578
146	585	1	0	1	63.6105069946
147	0	5	0	5	52.9289830679
147	1	61	0	61	63.1704569861
147	3	1	0	1	50.7029891172
147	5	2	0	2	63.3729304664
147	7	1	0	1	52.3155407411
147	11	0	0	0	73.1684233535
147	13	3	1	2	49.1484044526
147	15	2	0	2	52.5412683313
147	16	1	0	1	53.6924133395
147	18	1	0	1	48.1106610176
147	26	1	0	1	48.0742412128
147	28	2	0	2	63.0812755571
147	30	1	0	1	38.4601423373
147	31	4	0	4	34.8832602285
147	32	2	0	2	58.2461103588
147	33	1	0	1	43.5258583309
147	34	8	1	7	32.2876995541
147	35	2	0	2	42.7329171693
147	36	62	9	53	42.0604631751
147	37	2	0	2	42.4367546183
147	38	2	0	2	34.1195944347
147	39	3	0	3	52.7857912433
147	40	1	0	1	56.4901644217
147	41	2	0	2	39.7984281764
147	43	1	0	1	59.0097753447
147	47	2	1	1	49.4198803649
147	48	10	2	8	39.558482062
147	50	8	1	7	39.955537677
147	55	0	0	0	47.9815497141
147	59	2	0	2	49.1799775895
147	60	3	0	3	39.3035315025
147	65	5	0	5	57.5080562971
147	68	5	0	5	33.0302153023
147	69	1	0	1	30.269444198
147	70	49	1	48	45.6319560577
147	71	17	6	11	35.3934214171
147	72	8	3	5	45.887515943
147	73	887	0	887	40.357475765
147	74	54	11	43	38.5237048377
147	75	115	0	115	37.9527084412
147	76	20	2	18	43.403637268
147	77	2	0	2	44.9526915594
147	78	68	13	55	39.6996714283
147	79	17	1	16	44.2554978433
147	80	5	1	4	43.7604758308
147	81	44	0	44	44.0583442704
147	82	73	0	73	42.0028247459
147	83	35	4	31	40.4780357894
147	84	125	69	56	39.4285642357
147	85	16	0	16	40.8764907055
147	86	13	3	10	36.4973107608
147	87	55	1	54	36.0652652201
147	88	30	2	28	35.1104550786
147	89	6	1	5	52.0929418496
147	90	5	1	4	45.5195343517
147	92	7	0	7	49.948455056
147	95	13	8	5	42.3335430496
147	96	9	0	9	50.4811930907
147	98	2	0	2	34.9833741347
147	99	10	1	9	30.3749087611
147	100	1	0	1	46.3772582039
147	101	3	0	3	59.9222615474
147	102	1	1	0	51.6336041742
147	103	118	0	118	36.3776468736
147	105	1	0	1	51.1593664069
147	107	18	0	18	29.1092351135
147	109	3	0	3	49.0725513286
147	110	23	2	21	33.3674189876
147	112	57	8	49	38.0072290021
147	113	301	0	301	32.6552816252
147	114	3	1	2	38.6904407597
147	116	3	0	3	44.5296504725
147	117	3	0	3	33.2629284679
147	118	2	0	2	42.2123856251
147	119	1	0	1	40.6415420044
147	120	2	0	2	45.7131174341
147	121	5	1	4	31.7558220134
147	122	0	0	0	54.6861049389
147	123	1	0	1	58.9049053148
147	124	61	0	61	20.4289673401
147	125	1	0	1	24.3448770928
147	126	18	8	10	13.8572030667
147	127	21	0	21	23.7867048668
147	128	100	15	85	12.427952232
147	129	6	0	6	32.6233036031
147	130	90	10	80	7.42977330605
147	131	65	1	64	22.8988528311
147	132	4	0	4	15.9713758452
147	133	13	0	13	27.0456012889
147	134	48	18	30	23.4606146929
147	135	171	66	105	5.87592348108
147	136	9	8	1	16.3774223264
147	137	8	0	8	23.3207446245
147	138	3	1	2	29.4774631096
147	139	39	0	39	10.6914594351
147	140	48	0	48	27.5880096025
147	141	88	11	77	10.5555540894
147	142	1564	50	1514	18.3229649569
147	143	72	0	72	11.1419331124
147	144	29	13	16	17.9390526285
147	145	19	14	5	22.046602717
147	146	30	2	28	29.3540945339
147	148	2	0	2	25.7193826941
147	149	32	1	31	11.4899138741
147	150	33	1	32	7.10894985786
147	151	6	0	6	20.7947002626
147	152	45	8	37	12.8022566076
147	153	67	0	67	6.15639905949
147	154	48	13	35	13.0782238528
147	155	2	0	2	44.1023230854
147	156	1	0	1	48.5691045718
147	157	1	0	1	22.4757091984
147	160	2	0	2	19.1933589635
147	161	1	0	1	16.8776266746
147	163	35	10	25	10.918459419
147	164	2	0	2	34.5878969537
147	166	4	0	4	49.1508776553
147	168	2	1	1	30.9817677271
147	171	2	0	2	39.5400287099
147	172	17	2	15	26.7523945104
147	174	3	1	2	7.62897237467
147	176	3	0	3	13.6519366121
147	177	10	0	10	30.8947252978
147	179	1	0	1	59.2147980489
147	182	0	0	0	137.165036237
147	183	0	0	0	129.751707582
147	208	0	0	0	117.902984231
147	210	1	0	1	120.347945332
147	220	2	0	2	147.810139113
147	222	0	0	0	141.50939391
147	229	1	0	1	127.670929019
147	231	1	0	1	108.870769487
147	236	1	0	1	112.770201304
147	242	0	0	0	161.71815937
147	245	4	0	4	63.0287473634
147	254	1	0	1	70.5450292148
147	256	1	0	1	56.6411274136
147	257	2	0	2	64.331782404
147	262	1	0	1	77.8592514143
147	264	1	0	1	69.563836468
147	277	8	0	8	90.1031940564
147	293	1	0	1	92.901373364
147	294	0	0	0	94.0883854046
147	304	1	0	1	59.6024741988
147	307	1	0	1	70.3142210954
147	310	1	0	1	84.5112991415
147	314	1	0	1	85.869960803
147	319	3	0	3	56.3143649079
147	323	1	0	1	46.0125335741
147	329	1	0	1	56.1345339028
147	335	1	0	1	96.2284492788
147	349	1	0	1	66.9681340266
147	375	1	0	1	110.195580427
147	385	1	0	1	39.1316008047
147	386	0	0	0	43.6930598122
147	396	2	0	2	42.2268122881
147	401	1	0	1	55.0698185801
147	406	3	0	3	48.9819986681
147	407	1	0	1	43.8476878256
147	408	5	0	5	49.8722373805
147	409	1	0	1	50.2358164524
147	410	1	0	1	45.755610526
147	411	2	0	2	47.421159801
147	412	1	0	1	59.0543524826
147	414	1	0	1	53.0684826985
147	415	6	3	3	40.0233634089
147	416	1	0	1	56.1094920169
147	417	1	0	1	42.5324609657
147	426	1	0	1	86.3362365733
147	451	1	0	1	33.9258899834
147	453	1	0	1	36.347664923
147	455	3	0	3	18.6739324493
147	457	1	0	1	30.1789102391
147	460	2	0	2	26.3716475967
147	464	7	0	7	34.9390773469
147	465	4	0	4	35.1761623707
147	466	15	0	15	42.4796782872
147	467	5	0	5	18.0266766914
147	468	9	1	8	18.7274919921
147	469	111	0	111	29.1559074796
147	470	1	0	1	21.6553659686
147	471	9	1	8	40.2694502658
147	472	4	0	4	26.516102325
147	473	3	0	3	19.9472487966
147	474	2	0	2	50.9213455039
147	475	100	4	96	18.353178489
147	476	7	1	6	28.4672543797
147	477	2	0	2	36.4832941385
147	478	1	0	1	46.4560572716
147	479	2	0	2	35.5619634952
147	480	5	1	4	33.6068876129
147	482	1	0	1	60.7164764218
147	483	0	0	0	68.7210154841
147	484	1	0	1	52.4681499216
147	486	1	0	1	58.8424925572
147	487	3	0	3	53.5264859868
147	488	3	0	3	50.6449463283
147	491	10	0	10	41.780070132
147	492	1	0	1	52.423925616
147	494	6	0	6	25.5829392572
147	495	4	0	4	42.1018855902
147	496	4	1	3	28.0570918813
147	499	1	0	1	37.460941059
147	503	8	1	7	37.0067240001
147	504	1	0	1	27.0236592568
147	505	1	0	1	54.5090421178
147	507	1	0	1	140.207357134
147	554	0	0	0	61.6662108365
147	566	4	2	2	37.0778317281
147	568	1	0	1	25.2807311614
147	569	1	0	1	43.9378001949
147	573	4	0	4	39.3962552083
147	576	3	1	2	39.7297915042
148	0	7	0	7	28.2290441013
148	1	175	52	123	37.4975177802
148	2	4	1	3	23.6226028165
148	3	5	0	5	26.879837764
148	7	5	0	5	26.9608689053
148	8	1	0	1	53.2774821219
148	9	1	0	1	31.4369992919
148	10	1	0	1	23.724267897
148	13	6	0	6	24.0973868572
148	14	2	1	1	21.4467758161
148	15	37	0	37	26.9337684228
148	17	1	0	1	23.5375906997
148	18	3	0	3	23.825692672
148	23	3	1	2	29.519568518
148	24	1	0	1	27.2696370722
148	25	1	0	1	44.7942063063
148	26	1	0	1	23.8268329891
148	28	4	0	4	37.7064689165
148	29	2	0	2	32.7219177604
148	30	7	0	7	12.9871581565
148	31	132	43	89	11.1767292949
148	32	3	0	3	35.4855347404
148	33	20	9	11	18.3370053884
148	34	183	0	183	8.08435854366
148	35	112	42	70	17.0258080096
148	36	306	0	306	19.6211900898
148	37	1	0	1	17.4379156799
148	38	45	12	33	8.5349675443
148	39	8	0	8	30.3767291517
148	40	1	0	1	35.1600180821
148	41	43	1	42	15.0602075656
148	42	6	1	5	25.7914860881
148	45	1	0	1	36.4853587476
148	46	4	0	4	35.7000766621
148	48	14	2	12	25.9131869556
148	49	2	0	2	20.1072077516
148	50	20	8	12	19.6291886662
148	51	2	0	2	15.7443402436
148	52	18	4	14	12.1759479828
148	53	1	0	1	49.1510546859
148	54	26	1	25	9.28076968639
148	55	1	0	1	31.0356809936
148	57	1	0	1	27.9673338748
148	59	1	0	1	39.5616252059
148	60	6	0	6	21.3870865415
148	62	1	0	1	50.7272838122
148	64	1	0	1	39.6913657833
148	65	4	1	3	39.5837525611
148	66	2	0	2	24.5176531097
148	67	1	0	1	35.7947316841
148	68	27	13	14	16.1311088183
148	69	2	0	2	21.5473688254
148	70	13	1	12	35.8272810021
148	71	6	0	6	29.1834665944
148	72	5	0	5	33.8292930195
148	73	220	27	193	28.3424439563
148	74	17	12	5	29.7381088569
148	75	48	5	43	26.5514205271
148	76	11	0	11	34.9379351342
148	78	30	1	29	31.4381965614
148	79	10	0	10	31.2669233916
148	80	1	0	1	32.0310347099
148	81	9	4	5	32.8028036929
148	82	12	6	6	32.7727828636
148	83	10	0	10	29.8137729164
148	84	29	0	29	28.3456108864
148	85	6	0	6	34.6288434854
148	86	5	0	5	31.2887001692
148	87	23	5	18	26.6693052392
148	88	10	0	10	27.3001282401
148	89	4	1	3	37.2584428082
148	90	3	0	3	40.6765338265
148	92	4	0	4	38.1772922575
148	95	24	5	19	25.2674164499
148	96	2	0	2	45.8546834019
148	99	68	15	53	13.2972397459
148	100	6	0	6	26.0487017695
148	103	72	0	72	22.5277467807
148	104	1	0	1	29.0985026717
148	109	4	0	4	41.2008312179
148	110	25	4	21	18.1553495239
148	111	5	0	5	42.313517835
148	112	80	7	73	21.9023903259
148	113	188	36	152	22.0380919131
148	114	11	0	11	18.9475155152
148	116	1	1	0	37.1667926853
148	117	2	0	2	24.7545468696
148	119	2	0	2	37.6242357691
148	120	4	1	3	30.8923749873
148	124	201	30	171	9.71454935661
148	125	60	16	44	4.14436366628
148	126	1	0	1	19.0141936166
148	127	2	0	2	18.1313838289
148	128	11	0	11	19.0176651087
148	129	60	5	55	11.8066350605
148	130	3	0	3	19.961101593
148	131	17	0	17	23.9672414778
148	133	105	13	92	7.15435436545
148	134	38	3	35	11.3338527938
148	136	11	3	8	9.34857558345
148	137	4	0	4	24.643803534
148	138	121	42	79	5.11365289239
148	140	26	0	26	16.4400063293
148	142	483	90	393	13.0938596118
148	143	9	1	8	14.852973276
148	144	1	0	1	20.1236631947
148	145	106	55	51	4.42339974338
148	146	7	0	7	24.318768699
148	147	16	1	15	25.7193826941
148	151	9	1	8	16.9293839362
148	152	5	1	4	14.5814397495
148	154	1	0	1	24.9550426851
148	155	3	0	3	44.6830930943
148	158	1	0	1	43.0286583188
148	160	1	0	1	28.022884766
148	161	0	0	0	33.6041563077
148	164	5	0	5	34.5418387394
148	171	1	0	1	39.386878862
148	172	2	0	2	32.8797877059
148	176	1	0	1	38.1994885806
148	183	1	0	1	108.791850202
148	208	1	0	1	104.935201931
148	220	1	0	1	127.895123909
148	221	0	0	0	121.556242781
148	229	1	0	1	111.807045707
148	245	1	0	1	46.4814399412
148	256	1	0	1	36.9591515483
148	257	1	0	1	44.6335554558
148	258	1	0	1	41.9644901811
148	277	2	0	2	70.5249183543
148	281	0	0	0	65.1246713999
148	282	0	0	0	69.0898407043
148	291	1	0	1	88.1099131279
148	303	2	0	2	44.3576076113
148	304	1	1	0	35.1474993969
148	307	1	0	1	46.958609648
148	309	1	0	1	39.3427811614
148	319	1	0	1	67.5151146111
148	323	1	0	1	58.5460023164
148	349	1	0	1	70.9210219602
148	375	1	0	1	102.009402434
148	408	2	0	2	73.1673620979
148	465	1	0	1	49.3634737994
148	466	2	0	2	53.90795064
148	468	1	0	1	26.3148803782
148	469	8	0	8	41.3426867513
148	470	1	0	1	32.3312759705
148	471	3	0	3	38.9048518162
148	472	2	1	1	31.9602766858
148	474	1	0	1	59.2672348448
148	475	3	0	3	39.4523288283
148	476	4	0	4	24.7698573628
148	477	1	0	1	45.5013649376
148	491	0	0	0	47.9786260908
148	493	1	1	0	69.0762469995
148	494	2	0	2	41.7383195045
148	495	0	0	0	58.2958602398
148	499	1	0	1	55.0211136331
148	503	1	0	1	57.6055501207
148	505	0	0	0	66.6789702316
148	507	1	0	1	165.603509495
148	537	1	0	1	115.523782394
148	577	1	0	1	61.9306255682
149	0	1	0	1	60.1816217871
149	1	6	0	6	68.8892994054
149	13	1	0	1	56.0696906191
149	24	2	0	2	58.0318747814
149	26	1	0	1	51.2034997145
149	29	1	0	1	57.7128872858
149	32	1	0	1	66.7276622484
149	33	1	0	1	50.3069763203
149	35	1	0	1	48.5365076313
149	36	5	0	5	50.4486650259
149	46	2	1	1	56.730696098
149	49	1	0	1	45.9507808169
149	50	2	1	1	41.2720274705
149	55	1	0	1	46.7409774297
149	56	1	0	1	50.3694484193
149	65	2	0	2	56.0640037238
149	70	5	1	4	56.7785754528
149	71	3	0	3	46.6627964445
149	73	128	80	48	51.1330266319
149	74	13	2	11	49.636423634
149	75	14	4	10	48.7415681755
149	76	4	0	4	54.6373931619
149	78	14	2	12	50.8873990664
149	79	0	0	0	54.989760977
149	81	7	0	7	55.0190732438
149	82	8	1	7	53.144070565
149	83	5	1	4	51.4311378783
149	84	13	1	12	50.3027378998
149	85	6	0	6	52.2342898178
149	86	1	0	1	47.8558749271
149	87	6	0	6	47.0461139936
149	88	1	0	1	46.2322982711
149	89	2	0	2	62.6883996957
149	90	1	0	1	56.9790318657
149	95	2	1	1	52.2831632692
149	96	1	0	1	61.9624377
149	98	1	0	1	46.4529697761
149	99	2	0	2	39.7190231677
149	103	17	0	17	46.7320498816
149	110	8	0	8	43.3207472493
149	112	12	1	11	48.0075986611
149	113	49	9	40	43.3468423717
149	114	1	0	1	47.8576055299
149	116	1	0	1	55.8608046797
149	121	1	0	1	42.7593652075
149	122	1	0	1	65.9124173251
149	124	13	0	13	23.8364851965
149	126	12	0	12	14.0229330656
149	127	4	0	4	34.5730185455
149	128	11	0	11	23.4585337395
149	129	1	0	1	41.1827868581
149	130	3	0	3	18.1498909611
149	131	60	3	57	18.638366611
149	132	30	13	17	6.61258339637
149	133	1	0	1	35.3113261099
149	134	3	0	3	32.9955050475
149	135	13	0	13	16.9906325385
149	136	2	0	2	23.4911199237
149	139	18	0	18	8.4679386642
149	140	6	0	6	37.8621798071
149	141	50	2	48	9.36196092561
149	142	195	36	159	28.243470966
149	143	2	1	1	19.8351721767
149	144	3	0	3	29.1550810201
149	145	4	1	3	29.3498212
149	146	2	0	2	40.5490917242
149	147	401	68	333	11.4899138741
149	150	36	28	8	4.45112443795
149	151	4	0	4	20.3709912587
149	152	5	0	5	17.3929240578
149	153	6	2	4	11.2294493171
149	154	13	0	13	24.5484046915
149	156	1	0	1	60.0326717065
149	157	1	0	1	33.2474488132
149	163	1	0	1	20.686637871
149	172	4	0	4	38.1113858475
149	208	1	0	1	129.121427625
149	220	0	0	0	157.746486355
149	246	1	0	1	73.4506075908
149	277	2	0	2	99.9905081444
149	392	1	0	1	32.4091024557
149	397	1	0	1	29.5091722021
149	399	1	0	1	36.5986972258
149	406	2	0	2	39.4563843554
149	408	4	0	4	41.2038535649
149	410	1	0	1	37.4879536832
149	415	1	0	1	32.377953024
149	455	1	0	1	18.9122341421
149	464	4	0	4	27.3077124993
149	465	5	0	5	23.7640323058
149	466	26	5	21	31.2858188537
149	467	4	0	4	11.8808059424
149	468	13	3	10	12.7948424959
149	469	160	50	110	18.3172158446
149	470	13	7	6	12.5772487878
149	471	2	0	2	33.0834978326
149	472	6	2	4	18.7265353589
149	473	13	4	9	8.80019442402
149	474	2	0	2	40.0831914633
149	475	415	281	134	7.66227892024
149	476	3	0	3	24.5382167183
149	477	1	0	1	26.023438171
149	478	1	0	1	35.0035940786
149	480	4	0	4	24.4225370615
149	485	1	0	1	51.3714086766
149	488	5	0	5	41.2468516444
149	489	1	0	1	55.1472258443
149	490	1	0	1	37.8583258251
149	491	3	1	2	31.8050768731
149	494	5	0	5	14.1407127504
149	495	1	0	1	30.6443667366
149	496	10	6	4	17.1778170574
149	499	1	0	1	26.1012206493
149	500	0	0	0	21.4952004653
149	501	1	0	1	38.7974426158
149	503	18	2	16	26.4821621485
149	504	6	1	5	15.6303262207
149	505	1	0	1	43.0964005211
149	506	1	0	1	51.7079065377
149	566	1	0	1	38.86699508
150	1	11	1	10	67.0503980505
150	5	1	0	1	66.241660181
150	7	1	0	1	56.6620429351
150	31	1	0	1	39.8291247574
150	32	1	0	1	63.7733311308
150	34	1	0	1	35.1823929105
150	36	13	1	12	47.4904645056
150	46	1	0	1	56.9837539683
150	48	1	0	1	38.6596013624
150	52	2	0	2	27.5523606461
150	55	1	0	1	47.5056728076
150	59	1	0	1	46.5700523404
150	60	3	0	3	39.6533242313
150	65	2	0	2	56.9613706548
150	68	1	0	1	33.6896689951
150	69	3	0	3	29.0506043714
150	70	8	4	4	52.633777327
150	71	4	0	4	42.4455749332
150	72	1	0	1	52.7672819496
150	73	166	7	159	47.1702351112
150	74	11	0	11	45.506423912
150	75	17	6	11	44.7701212292
150	76	8	0	8	50.4433770413
150	78	16	3	13	46.7178502457
150	79	5	0	5	51.0499118761
150	80	2	0	2	50.6386844602
150	81	8	0	8	50.9697356174
150	82	12	0	12	49.0006984297
150	83	9	1	8	47.3831920435
150	84	28	10	18	46.2923089587
150	85	2	0	2	47.9637690757
150	86	2	0	2	43.5840845861
150	87	11	0	11	42.9810809821
150	88	5	1	4	42.0955045318
150	89	2	1	1	58.8197923701
150	90	1	0	1	52.6283848228
150	92	3	0	3	56.8819293841
150	95	1	0	1	48.6887857271
150	96	4	0	4	57.5840882393
150	98	2	0	2	42.0913044772
150	99	1	0	1	36.3371710098
150	101	1	0	1	66.8368880648
150	103	16	1	15	42.9532756013
150	107	3	0	3	36.2177613802
150	110	3	1	2	39.7046095017
150	111	1	0	1	62.1494642595
150	112	12	0	12	44.3831779678
150	113	57	3	54	39.4132138864
150	114	1	0	1	44.5772510146
150	117	1	0	1	40.179730513
150	118	1	0	1	49.3188345628
150	120	1	0	1	52.3694408876
150	122	1	0	1	61.7254771963
150	124	9	3	6	22.4662561349
150	126	4	2	2	13.4070196534
150	128	15	4	11	19.3259984461
150	130	10	6	4	14.0880376529
150	131	25	9	16	20.1836065667
150	132	9	0	9	10.0475825149
150	133	1	1	0	32.3211331972
150	134	14	0	14	29.5031648482
150	135	16	2	14	12.5397299388
150	136	2	0	2	20.7542899342
150	137	2	0	2	30.4258997512
150	139	15	0	15	8.1559852831
150	140	4	0	4	34.0966415996
150	141	38	1	37	7.47814730825
150	142	347	7	340	24.5706728352
150	143	13	5	8	16.4598447788
150	144	4	0	4	24.9534964247
150	145	4	0	4	26.6552197406
150	146	4	1	3	36.3700036311
150	147	680	225	455	7.10894985786
150	149	44	11	33	4.45112443795
150	151	2	0	2	20.3782006447
150	152	2	0	2	15.3080593694
150	153	16	0	16	8.286866226
150	154	8	2	6	20.1226450254
150	155	1	0	1	51.0735509243
150	163	4	0	4	16.4035225866
150	172	3	0	3	33.6606885095
150	174	1	0	1	9.07095849993
150	177	2	0	2	37.5639710647
150	220	0	0	0	154.218049945
150	229	2	0	2	134.549690663
150	244	0	0	0	168.511976492
150	245	2	0	2	69.6725978792
150	246	1	0	1	69.4695891596
150	254	1	0	1	77.3229200223
150	277	2	0	2	96.467684234
150	305	1	0	1	82.3869756292
150	307	1	0	1	75.7223121635
150	319	2	0	2	61.760362712
150	329	1	0	1	62.7308077204
150	367	1	0	1	69.9821779167
150	396	1	0	1	36.0865143533
150	408	5	1	4	43.9671684531
150	411	1	0	1	42.1645302008
150	415	2	0	2	34.5954420046
150	455	0	0	0	17.3571105423
150	464	2	0	2	30.4204796133
150	465	1	0	1	28.2151465027
150	466	11	3	8	35.7058744201
150	467	2	0	2	12.8996994916
150	468	6	1	5	14.8380639114
150	469	48	4	44	22.6172621699
150	470	3	1	2	16.0873239102
150	472	3	1	2	21.7933197153
150	473	3	0	3	13.1718300491
150	475	124	3	121	11.3703955647
150	476	2	0	2	26.101070142
150	478	1	1	0	39.45047527
150	479	1	0	1	32.1822810027
150	480	2	0	2	28.1288428463
150	481	1	0	1	54.7084324955
150	485	1	0	1	55.7255647358
150	487	1	0	1	48.8485736659
150	490	1	0	1	41.2644122992
150	491	3	0	3	35.8418088835
150	494	7	1	6	18.5913623956
150	496	4	0	4	21.0792073484
150	501	1	0	1	43.1867837997
150	502	1	0	1	38.7071643449
150	503	5	0	5	30.1879993394
150	504	3	1	2	19.9153327741
150	566	1	0	1	37.1727023466
150	573	2	0	2	41.8283235825
151	0	8	0	8	43.5857586507
151	1	203	5	198	50.2190584721
151	2	1	0	1	36.6570262851
151	3	2	0	2	42.9885737817
151	4	1	0	1	39.8894025049
151	5	2	0	2	47.6100122194
151	7	1	0	1	41.3617485473
151	9	1	0	1	46.8108209103
151	12	1	0	1	52.2964751495
151	13	10	0	10	39.1989608475
151	15	23	0	23	40.5344875691
151	17	2	0	2	34.1417998558
151	18	3	1	2	39.7386680342
151	19	2	0	2	45.8772176141
151	20	2	0	2	39.4191243127
151	22	1	0	1	55.2528557981
151	23	1	0	1	40.7129814498
151	24	3	0	3	39.0475181284
151	26	2	0	2	31.154533144
151	28	2	0	2	51.616708812
151	29	3	0	3	37.3446123805
151	30	9	2	7	24.9862351897
151	31	2	0	2	27.9544897738
151	32	2	0	2	51.8858186516
151	33	7	1	6	33.5780414923
151	34	57	0	57	18.2042925604
151	35	62	2	60	30.6621708599
151	36	61	0	61	36.4280513294
151	37	1	0	1	27.2561944563
151	38	3	1	2	23.9674988345
151	39	2	0	2	46.9828674226
151	41	1	0	1	31.0708002553
151	42	1	0	1	42.4377609512
151	45	2	0	2	23.3100138262
151	46	7	0	7	36.6091847554
151	47	3	0	3	29.1178045187
151	48	122	33	89	18.7683473068
151	49	11	1	10	25.7942391671
151	50	50	12	38	20.9021444077
151	52	41	2	39	8.11712976398
151	54	18	9	9	13.0833837732
151	55	2	0	2	27.3344078641
151	56	2	0	2	30.1528561527
151	57	5	2	3	15.8607167189
151	58	1	0	1	41.9791487423
151	59	18	2	16	29.1891609507
151	60	6	2	4	19.2867727612
151	63	1	0	1	30.8627452606
151	65	17	0	17	36.8514267408
151	66	2	0	2	27.9872547277
151	67	1	0	1	34.6599909206
151	68	110	8	102	13.4885685563
151	69	43	18	25	9.58760122312
151	70	17	1	16	50.9752519048
151	71	4	0	4	42.6722433435
151	73	353	0	353	43.8428258717
151	74	27	13	14	44.2447661617
151	75	55	0	55	41.758499736
151	76	16	0	16	49.6103509624
151	77	1	0	1	48.2038710156
151	78	27	0	27	45.8592875987
151	79	8	1	7	47.1681066524
151	80	4	0	4	47.6112864371
151	81	12	1	11	48.2747489251
151	82	24	3	21	47.601367195
151	83	10	5	5	44.9656692148
151	84	40	1	39	43.5539060804
151	85	14	7	7	48.4895628736
151	86	2	0	2	44.5335270093
151	87	23	0	23	41.1876382889
151	88	14	7	7	41.2696017997
151	89	6	0	6	53.7327721752
151	90	2	0	2	54.2983484824
151	92	6	0	6	53.972100867
151	95	6	2	4	41.8921113907
151	96	2	0	2	59.5902965311
151	98	3	0	3	44.895283772
151	99	11	1	10	29.2630519452
151	100	3	0	3	42.9767394349
151	102	4	1	3	48.4640456591
151	103	30	0	30	38.2548954196
151	104	1	0	1	45.9098395979
151	107	4	2	2	39.6389643074
151	109	1	0	1	55.920337821
151	110	11	1	10	33.9848610896
151	111	1	0	1	58.487904317
151	112	40	0	40	38.2109325312
151	113	130	14	116	36.6134979715
151	114	2	0	2	35.8093303345
151	117	1	0	1	38.774699939
151	121	2	0	2	37.5717326041
151	124	576	70	506	7.35261366468
151	125	24	0	24	12.9148991078
151	126	55	0	55	7.11656302881
151	127	3	0	3	29.8399645391
151	128	19	5	14	23.4147561568
151	129	6	0	6	28.6169050414
151	130	3	0	3	20.1412431824
151	131	726	48	678	7.04770050054
151	132	4	0	4	16.4423277032
151	133	12	0	12	23.239172427
151	134	29	8	21	24.5686004974
151	136	29	7	22	13.9392236116
151	138	11	0	11	22.0115668229
151	139	9	0	9	12.2793134307
151	140	28	2	26	30.4906219337
151	141	3	0	3	27.8433918684
151	142	933	118	815	22.4776969174
151	143	40	23	17	16.2090705808
151	144	14	4	10	27.9769921685
151	145	53	0	53	17.098317439
151	146	6	1	5	36.8204336853
151	147	91	47	44	20.7947002626
151	148	24	0	24	16.9293839362
151	149	6	0	6	20.3709912587
151	150	2	0	2	20.3782006447
151	152	59	3	56	9.7187582448
151	153	2	1	1	14.6383458792
151	154	11	2	9	28.5392456407
151	155	1	0	1	56.2515424612
151	163	1	0	1	30.949248264
151	164	2	0	2	45.8095998563
151	168	1	0	1	43.7978155108
151	169	1	0	1	64.4918032957
151	171	1	0	1	51.0170789712
151	172	1	0	1	40.9907858657
151	177	1	0	1	46.2170128365
151	183	1	0	1	125.252641178
151	220	2	0	2	144.553659356
151	236	1	0	1	112.328143492
151	242	0	0	0	160.325981905
151	257	3	1	2	61.5331995862
151	259	0	0	0	76.0333749435
151	267	1	1	0	96.5444888137
151	271	1	0	1	106.912279629
151	275	1	0	1	89.5642297076
151	276	2	0	2	90.2056266848
151	277	3	2	1	87.3556647575
151	279	1	0	1	78.5901722752
151	282	0	0	0	86.0090153392
151	294	0	0	0	99.4389493991
151	303	3	0	3	58.4722143551
151	304	2	1	1	50.5227306802
151	305	2	0	2	71.5723606992
151	319	1	0	1	74.3905691955
151	348	2	0	2	74.9406906881
151	411	1	0	1	59.5733159131
151	415	1	0	1	51.9633346935
151	464	36	0	36	20.154761215
151	465	3	0	3	32.8886346371
151	466	45	0	45	37.0162658712
151	468	29	1	28	10.2973736457
151	469	170	39	131	24.7901886702
151	470	21	2	19	16.1340884814
151	471	21	0	21	23.7568546248
151	472	31	3	28	15.0313046794
151	475	30	9	21	26.5707070592
151	476	124	7	117	9.47411302908
151	477	4	0	4	28.5728213724
151	478	1	0	1	43.1191659567
151	479	12	1	11	17.6108386359
151	480	22	0	22	22.5909810324
151	482	1	0	1	49.079412055
151	484	3	1	2	34.3910843972
151	485	1	0	1	53.1417676143
151	487	5	1	4	37.2328452832
151	488	14	3	11	37.3868018494
151	490	0	0	0	30.6797497521
151	491	15	0	15	31.2296172914
151	493	3	0	3	52.2042401044
151	494	2	0	2	26.201689712
151	495	2	0	2	42.0108790445
151	499	1	0	1	39.212736478
151	501	2	0	2	48.6106395057
151	503	4	0	4	42.9390772434
151	504	1	0	1	30.2960837821
151	505	0	0	0	49.766527346
151	507	1	0	1	158.376275493
151	573	4	0	4	60.1828179159
152	0	2	0	2	42.7917425714
152	1	38	2	36	51.753173889
152	2	1	0	1	37.8327407248
152	3	1	0	1	41.2503278876
152	5	2	0	2	51.087033108
152	7	1	0	1	41.5023816654
152	15	1	0	1	41.3318805334
152	16	1	0	1	44.259421313
152	17	1	0	1	36.810574901
152	18	1	0	1	38.2980051758
152	23	1	0	1	43.1707009798
152	30	1	0	1	26.4735408393
152	31	4	0	4	25.2605487193
152	32	2	0	2	49.5864787099
152	33	2	0	2	32.9178381761
152	34	21	0	21	19.9515640832
152	35	7	2	5	31.3032291078
152	36	29	0	29	33.37656846
152	39	1	0	1	44.3022656212
152	41	2	0	2	29.5806856611
152	42	1	0	1	39.7233630686
152	46	2	0	2	43.7862387978
152	47	3	0	3	38.7309986463
152	48	8	0	8	27.7358362778
152	50	9	1	8	27.1765785487
152	52	5	3	2	13.821082725
152	54	2	0	2	16.5924366107
152	59	2	1	1	38.8776430612
152	60	4	1	3	26.7152607278
152	65	3	0	3	45.2082116568
152	66	1	1	0	33.8545838794
152	68	9	0	9	20.3865035635
152	69	1	0	1	19.1307076565
152	70	11	2	9	43.6456192418
152	71	6	0	6	34.5545392055
152	73	163	32	131	36.9871478601
152	74	11	0	11	36.6400118615
152	75	35	0	35	34.726663063
152	76	8	1	7	41.9747008243
152	78	22	0	22	38.1563812754
152	79	3	0	3	40.6093810212
152	81	7	0	7	41.2716735802
152	82	14	2	12	40.1172871587
152	83	3	1	2	37.7880429832
152	84	19	5	14	36.4631121299
152	85	5	0	5	40.4083108163
152	86	1	0	1	36.2497120212
152	87	12	0	12	33.6893987103
152	88	5	0	5	33.4447217783
152	89	2	0	2	47.802211365
152	90	1	0	1	45.9899797853
152	92	4	0	4	47.1521424
152	95	6	0	6	36.5323167593
152	96	1	0	1	51.2609040426
152	97	1	0	1	64.4049374893
152	98	1	0	1	36.143487045
152	99	12	0	12	23.6318497754
152	100	3	1	2	38.9989799473
152	102	4	0	4	44.5097040002
152	103	32	0	32	31.8177860595
152	104	1	0	1	40.9326029867
152	107	2	0	2	30.6394978383
152	109	2	1	1	48.1954259924
152	110	5	1	4	27.8690614789
152	112	32	2	30	32.4500546591
152	113	106	0	106	29.3442117278
152	114	5	0	5	31.3435910672
152	115	1	0	1	56.8932142202
152	117	2	0	2	31.0714612616
152	120	5	0	5	41.2054042007
152	121	3	0	3	29.7300345793
152	124	206	0	206	7.63205934573
152	125	12	6	6	12.1682720218
152	126	27	15	12	5.83184245196
152	127	8	0	8	21.5624898697
152	128	52	0	52	13.7824375571
152	129	8	0	8	24.3554246514
152	130	13	1	12	10.501474329
152	131	91	59	32	14.8830299508
152	132	1	0	1	16.8285069465
152	133	16	0	16	18.4635295211
152	134	27	6	21	17.5894950765
152	135	5	0	5	16.1092670511
152	136	30	11	19	6.67931805276
152	137	7	1	6	24.9071084918
152	138	5	1	4	19.2571087117
152	139	2	2	0	9.48923795605
152	140	20	5	15	23.2870743236
152	141	3	0	3	22.0525522061
152	142	1078	513	565	14.1419233373
152	143	121	36	85	6.62226853361
152	144	8	0	8	18.679872469
152	145	33	7	26	12.2016534246
152	146	10	1	9	28.4716511421
152	147	153	0	153	12.8022566076
152	148	5	0	5	14.5814397495
152	149	3	0	3	17.3929240578
152	150	4	0	4	15.3080593694
152	151	27	1	26	9.7187582448
152	153	10	0	10	7.28367071045
152	154	4	0	4	18.823291812
152	156	1	1	0	50.8781869796
152	163	1	0	1	21.8429104052
152	164	2	0	2	36.7867075197
152	172	3	1	2	31.4239930967
152	173	1	0	1	41.8301457627
152	177	0	0	0	36.5845754082
152	183	0	0	0	122.563151595
152	208	1	0	1	115.397462734
152	212	1	0	1	104.933248873
152	220	1	0	1	141.339217047
152	229	1	0	1	123.598441422
152	240	1	0	1	155.586123486
152	242	0	0	0	156.315436085
152	243	1	0	1	150.611573675
152	257	1	0	1	57.6297110126
152	260	2	0	2	55.0215816032
152	277	8	1	7	83.6759420731
152	304	2	0	2	49.6908212749
152	307	2	0	2	61.2998110174
152	319	1	0	1	64.6726769894
152	415	1	0	1	49.6575859726
152	444	1	0	1	78.788826296
152	464	2	0	2	28.5385455285
152	465	3	1	2	36.5433589087
152	466	15	0	15	42.2138647677
152	467	0	0	0	28.2020390445
152	468	6	1	5	14.1719802257
152	469	36	1	35	28.8870804826
152	470	5	0	5	19.7717224005
152	471	3	0	3	32.8399521903
152	472	2	0	2	21.6191609741
152	474	1	0	1	49.0020571281
152	475	11	1	10	24.9086704713
152	476	6	0	6	18.9847819951
152	479	1	0	1	27.0063706519
152	480	3	1	2	29.537890474
152	484	1	0	1	43.9652844179
152	485	2	0	2	60.1257632331
152	487	2	0	2	46.4178671771
152	488	2	0	2	45.6329908373
152	491	4	1	3	38.3330278779
152	495	2	0	2	45.0508890987
152	501	1	0	1	52.5106441162
152	503	1	0	1	43.2901352934
152	505	2	0	2	54.9784535684
152	573	1	0	1	51.5222495995
153	0	1	0	1	49.4240142116
153	1	11	0	11	58.8549190264
153	5	1	0	1	58.3668486194
153	13	1	0	1	45.4282980743
153	33	1	0	1	39.6991314145
153	34	4	0	4	27.2247457302
153	35	3	0	3	38.3741013028
153	36	10	2	8	39.3274914271
153	40	1	0	1	54.3400034946
153	41	2	0	2	36.186615214
153	42	1	0	1	45.7021386354
153	46	1	1	0	50.5296316107
153	48	2	1	1	33.402543279
153	50	4	0	4	34.0967282644
153	59	1	0	1	43.1873043
153	60	1	0	1	33.273828387
153	65	2	0	2	51.3789357548
153	70	6	2	4	46.2945772081
153	71	2	0	2	36.4611514915
153	73	114	0	114	40.2977420629
153	74	7	0	7	39.1488380955
153	75	9	1	8	37.9290687912
153	77	0	0	0	44.928032932
153	78	12	0	12	40.5019812042
153	79	8	0	8	44.1081749659
153	81	4	0	4	44.3231900503
153	82	4	0	4	42.6729995092
153	83	1	0	1	40.7465435828
153	84	11	0	11	39.5511506451
153	85	2	0	2	42.1971492971
153	86	2	0	2	37.8589477909
153	87	6	1	5	36.418689838
153	88	4	2	2	35.7843511684
153	89	2	0	2	51.7000839673
153	92	1	0	1	50.2648766006
153	95	3	0	3	41.1022931446
153	96	1	0	1	52.4705812677
153	98	2	0	2	36.9700668462
153	99	3	0	3	28.4918880742
153	101	1	0	1	60.115283808
153	102	1	0	1	49.8004024645
153	103	13	1	12	35.6831784755
153	105	1	0	1	50.1427826843
153	107	2	0	2	31.1517508501
153	109	1	0	1	50.2885707171
153	110	1	0	1	32.1608229097
153	112	5	1	4	36.8454273791
153	113	34	2	32	32.4983950053
153	120	1	0	1	45.1595340929
153	124	23	2	21	14.8118545328
153	125	1	0	1	19.3897668386
153	126	11	6	5	7.75236854944
153	127	3	1	2	23.8927332149
153	128	17	5	12	13.4325410416
153	129	1	0	1	30.0068640042
153	130	13	1	12	8.28002305618
153	131	32	0	32	17.145844957
153	132	2	0	2	13.0374427637
153	133	1	0	1	24.1618328551
153	134	15	2	13	21.7987664858
153	135	33	6	27	11.0467239278
153	136	2	0	2	12.4814496339
153	137	1	0	1	25.2213720594
153	138	3	1	2	25.7707318535
153	139	25	1	24	5.93115488344
153	140	5	0	5	26.8296920958
153	141	11	0	11	14.7711068491
153	142	305	45	260	17.1791088508
153	143	37	10	27	8.64382282285
153	144	5	0	5	19.1686746996
153	145	4	0	4	18.3835409141
153	146	6	1	5	30.2764964838
153	147	537	211	326	6.15639905949
153	148	1	0	1	21.4410469099
153	149	3	0	3	11.2294493171
153	150	5	1	4	8.286866226
153	151	7	2	5	14.6383458792
153	152	18	11	7	7.28367071045
153	154	9	2	7	16.4603471259
153	155	1	0	1	47.0561969177
153	163	1	0	1	16.6489153746
153	171	1	0	1	42.1846893667
153	172	1	0	1	30.1696612579
153	174	1	0	1	13.4042015379
153	177	1	0	1	34.8306614987
153	183	1	0	1	128.065832733
153	229	1	0	1	127.608071339
153	244	0	0	0	161.305443958
153	245	1	0	1	62.3724666947
153	251	1	0	1	66.4951261681
153	277	2	0	2	88.7732315325
153	319	1	0	1	61.4768887086
153	415	2	0	2	42.8760772353
153	464	2	0	2	29.835934401
153	465	0	0	0	33.2026577349
153	466	6	0	6	39.8406846749
153	468	2	0	2	13.7304461548
153	469	18	1	17	26.290333781
153	470	2	1	1	17.8231443713
153	472	3	1	2	21.7326679527
153	474	1	0	1	47.6428073182
153	475	21	0	21	18.8873817343
153	476	3	0	3	22.5205615237
153	480	1	0	1	29.2728096703
153	491	1	0	1	37.7967804917
153	496	1	0	1	28.3531305604
153	499	2	0	2	36.8024005846
153	503	2	1	1	37.699401307
153	565	1	0	1	113.123308731
153	573	1	0	1	45.5488553961
153	576	1	0	1	45.0612995521
154	1	6	0	6	59.7847534014
154	5	1	0	1	62.1488443393
154	32	2	0	2	50.9796737327
154	36	1	0	1	35.7117964895
154	68	2	0	2	37.654773709
154	70	17	0	17	33.6729655468
154	71	21	0	21	23.2591108043
154	73	227	27	200	29.3954072315
154	74	32	6	26	26.7708572827
154	75	49	0	49	27.0380135498
154	76	11	0	11	31.2502908702
154	78	45	1	44	27.7224127638
154	79	5	0	5	33.2804801308
154	80	2	0	2	32.4307333312
154	81	14	1	13	32.5706883869
154	82	11	0	11	30.1096844182
154	83	12	0	12	29.0869134354
154	84	56	6	50	28.2584926845
154	85	10	1	9	28.3995320706
154	86	11	0	11	24.0632154935
154	87	102	1	101	24.7287915954
154	88	24	1	23	23.4172352519
154	89	2	0	2	41.2437460762
154	90	4	0	4	32.6800337018
154	92	1	0	1	38.2787719654
154	95	4	1	3	33.0781917823
154	96	1	0	1	37.5368965025
154	97	0	0	0	51.570668669
154	98	1	0	1	22.1350023269
154	99	1	0	1	23.2934466733
154	102	2	0	2	43.0529216482
154	103	24	0	24	26.5565169704
154	104	1	0	1	37.6447484173
154	107	4	0	4	16.3142454492
154	109	1	0	1	36.5777694843
154	110	8	0	8	24.6565357168
154	111	4	2	2	43.6798217595
154	112	13	0	13	28.8702948369
154	113	54	0	54	22.2292892696
154	116	3	0	3	32.1004595391
154	119	4	1	3	27.717435296
154	121	1	0	1	20.5239637269
154	124	0	0	0	24.6956988911
154	127	0	0	0	13.8970437436
154	128	6	3	3	6.01235972217
154	133	1	0	1	22.63143241
154	134	4	0	4	17.1129252272
154	135	2	1	1	7.8571695841
154	137	1	1	0	10.8468901431
154	139	1	0	1	22.343912924
154	140	5	0	5	18.6885123179
154	142	100	0	100	12.5028179266
154	143	2	0	2	12.6165880291
154	144	7	0	7	7.33131149014
154	146	4	0	4	17.6324807302
154	147	4	1	3	13.0782238528
154	155	8	0	8	31.042837112
154	156	1	0	1	35.4911060331
154	157	12	0	12	11.1830618528
154	158	6	1	5	21.899157701
154	159	1	0	1	28.5215473751
154	160	29	0	29	6.2059157275
154	161	6	2	4	8.65222561782
154	163	52	3	49	8.5731192608
154	164	7	5	2	21.5550782791
154	165	3	0	3	18.3600012308
154	166	11	0	11	36.4107932629
154	167	4	0	4	15.8840577122
154	168	23	2	21	17.9090357777
154	169	1	1	0	41.5320718067
154	171	15	1	14	26.4658844165
154	172	177	47	130	13.8020324518
154	173	5	1	4	23.0292239488
154	174	5	4	1	15.6516880584
154	175	3	0	3	23.7427418133
154	176	2	0	2	16.9528760074
154	177	90	48	42	18.3743075193
154	178	1	0	1	15.7914044269
154	180	2	0	2	16.8013056692
154	256	1	1	0	47.5643884851
154	277	1	0	1	80.0525564243
154	281	1	0	1	72.2444699431
154	319	6	0	6	45.8524781552
154	323	1	0	1	35.9362298551
154	328	1	0	1	39.7719241467
154	329	3	0	3	43.5326895659
154	334	1	0	1	75.4481655659
154	338	2	0	2	66.5271038474
154	353	0	0	0	56.271462499
154	367	2	0	2	51.8548999122
154	392	1	0	1	39.5423275844
154	396	1	0	1	53.220393323
154	406	1	0	1	60.2028846158
154	408	5	0	5	60.3451904471
154	410	1	0	1	55.9924087123
154	414	1	0	1	65.0659649181
154	415	1	0	1	49.947097367
154	427	1	0	1	74.0192502561
154	442	2	0	2	80.5354137719
154	454	0	0	0	31.651845005
154	455	0	0	0	24.9364399247
154	466	1	0	1	55.4925808476
154	470	1	0	1	34.1043774874
154	471	1	0	1	50.9884160267
154	496	2	0	2	40.63986784
154	503	1	0	1	49.2151982074
154	505	1	0	1	67.5845270412
154	524	2	0	2	75.1848407133
154	551	0	0	0	50.9669228145
154	554	0	0	0	61.7678986635
154	563	0	0	0	51.6668994045
154	568	0	0	0	22.9591216025
154	573	17	0	17	35.9263624237
154	579	1	0	1	34.4203984521
154	581	2	0	2	24.9763579662
154	585	1	0	1	58.8575593199
155	1	17	3	14	64.7355405886
155	7	3	1	2	53.9976014632
155	12	1	0	1	73.7411038922
155	13	1	0	1	50.496052124
155	16	1	0	1	48.2927014998
155	20	1	0	1	66.7538365101
155	32	4	0	4	47.604163962
155	36	6	0	6	40.0904586
155	39	2	1	1	43.8008421803
155	46	1	0	1	78.4885694003
155	50	1	0	1	63.8515178319
155	65	1	0	1	83.6480221274
155	68	1	0	1	60.7425780645
155	70	394	2	392	17.8545095732
155	71	137	0	137	16.3136694109
155	72	32	0	32	21.7137103604
155	73	1894	58	1836	22.2624648061
155	74	217	19	198	17.9789674453
155	75	142	0	142	22.1130858304
155	76	196	0	196	15.8097788119
155	77	21	0	21	22.5946691786
155	78	441	0	441	16.6450680222
155	79	37	6	31	23.3011774524
155	80	14	0	14	21.2129505861
155	81	150	6	144	20.3933846235
155	82	214	0	214	17.3846329468
155	83	73	3	70	20.1055090076
155	84	223	0	223	21.0895555976
155	85	515	77	438	12.9707642743
155	86	157	17	140	14.1563635066
155	87	256	0	256	20.1590414517
155	88	90	0	90	18.6176634105
155	89	16	0	16	27.8086291401
155	90	41	2	39	9.35193663775
155	92	20	6	14	21.7529039139
155	94	1	0	1	21.8139626266
155	95	13	1	12	30.2247312174
155	96	21	8	13	10.1778397756
155	98	8	0	8	11.8707614431
155	99	2	0	2	33.1326517679
155	102	2	0	2	37.9194926955
155	103	56	3	53	26.2760154137
155	104	2	1	1	32.1355550973
155	105	1	0	1	31.8325565786
155	107	10	3	7	16.6153637366
155	109	18	0	18	14.872876909
155	110	9	2	7	29.3761093913
155	111	11	2	9	25.6045405012
155	112	24	0	24	29.1160492158
155	113	154	3	151	23.8993752766
155	114	1	0	1	34.7578995312
155	116	44	9	35	13.7696349437
155	117	6	3	3	20.8369565786
155	118	20	4	16	10.5456944913
155	119	65	48	17	8.03900180161
155	120	9	1	8	26.4801549215
155	121	2	0	2	21.2233577057
155	122	1	0	1	20.5727988901
155	123	1	0	1	30.6855686808
155	131	0	0	0	62.0507904727
155	134	1	0	1	33.4375749571
155	135	1	0	1	38.5590814308
155	138	0	0	0	42.4929129336
155	140	5	1	4	28.4062385555
155	142	25	2	23	33.9063379173
155	145	1	0	1	41.4415307132
155	146	10	1	9	20.3645118712
155	147	0	0	0	44.1023230854
155	148	1	0	1	44.6830930943
155	154	4	0	4	31.042837112
155	156	105	37	68	5.02892261471
155	157	4	0	4	23.7177849265
155	158	23	1	22	15.5505456674
155	159	28	1	27	10.0211520154
155	160	7	7	0	24.9170800446
155	161	2	0	2	30.207552631
155	162	27	1	26	7.6583482275
155	163	5	0	5	36.1368986488
155	164	79	23	56	10.449256968
155	165	8	0	8	19.3589643388
155	166	413	14	399	8.63733326628
155	167	2	0	2	30.9809026363
155	168	121	1	120	13.1477732043
155	169	71	10	61	11.7249784325
155	170	5	0	5	17.3055712278
155	171	801	641	160	5.31574849733
155	172	151	22	129	17.4537204762
155	173	7	1	6	21.1229182817
155	175	95	21	74	7.602069635
155	176	1	0	1	42.9244926867
155	177	137	24	113	14.7655510075
155	179	5	1	4	15.8226655839
155	180	1	0	1	24.6044887288
155	183	2	0	2	101.647165173
155	186	1	0	1	93.1887218406
155	188	0	0	0	99.3570969508
155	190	1	0	1	103.38367678
155	209	1	0	1	78.9887345806
155	242	1	0	1	126.982603989
155	245	3	0	3	36.2718720411
155	251	3	0	3	29.9243853126
155	271	1	0	1	78.1258706695
155	276	1	0	1	54.9670588479
155	277	6	0	6	62.7778429719
155	281	0	0	0	53.2388447989
155	282	1	0	1	54.6125645816
155	291	2	0	2	68.6077263828
155	293	3	0	3	55.3779647589
155	307	1	0	1	57.3239552844
155	310	5	1	4	41.2035266861
155	312	1	0	1	51.8890816827
155	313	1	0	1	35.2942268869
155	318	1	0	1	23.9229634604
155	319	178	4	174	28.6176406844
155	320	2	0	2	32.9220324575
155	321	6	0	6	22.3548039668
155	322	1	0	1	29.8379855261
155	323	10	1	9	24.5378699388
155	324	2	1	1	29.6731399895
155	326	5	1	4	21.6285484355
155	327	5	0	5	33.0534081633
155	328	2	1	1	17.8315058656
155	329	51	25	26	15.375556721
155	331	2	1	1	17.4667831387
155	332	4	0	4	47.8496621074
155	333	1	0	1	51.2104347681
155	334	6	1	5	45.7173111961
155	338	33	4	29	36.5367753352
155	339	2	0	2	43.7623844398
155	340	1	0	1	55.4895915321
155	341	4	1	3	44.2522333358
155	345	1	0	1	78.0633827265
155	347	4	0	4	16.2669615454
155	348	5	1	4	22.8922318447
155	349	27	0	27	26.2661954015
155	350	8	1	7	37.0160995119
155	352	1	0	1	28.0381729005
155	353	9	4	5	25.3100993355
155	355	1	1	0	30.6484273802
155	357	1	0	1	31.9960749976
155	359	1	0	1	43.8399772603
155	361	2	0	2	36.204773814
155	364	0	0	0	38.9503137335
155	367	2	0	2	26.3205973787
155	371	1	0	1	75.1675240191
155	375	6	1	5	67.0811486161
155	379	1	0	1	68.8420762514
155	392	1	0	1	61.0551351818
155	394	1	0	1	74.0963954984
155	403	1	0	1	99.0671375424
155	406	4	0	4	88.2331112751
155	408	10	1	9	87.2632462953
155	410	1	0	1	82.7459788426
155	411	0	0	0	82.4451862173
155	412	0	0	0	97.1694710452
155	413	1	0	1	94.17667002
155	441	0	0	0	104.87470036
155	450	2	0	2	56.4188681328
155	455	1	0	1	50.6484875053
155	456	1	0	1	47.7017889313
155	465	0	0	0	79.2698878975
155	469	1	0	1	73.0862560389
155	472	0	0	0	68.3389296663
155	474	0	0	0	94.6682296055
155	475	0	0	0	61.6173496679
155	484	0	0	0	90.4455089057
155	485	0	0	0	106.005599196
155	491	0	0	0	84.7785125638
155	493	0	0	0	103.501905194
155	495	0	0	0	85.8185634494
155	501	1	0	1	94.1069967975
155	503	1	0	1	78.891871507
155	505	0	0	0	98.6054018787
155	507	2	0	2	151.104534542
155	512	1	0	1	123.774367355
155	515	1	0	1	116.351494957
155	524	1	0	1	87.0073346695
155	535	1	0	1	119.354109118
155	537	1	0	1	99.6886231444
155	540	1	0	1	110.864672699
155	551	0	0	0	50.9163175079
155	554	0	0	0	70.5037517463
155	555	1	1	0	62.9142838532
155	563	4	1	3	56.7187942175
155	566	1	0	1	53.8194772283
155	569	4	2	2	38.8062056015
155	571	0	0	0	56.7125783038
155	573	41	12	29	43.5751494547
155	577	1	0	1	31.459358256
155	579	2	0	2	31.9049801198
155	581	11	0	11	28.2939162014
155	585	1	0	1	50.6018145152
155	587	1	0	1	45.5921564464
156	1	6	0	6	64.3387421715
156	17	1	0	1	60.9846912925
156	24	1	0	1	60.8940231061
156	36	1	0	1	40.5322628183
156	39	1	0	1	42.9826914004
156	70	166	16	150	16.6202793771
156	71	27	0	27	18.1162623971
156	72	11	0	11	20.5904202501
156	73	390	4	386	22.4446119532
156	74	40	1	39	18.7383711582
156	75	30	8	22	22.8320640154
156	76	61	0	61	15.2187671007
156	77	4	0	4	21.7337443601
156	78	94	25	69	17.1590292995
156	79	28	3	25	22.6270503435
156	80	7	0	7	20.5875410835
156	81	52	1	51	19.6720154604
156	82	39	1	38	17.1984698364
156	83	22	1	21	20.2790770414
156	84	43	4	39	21.4976614851
156	85	109	11	98	13.4067286437
156	86	22	0	22	15.9651807044
156	87	48	4	44	21.396585657
156	88	15	0	15	20.2167623551
156	89	3	0	3	25.7734033066
156	90	22	0	22	7.96957512592
156	92	5	1	4	19.6329967825
156	95	2	1	1	30.1841566385
156	96	26	22	4	6.16130991976
156	102	1	0	1	36.8137221729
156	103	5	3	2	27.236240293
156	107	1	0	1	20.2620247792
156	108	1	0	1	11.9994798427
156	109	16	4	12	12.3069977284
156	110	8	1	7	30.8191885234
156	111	1	0	1	22.6739441789
156	112	8	0	8	29.7926489626
156	113	43	1	42	25.636264656
156	116	20	9	11	12.7993928183
156	118	2	0	2	10.7267554115
156	119	14	0	14	9.59334289998
156	120	3	0	3	25.6402167705
156	122	1	0	1	17.1076803104
156	140	1	0	1	30.7814393243
156	142	4	1	3	37.2441859384
156	145	1	0	1	44.2789232015
156	154	2	2	0	35.4911060331
156	155	348	54	294	5.02892261471
156	158	3	0	3	20.5050265413
156	159	5	2	3	14.3837644138
156	162	27	1	26	4.53744305404
156	163	1	0	1	40.9472389348
156	164	17	11	6	14.2010631732
156	165	4	0	4	24.3796483189
156	166	82	10	72	9.8017167567
156	168	17	0	17	17.6186091078
156	169	77	0	77	6.69777392054
156	170	3	0	3	21.5260792683
156	171	130	3	127	9.05431545624
156	172	24	3	21	22.1439208387
156	173	1	0	1	25.9525888952
156	175	14	0	14	12.5163464184
156	177	18	11	7	19.7670341708
156	179	3	0	3	10.8794208646
156	183	1	0	1	97.35343927
156	245	1	0	1	33.1418337819
156	251	1	0	1	25.5284019464
156	252	1	0	1	40.0654431831
156	277	0	0	0	58.8625454642
156	291	1	0	1	63.8312247552
156	294	0	0	0	48.2815132049
156	303	1	0	1	63.7083849915
156	307	1	0	1	55.3403338459
156	310	4	1	3	36.3245690037
156	319	35	5	30	30.6671152579
156	320	1	0	1	35.652329124
156	321	1	0	1	23.3899049894
156	323	3	0	3	28.0523477248
156	326	1	0	1	20.9620905686
156	327	1	0	1	34.2994645788
156	328	1	0	1	19.6759364545
156	329	18	0	18	14.7284964647
156	331	5	0	5	20.4733651057
156	332	0	0	0	44.292734964
156	338	8	0	8	33.5422090751
156	341	1	0	1	40.2803956883
156	347	2	0	2	12.2348854056
156	348	1	0	1	17.9084066075
156	349	4	1	3	24.6384159408
156	350	2	0	2	31.9883542306
156	351	1	1	0	22.9181566804
156	353	6	1	5	21.4519696535
156	355	1	0	1	30.7299190552
156	361	1	0	1	36.146119515
156	364	1	0	1	39.5802503076
156	375	3	1	2	62.1954427501
156	385	0	0	0	68.9896094193
156	392	0	0	0	66.0697333874
156	408	2	0	2	92.2696572276
156	415	1	1	0	81.5812438904
156	419	1	0	1	101.194792838
156	426	0	0	0	130.100313994
156	438	1	0	1	114.164878912
156	441	0	0	0	109.902420728
156	444	0	0	0	116.671354097
156	455	1	0	1	55.6383668796
156	469	0	0	0	77.3966480761
156	475	1	0	1	66.2824474286
156	540	1	0	1	114.853328571
156	563	0	0	0	60.9211226101
156	573	4	0	4	48.1936662906
156	576	1	0	1	28.1975022936
156	577	2	0	2	35.1901298237
156	579	1	0	1	36.0771889216
156	581	1	0	1	33.0739470896
156	585	3	1	2	53.3657032667
157	0	1	0	1	53.981589129
157	1	2	1	1	66.8809520835
157	2	1	0	1	54.6004319921
157	13	1	0	1	51.5311775493
157	19	1	0	1	54.2266828556
157	21	1	0	1	65.447476802
157	23	1	0	1	61.5481378885
157	34	1	0	1	42.8829313609
157	35	1	0	1	48.6563450752
157	36	3	0	3	41.5623788417
157	39	1	0	1	50.0435671603
157	42	2	0	2	46.6452901039
157	70	54	0	54	32.1168640161
157	71	51	9	42	22.4152506227
157	72	3	1	2	34.1807187472
157	73	429	80	349	30.3093513132
157	74	67	13	54	26.3964268063
157	75	39	0	39	28.3098801733
157	76	21	0	21	29.3945627944
157	77	5	0	5	33.9430362441
157	78	119	69	50	26.6903130297
157	79	13	2	11	33.7968830491
157	80	2	0	2	32.3582944524
157	81	30	3	27	32.1673449432
157	82	22	0	22	29.0305508618
157	83	20	3	17	29.2217546479
157	84	67	9	58	28.917925012
157	85	46	2	44	25.8335888114
157	86	38	13	25	22.1764740045
157	87	116	0	116	25.5238011234
157	88	36	9	27	23.6549165636
157	89	3	0	3	41.4177998003
157	90	2	0	2	28.26062207
157	92	3	1	2	37.0639256229
157	95	5	0	5	36.1612216542
157	96	3	1	2	32.2413448147
157	97	1	0	1	46.232701942
157	98	7	1	6	18.7676948002
157	103	10	0	10	29.5816099047
157	104	1	0	1	40.2848958598
157	107	14	1	13	14.5252975881
157	109	2	0	2	33.3022987984
157	110	2	0	2	29.2994141379
157	111	1	0	1	42.3722179278
157	112	14	2	12	32.5066778375
157	113	59	0	59	25.0145399071
157	116	5	1	4	29.3545924034
157	117	4	0	4	23.4101113012
157	118	1	0	1	25.9025091417
157	119	2	0	2	23.2002605213
157	120	3	0	3	36.4762612938
157	121	5	0	5	22.2437228069
157	124	0	0	0	35.7274927715
157	134	2	0	2	25.0540150882
157	135	1	0	1	16.5998748072
157	137	2	0	2	12.6872168992
157	140	3	0	3	24.116030696
157	142	15	3	12	21.7207180729
157	143	1	0	1	23.7557213935
157	145	1	1	0	30.4401754988
157	146	7	1	6	18.9858420026
157	147	2	1	1	22.4757091984
157	154	3	0	3	11.1830618528
157	155	26	0	26	23.7177849265
157	156	2	1	1	28.6561622738
157	158	16	3	13	11.2704277682
157	159	3	1	2	18.6260226649
157	160	50	45	5	6.81727292308
157	161	10	1	9	6.54100973101
157	162	2	0	2	30.9250446559
157	163	21	2	19	12.8037718341
157	164	31	1	30	16.8106394697
157	165	17	0	17	7.28711708849
157	166	28	2	26	27.1981333591
157	167	18	0	18	9.14359344266
157	168	97	1	96	12.208482735
157	169	5	0	5	35.2375387263
157	170	4	0	4	18.0465854751
157	171	25	0	25	20.3784078007
157	172	435	21	414	7.56552996767
157	173	4	0	4	11.8614465959
157	175	5	1	4	16.1403168704
157	176	4	2	2	19.2174238279
157	177	287	12	275	9.10284340017
157	179	1	0	1	39.5254535098
157	180	9	4	5	6.24226588157
157	242	0	0	0	148.510411749
157	252	1	1	0	63.3623004243
157	253	0	0	0	65.4055794242
157	277	2	0	2	80.2615037898
157	281	0	0	0	71.6346078424
157	318	1	0	1	37.8813425902
157	319	21	4	17	34.6877068271
157	320	2	0	2	34.3814357819
157	323	4	0	4	24.758513987
157	327	1	0	1	41.2910189337
157	329	5	2	3	33.9178255247
157	338	1	0	1	57.0861201576
157	347	0	0	0	39.4534277274
157	349	4	0	4	44.580313279
157	350	3	0	3	60.475879709
157	351	0	0	0	45.8497959838
157	365	0	0	0	54.0052236045
157	367	1	0	1	41.3306243011
157	375	1	0	1	90.7950523782
157	385	1	0	1	42.5311497581
157	392	1	0	1	38.8984291464
157	406	1	0	1	64.5536239343
157	408	12	0	12	63.7484367349
157	415	3	0	3	53.0703033451
157	417	1	0	1	53.889470315
157	441	0	0	0	81.9705439484
157	442	1	0	1	83.7526239975
157	455	3	0	3	27.0674089125
157	465	1	0	1	56.8605640142
157	466	0	0	0	64.528772081
157	471	1	0	1	61.9027333774
157	480	1	0	1	56.0183791585
157	516	1	0	1	96.5112539588
157	520	0	0	0	67.0831274584
157	524	1	0	1	70.4577008161
157	540	0	0	0	97.4334793954
157	548	0	0	0	139.130743675
157	551	0	0	0	41.8352521975
157	554	0	0	0	55.6104172389
157	555	1	0	1	51.8673052711
157	557	1	0	1	50.2528586482
157	564	1	0	1	55.5647548087
157	566	3	0	3	34.1984438095
157	567	1	0	1	40.7309399316
157	568	1	0	1	18.1891432965
157	569	2	0	2	28.4299822616
157	573	70	6	64	28.3046177385
157	576	2	0	2	18.9009094387
157	577	2	0	2	27.2243326046
157	579	4	2	2	23.9781260967
157	580	1	0	1	19.4252915396
157	581	19	14	5	14.8322079581
157	585	2	0	2	48.38608164
158	1	2	0	2	71.1189889682
158	13	1	0	1	55.9210226139
158	39	1	0	1	52.0947115417
158	70	41	4	37	29.452592934
158	71	28	0	28	22.2210191078
158	72	2	0	2	32.5474842896
158	73	291	22	269	30.4183381165
158	74	33	0	33	25.8307342625
158	75	25	11	14	29.0651558241
158	76	18	5	13	26.7784805124
158	77	4	1	3	32.8253107142
158	78	75	67	8	25.3897018207
158	79	7	0	7	33.0718511398
158	80	1	0	1	31.2048257656
158	81	18	2	16	30.6983050202
158	82	21	0	21	27.2923172202
158	83	14	0	14	28.705781948
158	84	38	7	31	28.9750802253
158	85	48	0	48	23.0393202874
158	86	37	1	36	20.9407052781
158	87	62	1	61	26.2928983111
158	88	17	3	14	24.2602746838
158	90	2	0	2	22.9633515932
158	92	3	0	3	34.2295921359
158	95	2	0	2	37.7315670914
158	96	2	0	2	25.4886765135
158	97	1	0	1	38.5861759476
158	98	2	0	2	16.8990321711
158	100	1	0	1	44.4224634155
158	103	8	3	5	31.8303379079
158	107	8	0	8	16.2431028877
158	109	2	0	2	28.6605977667
158	111	2	0	2	39.0184718946
158	112	7	1	6	34.9768099988
158	113	37	0	37	27.7551934043
158	114	1	0	1	39.8797916616
158	116	6	1	5	25.779559834
158	117	1	0	1	25.1907222275
158	118	1	0	1	21.9371515802
158	119	5	0	5	18.6872345984
158	121	2	0	2	24.5849722072
158	135	1	1	0	27.8682863895
158	136	0	0	0	37.6910605718
158	137	0	0	0	18.4922502029
158	140	3	0	3	29.2961773737
158	142	4	1	3	30.1756783297
158	145	0	0	0	38.9192064397
158	146	4	1	3	21.8692168538
158	147	1	1	0	33.7435637238
158	154	3	0	3	21.899157701
158	155	65	0	65	15.5505456674
158	156	6	2	4	20.5050265413
158	157	8	0	8	11.2704277682
158	159	36	0	36	7.73142843869
158	160	11	0	11	16.1904569387
158	161	0	0	0	17.4186986191
158	162	1	0	1	21.5841647172
158	163	5	2	3	23.8502298103
158	164	19	1	18	14.0167095274
158	165	32	11	21	4.45958011869
158	166	67	2	65	16.5888886834
158	167	7	0	7	16.0522991339
158	168	112	3	109	10.8102875013
158	169	8	0	8	27.1693090224
158	170	12	2	10	7.55195948009
158	171	54	31	23	14.5404843681
158	172	221	0	221	10.1700737879
158	173	12	1	11	5.95427213432
158	175	24	16	8	9.44448444163
158	176	1	0	1	29.1223790915
158	177	455	67	388	4.87789647528
158	178	1	0	1	23.0613938786
158	179	1	0	1	30.8913481553
158	180	4	1	3	9.52102213808
158	183	0	0	0	116.439082127
158	199	1	0	1	108.006401154
158	222	0	0	0	127.361028451
158	251	1	0	1	45.111954749
158	277	1	0	1	77.0510079357
158	313	1	0	1	49.1504488575
158	319	44	0	44	24.5767815966
158	320	7	2	5	25.6703248959
158	321	1	0	1	23.2059059754
158	323	5	0	5	15.6736659624
158	324	1	0	1	29.7338774333
158	325	2	0	2	31.1313038756
158	326	1	0	1	27.2774512034
158	327	1	0	1	30.9426614557
158	329	11	0	11	22.8884503231
158	330	1	0	1	24.6716028492
158	331	3	2	1	13.6198305217
158	338	6	0	6	46.0197146975
158	341	1	0	1	56.0024430716
158	347	2	0	2	29.6683870901
158	349	2	0	2	33.3608923946
158	350	1	0	1	52.3063571375
158	353	1	0	1	37.6139436926
158	357	1	0	1	36.4648476946
158	367	1	0	1	30.0855414569
158	375	2	0	2	81.4836232417
158	380	1	0	1	38.2131593248
158	385	0	0	0	48.4892064052
158	396	1	0	1	66.8261960479
158	408	6	1	5	72.5278051079
158	416	1	0	1	81.0198186315
158	417	1	0	1	62.1057470379
158	455	1	0	1	36.2801594823
158	464	0	0	0	67.9794964137
158	475	1	0	1	49.520666914
158	480	0	0	0	67.2551494155
158	503	1	0	1	65.5515931616
158	505	0	0	0	87.162025334
158	516	1	0	1	101.892600364
158	524	2	0	2	72.2341748304
158	529	1	0	1	98.7315314336
158	536	0	0	0	89.7713600263
158	548	0	0	0	137.716321118
158	554	0	0	0	56.1200038309
158	555	0	0	0	49.8591223967
158	559	2	0	2	58.0944615818
158	566	1	0	1	38.2974273329
158	569	2	1	1	25.3107492955
158	570	1	0	1	27.2646187967
158	573	40	2	38	28.6595371697
158	574	1	0	1	47.6693929749
158	576	2	0	2	11.4598630735
158	577	1	0	1	20.4437978362
158	581	11	0	11	13.0977033352
159	1	4	0	4	71.9553980476
159	5	1	1	0	77.8638534853
159	13	1	0	1	57.1319339471
159	24	1	0	1	66.5082931509
159	32	1	0	1	56.0151981214
159	34	1	0	1	54.9691439054
159	36	1	0	1	46.5529232567
159	42	1	1	0	49.7497945245
159	46	1	1	0	82.4481956035
159	48	1	0	1	72.1526315876
159	65	1	0	1	86.8435409887
159	70	68	24	44	26.9159348199
159	71	32	0	32	22.2801083915
159	72	6	0	6	30.5278539906
159	73	390	4	386	29.7866402591
159	74	43	0	43	25.1606463053
159	75	43	15	28	28.9946909473
159	76	38	15	23	24.5151852116
159	77	5	0	5	31.1530725441
159	78	109	0	109	24.2424285348
159	79	9	0	9	31.6600249249
159	80	6	0	6	29.6229800373
159	81	35	0	35	28.9298840157
159	82	29	12	17	25.6253435546
159	83	22	1	21	27.7822536087
159	84	50	10	40	28.4295677499
159	85	82	0	82	21.0716895167
159	86	41	1	40	20.4588216916
159	87	70	0	70	26.501632411
159	88	20	4	16	24.5928723141
159	89	2	0	2	37.1362314121
159	90	7	0	7	19.014748929
159	92	2	0	2	31.2452826363
159	96	6	0	6	20.1368643608
159	98	4	1	3	16.7808854651
159	101	1	0	1	38.2760538181
159	103	18	3	15	32.5512681489
159	107	8	1	7	18.7261725013
159	109	7	0	7	24.7101513701
159	110	1	0	1	34.7253844674
159	111	1	0	1	35.4322919161
159	112	15	2	13	35.6403374357
159	113	33	2	31	29.134080217
159	116	8	0	8	22.891799881
159	117	2	0	2	26.2019214573
159	119	12	1	11	16.0348378376
159	120	3	0	3	34.8751265442
159	121	1	1	0	26.0331750793
159	122	1	0	1	30.5705089313
159	127	1	0	1	29.1822699077
159	140	2	0	2	32.1098915277
159	142	5	1	4	34.9970904278
159	154	2	1	1	28.5215473751
159	155	209	5	204	10.0211520154
159	156	9	6	3	14.3837644138
159	157	3	1	2	18.6260226649
159	158	67	3	64	7.73142843869
159	160	2	0	2	22.448265676
159	161	3	0	3	24.988220739
159	162	11	0	11	14.4569647436
159	163	1	0	1	31.3846920973
159	164	44	1	43	14.0432574645
159	165	7	1	6	12.1889593521
159	166	408	286	122	8.868623642
159	167	1	0	1	23.6971805113
159	168	90	23	67	13.253528358
159	169	17	1	16	20.7336193531
159	170	20	13	7	7.28718645438
159	171	187	33	154	11.6842957611
159	172	159	54	105	15.2230120769
159	173	2	1	1	12.0335924751
159	175	70	10	60	8.04304191616
159	177	274	0	274	10.1490944588
159	179	4	0	4	23.9705426561
159	180	5	4	1	17.1824513641
159	277	2	0	2	72.7975198331
159	307	1	0	1	66.3328011907
159	310	1	0	1	48.3161306992
159	316	1	0	1	53.4928943695
159	318	1	0	1	20.2887537872
159	319	136	2	134	21.084953085
159	320	4	0	4	24.1506075369
159	321	3	0	3	17.3343199538
159	323	10	0	10	14.9692979029
159	324	1	0	1	24.4738932866
159	326	5	1	4	20.1339853884
159	327	1	0	1	26.6898993616
159	328	2	0	2	11.9399059871
159	329	27	0	27	15.2923445181
159	331	6	2	4	9.16388788715
159	332	1	0	1	50.6981702035
159	333	1	0	1	53.4260188082
159	334	2	1	1	47.1655037863
159	336	1	0	1	40.3167078156
159	338	17	4	13	38.4606502326
159	341	2	0	2	48.2775058217
159	347	3	0	3	22.1469544632
159	348	1	0	1	30.9724107385
159	349	18	4	14	26.0622015025
159	350	1	0	1	45.3781856786
159	353	4	1	3	29.9006824871
159	355	1	0	1	26.6274549002
159	356	1	0	1	44.6014663113
159	357	1	0	1	29.8524555736
159	364	2	0	2	33.4204479583
159	367	1	0	1	23.5201681092
159	371	1	0	1	82.7962881836
159	375	2	0	2	73.9783105674
159	377	1	0	1	58.4185404942
159	379	0	0	0	60.7526662924
159	385	2	0	2	55.3784302735
159	389	0	0	0	73.7279289742
159	391	1	1	0	55.5686459444
159	392	0	0	0	52.8081954473
159	406	2	0	2	81.5294092377
159	408	4	0	4	80.0878625645
159	415	1	0	1	69.4438924463
159	424	1	0	1	124.987972187
159	425	1	0	1	100.109449798
159	438	1	0	1	100.909561336
159	441	0	0	0	96.8438306849
159	444	1	0	1	104.783513718
159	455	1	0	1	43.9715991434
159	457	1	0	1	64.0652047533
159	460	0	0	0	57.9283779032
159	466	0	0	0	83.1469878071
159	469	1	0	1	70.0123142519
159	477	0	0	0	77.3995136894
159	496	1	0	1	65.9742273546
159	507	0	0	0	141.091649898
159	523	0	0	0	95.305392001
159	524	3	0	3	77.109896185
159	525	1	0	1	82.9119855192
159	530	1	0	1	99.963815497
159	537	0	0	0	89.6676067995
159	540	0	0	0	100.849932376
159	551	1	0	1	40.9658020977
159	553	0	0	0	86.3930493843
159	554	0	0	0	60.5307018651
159	563	1	0	1	46.7027536234
159	566	1	0	1	44.6918492642
159	567	1	0	1	46.0910587909
159	569	3	1	2	28.7899000928
159	573	40	1	39	33.8263312074
159	576	2	0	2	13.9055823698
159	577	6	0	6	21.6085389257
159	579	1	0	1	21.8838305177
159	580	2	0	2	26.5385278145
159	581	11	1	10	18.9179680641
159	585	1	0	1	41.5339442792
159	587	1	0	1	38.2413370361
160	0	1	0	1	47.727990378
160	1	14	1	13	60.4157941335
160	7	1	0	1	48.7585455632
160	21	2	0	2	58.7384979293
160	32	1	0	1	49.6365774497
160	35	1	0	1	41.9188677644
160	36	5	0	5	35.3529764393
160	47	1	0	1	62.6982170997
160	48	1	0	1	50.939342188
160	60	1	0	1	48.1996071554
160	70	28	2	26	29.1887356533
160	71	51	0	51	18.8618835817
160	72	4	0	4	30.573375712
160	73	413	88	325	25.9776350571
160	74	69	0	69	22.6766071261
160	75	51	1	50	23.7598440754
160	76	30	1	29	26.6083789409
160	77	2	0	2	30.0710413669
160	78	106	0	106	23.3565305018
160	79	11	1	10	29.7259358185
160	80	2	0	2	28.5812099663
160	81	27	9	18	28.570294021
160	82	27	2	25	25.7697526785
160	83	18	1	17	25.2790112352
160	84	75	4	71	24.6910892863
160	85	47	0	47	23.4359271213
160	86	42	10	32	19.2562576815
160	87	123	16	107	21.1506532642
160	88	36	0	36	19.5255823129
160	89	1	0	1	37.6149154984
160	90	3	0	3	27.1753811347
160	92	5	1	4	33.9938786463
160	95	4	3	1	30.9065433904
160	96	4	0	4	31.841045173
160	98	2	0	2	16.7460090062
160	102	2	1	1	41.0470939978
160	103	28	1	27	24.2538219498
160	107	23	7	16	11.214222922
160	109	3	0	3	31.4797887628
160	110	3	1	2	23.3492119945
160	112	18	0	18	26.9775881506
160	113	73	29	44	19.6871898794
160	114	2	1	1	30.29746131
160	116	2	0	2	27.1332760501
160	117	4	0	4	18.6724196287
160	119	4	0	4	22.1162137019
160	120	3	0	3	32.0820178476
160	121	7	0	7	17.3124853217
160	124	0	0	0	29.4869268729
160	125	0	0	0	29.5533558237
160	127	3	0	3	12.9471959899
160	128	5	0	5	10.6608245418
160	130	1	0	1	14.5516911787
160	134	1	0	1	18.2810941158
160	136	1	0	1	21.6897492714
160	137	5	2	3	7.05966824706
160	140	5	0	5	17.8218887961
160	142	78	5	73	14.9317217892
160	144	4	1	3	7.96293048188
160	145	1	0	1	23.6882041225
160	146	12	2	10	14.0975065567
160	147	2	0	2	19.1933589635
160	148	2	0	2	28.022884766
160	151	1	0	1	34.0426235737
160	154	49	34	15	6.2059157275
160	155	17	0	17	24.9170800446
160	157	35	9	26	6.81727292308
160	158	21	9	12	16.1904569387
160	159	5	0	5	22.448265676
160	161	10	5	5	8.57089285049
160	162	1	0	1	32.5339845837
160	163	30	1	29	12.3286303694
160	164	31	0	31	15.7681281577
160	165	6	2	4	13.1655165172
160	166	32	8	24	30.2172849227
160	167	11	1	10	14.5882875907
160	168	96	6	90	11.8387620877
160	169	3	0	3	35.6296235317
160	170	4	0	4	23.5980172401
160	171	19	4	15	20.4878956233
160	172	481	197	284	7.59701263392
160	173	6	0	6	18.2658769779
160	174	1	0	1	20.7400325824
160	175	14	0	14	17.5550254594
160	176	5	0	5	20.4438748956
160	177	246	123	123	12.3105734778
160	178	2	0	2	17.2772604782
160	179	1	0	1	40.2040983143
160	180	2	1	1	13.0555031704
160	183	0	0	0	116.625451852
160	277	0	0	0	76.624303971
160	285	1	0	1	86.6881757502
160	310	1	0	1	65.6106279455
160	313	1	0	1	60.1041583603
160	319	22	0	22	40.5738456901
160	320	1	0	1	40.7898310032
160	323	2	0	2	30.9823040806
160	325	1	0	1	46.010587455
160	326	1	0	1	42.5646366049
160	329	6	0	6	37.3633031537
160	338	4	0	4	60.3290298286
160	348	2	0	2	47.0053627078
160	349	1	0	1	48.3990369514
160	353	4	1	3	50.0972870547
160	356	0	0	0	65.2336246426
160	357	1	0	1	52.2482786042
160	375	2	0	2	91.4046924265
160	381	1	0	1	59.0384945458
160	385	2	1	1	46.2325225982
160	392	0	0	0	42.1684840377
160	396	2	0	2	58.0686436622
160	401	1	0	1	69.2054312299
160	406	2	0	2	65.1142566066
160	408	14	0	14	64.8960118336
160	409	1	0	1	67.1773093132
160	411	1	0	1	60.9816392243
160	415	1	0	1	54.3411237041
160	442	1	0	1	85.0671587589
160	454	0	0	0	35.8447319127
160	455	2	1	1	28.6320645992
160	457	1	0	1	46.4847721952
160	460	1	0	1	41.2052654816
160	469	1	0	1	48.2684965457
160	470	1	0	1	40.3064682257
160	471	1	0	1	56.9051102945
160	475	1	0	1	36.8632342032
160	503	1	0	1	54.6780056049
160	512	2	0	2	111.528215948
160	524	1	0	1	75.821519546
160	525	1	1	0	82.9918820863
160	534	0	0	0	94.1497362818
160	548	0	0	0	145.303366691
160	551	0	0	0	48.5597069242
160	554	0	0	0	61.496860852
160	555	3	0	3	58.3634958985
160	563	2	0	2	50.3429119438
160	566	1	0	1	39.0916620725
160	568	1	0	1	23.1200441063
160	569	1	0	1	35.1956742442
160	573	29	3	26	34.5788522074
160	576	3	0	3	25.3923415659
160	577	3	0	3	33.9228114752
160	581	11	0	11	21.6404256753
160	585	1	0	1	55.1649434327
161	1	1	0	1	68.0267605244
161	36	2	1	1	43.4132695407
161	46	1	0	1	68.5044345183
161	59	1	1	0	64.9044883847
161	70	18	0	18	37.2834172438
161	71	17	1	16	27.1303369694
161	72	1	0	1	38.926222288
161	73	150	52	98	34.4940121234
161	74	23	0	23	31.0289830946
161	75	18	1	17	32.3037091642
161	76	7	0	7	34.6264766362
161	77	1	0	1	38.4984108092
161	78	33	1	32	31.5801433038
161	79	4	1	3	38.2004985365
161	81	6	0	6	36.9124773341
161	82	6	1	5	33.9806379065
161	83	7	2	5	33.7082075362
161	84	18	4	14	33.184109352
161	85	17	5	12	31.2447431043
161	86	7	3	4	27.2735242815
161	87	28	4	24	29.6594554149
161	88	16	0	16	27.9738756015
161	89	2	0	2	46.0425739556
161	92	1	0	1	42.1673110188
161	103	11	2	9	32.797578854
161	107	4	1	3	19.2627317353
161	109	2	0	2	39.0318649733
161	110	1	0	1	31.6877496705
161	111	1	0	1	47.5545737652
161	112	6	1	5	35.4710942122
161	113	28	0	28	28.2416600493
161	114	1	0	1	38.5375753453
161	116	0	0	0	34.8788352133
161	117	1	0	1	27.225961283
161	120	1	0	1	40.6195679394
161	128	1	0	1	14.6139791454
161	130	1	1	0	15.7575700676
161	137	0	0	0	15.6301035572
161	142	13	3	10	21.0543066846
161	145	2	0	2	29.1827724594
161	146	1	0	1	22.6521450558
161	147	2	2	0	16.8776266746
161	154	23	5	18	8.65222561782
161	155	7	1	6	30.207552631
161	157	23	16	7	6.54100973101
161	158	9	0	9	17.4186986191
161	159	3	1	2	24.988220739
161	160	22	8	14	8.57089285049
161	163	75	26	49	6.43780267438
161	164	7	0	7	22.6799762646
161	165	2	0	2	13.0877652792
161	166	15	0	15	33.6620828144
161	167	22	1	21	7.23822288245
161	168	21	3	18	18.1839587586
161	169	1	0	1	41.6489525218
161	171	7	0	7	26.6511502269
161	172	131	1	130	13.3936369195
161	173	5	1	4	16.5263205538
161	174	2	0	2	15.1967500473
161	175	5	1	4	22.6119998665
161	176	4	0	4	12.8469864887
161	177	80	2	78	15.6438466511
161	178	1	1	0	8.74188049417
161	180	2	1	1	9.60216387409
161	260	1	0	1	56.8389786327
161	277	0	0	0	85.0482118609
161	319	7	1	6	39.4568770386
161	323	1	0	1	29.192011739
161	329	2	0	2	40.2640190574
161	357	0	0	0	53.5421007367
161	358	1	0	1	80.0703425787
161	385	0	0	0	37.6986171793
161	406	1	0	1	58.1691304968
161	408	6	0	6	57.5208913335
161	411	0	0	0	53.2145184728
161	415	1	0	1	46.8675667769
161	427	1	0	1	71.7411840753
161	438	0	0	0	80.7101545288
161	444	1	0	1	81.6777361657
161	454	0	0	0	28.3792504109
161	455	0	0	0	20.8799273118
161	460	1	0	1	34.1985258395
161	475	0	0	0	32.1396095226
161	488	1	0	1	67.4955040376
161	495	0	0	0	56.2852080029
161	503	1	0	1	48.7428888206
161	524	2	0	2	67.4682110359
161	529	0	0	0	99.6263493673
161	536	0	0	0	91.5652789787
161	541	1	0	1	117.21195779
161	551	0	0	0	42.3434805524
161	563	1	0	1	43.073768072
161	566	1	0	1	30.6315217341
161	568	5	1	4	14.8066403477
161	573	33	2	31	27.307638418
161	579	2	0	2	26.3505496057
161	581	15	5	10	16.8879644846
161	585	1	0	1	50.6549846
162	49	1	0	1	68.6428231228
162	70	66	0	66	20.8923488026
162	71	15	0	15	22.5689675871
162	72	1	0	1	24.8453889776
162	73	192	30	162	26.9476924759
162	74	15	1	14	23.2758039323
162	75	7	0	7	27.3677932948
162	76	28	2	26	19.6572576077
162	77	4	0	4	26.0521575106
162	78	39	2	37	21.6944168471
162	79	13	7	6	26.9853916169
162	81	14	1	13	24.042125758
162	82	21	2	19	21.6813549112
162	83	5	1	4	24.7877501026
162	84	19	3	16	26.0215754184
162	85	46	19	27	17.9440811521
162	86	9	2	7	20.4042296513
162	87	18	2	16	25.9217949697
162	88	4	1	3	24.7064708495
162	89	1	0	1	29.6007725718
162	90	10	2	8	12.4042547178
162	92	7	2	5	23.5062872262
162	95	3	1	2	34.6361931311
162	96	8	1	7	9.44009792997
162	98	1	0	1	18.9475403019
162	99	1	0	1	39.4750801271
162	101	1	0	1	27.4601212483
162	103	3	1	2	31.7736833444
162	107	1	0	1	24.1053286477
162	109	5	0	5	16.1522926812
162	110	1	0	1	35.3418142533
162	112	6	1	5	34.3219070221
162	113	10	1	9	30.1226902346
162	116	15	0	15	17.1988502042
162	118	1	0	1	15.2640345788
162	119	5	0	5	13.9978875158
162	121	1	0	1	27.7658258321
162	142	1	0	1	41.2955097702
162	155	124	2	122	7.6583482275
162	156	49	2	47	4.53744305404
162	157	1	0	1	30.9250446559
162	158	3	1	2	21.5841647172
162	159	7	0	7	14.4569647436
162	160	1	0	1	32.5339845837
162	163	2	1	1	43.5315268214
162	164	5	0	5	17.9442806052
162	165	2	0	2	25.806241763
162	166	99	19	80	7.30009200627
162	168	16	3	13	20.8004948438
162	169	113	26	87	7.10397514576
162	171	64	0	64	12.7177255366
162	172	16	3	13	25.019070896
162	173	2	0	2	26.4782196396
162	175	7	0	7	15.0536940348
162	177	15	0	15	21.8368278353
162	179	8	1	7	9.53988249901
162	183	2	0	2	98.6916929612
162	247	1	0	1	29.2057133039
162	251	1	0	1	27.0916158171
162	264	1	0	1	49.7564414082
162	310	7	0	7	34.1942783816
162	313	1	0	1	27.9151084738
162	317	1	0	1	46.5307644497
162	319	29	15	14	27.6250494981
162	320	3	0	3	33.0931225001
162	321	1	0	1	19.8039618039
162	322	1	0	1	30.8815491757
162	323	3	0	3	26.4096440744
162	326	2	1	1	16.6315513144
162	327	1	0	1	30.6783901857
162	328	2	0	2	16.7617427579
162	329	20	12	8	10.5244694613
162	331	2	0	2	18.5370646418
162	334	1	0	1	38.4519538896
162	338	5	0	5	29.2309107729
162	339	1	0	1	36.2455417039
162	340	1	0	1	47.8972201635
162	347	19	2	17	8.63786660434
162	348	2	0	2	16.5158026565
162	349	13	0	13	20.1076968894
162	350	1	0	1	30.9214844507
162	353	11	4	7	17.6551510275
162	354	3	0	3	10.4540930607
162	357	2	0	2	26.6190700258
162	367	1	0	1	21.7164900055
162	375	0	0	0	60.0201974249
162	396	1	0	1	88.1324076444
162	408	3	0	3	94.0292910735
162	433	1	0	1	128.271813815
162	466	1	0	1	94.1719100602
162	469	1	0	1	80.7371285928
162	475	1	0	1	69.1295955177
162	554	1	0	1	73.9719942109
162	563	0	0	0	59.8494560491
162	573	5	0	5	47.9446441503
162	577	2	0	2	33.6745784146
162	581	2	0	2	33.3489356941
162	586	1	0	1	57.6096227724
163	1	2	0	2	67.6542209763
163	21	1	0	1	64.4987647392
163	35	1	0	1	47.8005040446
163	36	4	0	4	44.0858407054
163	42	1	0	1	50.0223336704
163	48	0	0	0	49.5096696886
163	50	1	0	1	48.4935587743
163	61	1	0	1	66.6558270854
163	68	1	0	1	42.0819765636
163	70	28	1	27	41.4396745944
163	71	29	7	22	31.0513557973
163	72	3	0	3	42.6088869604
163	73	334	36	298	37.6922920753
163	74	44	0	44	34.7584917381
163	75	34	5	29	35.3708782307
163	76	12	0	12	38.8950110905
163	77	2	0	2	41.990106268
163	78	73	0	73	35.553534387
163	79	8	0	8	41.5412042635
163	80	3	2	1	40.5634493155
163	81	26	2	24	40.6294327823
163	82	28	0	28	37.9650739006
163	83	19	0	19	37.2267681055
163	84	58	2	56	36.495720169
163	85	23	0	23	35.7630592077
163	86	23	0	23	31.5603179423
163	87	66	8	58	32.9438895174
163	88	18	5	13	31.4892646089
163	89	1	0	1	49.4949787933
163	92	2	0	2	46.1880036993
163	95	1	0	1	41.6383213943
163	96	1	0	1	43.881576338
163	98	2	0	2	29.0420747367
163	99	1	0	1	31.6821039286
163	102	2	0	2	51.6254383065
163	103	10	1	9	35.0931556301
163	107	1	0	1	23.5357129815
163	110	7	1	6	33.2223476931
163	112	9	1	8	37.4406351039
163	113	68	0	68	30.7147283402
163	116	1	0	1	39.4616150008
163	117	2	0	2	30.2942229689
163	119	1	0	1	34.2896364139
163	121	3	0	3	28.8364307392
163	124	2	1	1	28.9898027119
163	125	1	0	1	31.4485338343
163	127	1	0	1	22.4700964258
163	128	1	1	0	13.0714866263
163	129	1	0	1	35.0149699266
163	130	1	0	1	11.9581615274
163	134	4	0	4	25.2344186917
163	135	7	6	1	5.75822121242
163	138	1	0	1	34.0190015423
163	140	8	0	8	27.2437760601
163	141	3	0	3	14.4730840082
163	142	68	8	60	20.2632172321
163	144	1	0	1	15.8966990522
163	145	1	0	1	27.2430086859
163	146	3	1	2	25.8033379995
163	147	48	14	34	10.918459419
163	150	1	1	0	16.4035225866
163	152	1	0	1	21.8429104052
163	153	1	0	1	16.6489153746
163	154	53	46	7	8.5731192608
163	155	13	0	13	36.1368986488
163	156	5	0	5	40.9472389348
163	157	28	7	21	12.8037718341
163	158	20	1	19	23.8502298103
163	159	3	1	2	31.3846920973
163	160	49	1	48	12.3286303694
163	161	14	2	12	6.43780267438
163	164	13	1	12	27.8539283971
163	165	7	1	6	19.5248064396
163	166	25	22	3	40.0016288003
163	167	24	0	24	11.5969170775
163	168	49	0	49	23.5800845109
163	169	2	0	2	47.3662272692
163	170	2	0	2	29.8899612916
163	171	8	0	8	32.2323834922
163	172	269	5	264	18.8593595917
163	173	11	0	11	22.760267583
163	174	7	6	1	8.90220858384
163	175	6	0	6	28.5425644166
163	176	20	1	19	8.41917025247
163	177	106	9	97	21.8374777355
163	178	16	1	15	8.17315502373
163	180	4	0	4	15.7743968615
163	220	0	0	0	145.643050204
163	245	1	0	1	60.5860914904
163	252	1	0	1	72.7415198368
163	277	1	0	1	88.4166801654
163	293	1	0	1	88.2420399435
163	303	1	0	1	72.8336497897
163	319	13	1	12	45.5259701441
163	320	3	0	3	43.9052447516
163	321	2	0	2	46.410549173
163	322	1	0	1	39.4879655616
163	323	3	1	2	35.187166733
163	328	1	0	1	41.3744428595
163	329	2	0	2	46.6714190648
163	331	1	0	1	36.6414529292
163	333	1	0	1	84.7927921638
163	338	2	0	2	69.8347402448
163	349	2	0	2	57.2023626455
163	353	0	0	0	60.713139727
163	355	1	0	1	55.4055045683
163	373	0	0	0	94.1038075085
163	375	1	0	1	103.132424272
163	379	1	0	1	37.3332678259
163	385	5	0	5	35.4030681913
163	389	0	0	0	53.1378228002
163	391	1	0	1	30.8673101999
163	392	4	0	4	30.9710374885
163	406	1	0	1	52.8253185942
163	408	29	1	28	52.568927159
163	410	2	0	2	48.1450446417
163	411	1	0	1	48.7435476896
163	414	2	0	2	58.248737495
163	415	3	0	3	42.026974737
163	417	1	0	1	43.4871547813
163	419	1	0	1	62.3470607491
163	426	1	0	1	90.1526654626
163	438	0	0	0	76.5770378561
163	442	2	0	2	72.7436302671
163	450	2	0	2	23.9419404167
163	453	1	0	1	38.842229537
163	454	0	0	0	23.5531825048
163	455	13	0	13	16.5212522537
163	456	1	0	1	11.8008809944
163	457	2	0	2	34.2858047446
163	460	5	1	4	28.888568251
163	461	1	0	1	16.8784763341
163	464	1	0	1	45.8335892934
163	465	1	0	1	44.1264022073
163	467	1	0	1	21.7876220932
163	469	2	0	2	38.9934063408
163	471	0	0	0	51.1873584869
163	472	1	0	1	37.3613382364
163	475	3	0	3	25.773126009
163	495	0	0	0	49.9616414471
163	496	2	1	1	34.857330296
163	503	3	1	2	42.779228706
163	504	0	0	0	34.9554390145
163	548	0	0	0	138.344294686
163	551	0	0	0	45.6955173571
163	554	1	0	1	54.3042980895
163	559	1	0	1	61.1659330723
163	561	0	0	0	67.2187453467
163	563	2	0	2	45.1966264213
163	566	3	0	3	30.2753631444
163	568	3	0	3	15.9413397318
163	569	0	0	0	33.463642391
163	571	0	0	0	36.6571101466
163	573	81	3	78	29.8134333167
163	575	1	0	1	39.3487067664
163	576	3	1	2	28.8786657411
163	577	3	0	3	35.6312262446
163	579	2	0	2	31.3617099253
163	580	1	0	1	22.3788400463
163	581	15	2	13	22.1021623539
163	585	2	0	2	55.2200567924
164	0	1	0	1	44.3836898626
164	1	8	1	7	58.0384421525
164	5	1	0	1	63.8207535851
164	28	2	0	2	55.2109321006
164	35	1	0	1	43.1835077642
164	36	2	0	2	32.537588816
164	41	0	0	0	36.6165374837
164	42	1	0	1	35.978977879
164	70	40	2	38	15.8884631431
164	71	42	3	39	8.4255982601
164	72	2	0	2	18.6663896561
164	73	359	6	353	16.4587643103
164	74	58	0	58	11.8366131052
164	75	32	7	25	15.2865640275
164	76	12	1	11	13.145010811
164	77	5	1	4	18.8510082995
164	78	119	0	119	11.3835757783
164	79	7	2	5	19.062287678
164	80	1	0	1	17.2243086277
164	81	10	1	9	16.7632127987
164	82	22	14	8	13.3731186552
164	83	23	1	22	14.6950489471
164	84	44	13	31	15.0268225312
164	85	61	15	46	9.40660235546
164	86	54	10	44	6.93950889022
164	87	63	2	61	12.6338176132
164	88	18	6	12	10.6568568843
164	89	1	0	1	25.8655829137
164	90	4	0	4	11.5760071743
164	92	1	0	1	20.8140301295
164	95	5	0	5	23.9981184053
164	96	1	0	1	16.0745565947
164	98	10	4	6	2.91755301935
164	99	1	0	1	23.7735402666
164	103	17	1	16	18.5681829982
164	104	2	0	2	27.1202794572
164	107	17	2	15	6.17086829249
164	110	1	0	1	20.703939275
164	111	1	0	1	25.9387167043
164	112	1	0	1	21.6860170543
164	113	39	25	14	15.1025355404
164	114	1	0	1	26.9925056958
164	116	6	1	5	12.6868334594
164	117	1	0	1	12.158801873
164	119	2	0	2	6.47022590735
164	120	1	0	1	22.162538797
164	121	1	0	1	12.0350906584
164	122	2	0	2	22.847932555
164	134	1	0	1	23.2242118991
164	137	1	0	1	11.9379174369
164	140	6	0	6	18.5819512167
164	142	1	0	1	23.4607497849
164	146	4	1	3	10.3770583388
164	154	4	0	4	21.5550782791
164	155	33	11	22	10.449256968
164	156	1	1	0	14.2010631732
164	157	6	2	4	16.8106394697
164	158	2	0	2	14.0167095274
164	159	2	1	1	14.0432574645
164	160	2	1	1	15.7681281577
164	163	0	0	0	27.8539283971
164	165	2	1	1	15.6780854716
164	166	11	0	11	18.0976982225
164	167	1	0	1	25.5565524079
164	168	78	51	27	4.61063416534
164	169	5	1	4	19.9892716483
164	170	2	1	1	19.8183750837
164	171	56	30	26	5.22805951542
164	172	65	5	60	9.31860517781
164	173	0	0	0	19.7923130707
164	175	23	6	17	6.00045776519
164	177	51	0	51	10.135422072
164	180	2	0	2	20.1222115307
164	229	1	0	1	96.1378087343
164	277	3	0	3	64.0600764869
164	310	1	0	1	49.9367223431
164	319	16	2	14	35.1248518148
164	320	1	0	1	37.9390345712
164	323	1	0	1	28.2878466095
164	327	1	0	1	40.5787856861
164	329	8	0	8	25.329088477
164	332	1	0	1	58.2266258188
164	338	4	0	4	46.9860302863
164	341	1	0	1	54.4327547808
164	347	1	0	1	26.3585871518
164	349	4	1	3	36.439855225
164	353	1	0	1	35.5338049677
164	366	1	1	0	45.6183320751
164	370	1	0	1	71.6214992817
164	381	1	0	1	71.2630267019
164	385	1	0	1	59.2074084018
164	392	0	0	0	55.6832799406
164	406	1	0	1	80.6466820342
164	408	3	0	3	80.1707051018
164	411	1	0	1	75.8810890862
164	454	0	0	0	51.0257184195
164	469	0	0	0	63.2473763003
164	495	1	0	1	76.6310855676
164	496	1	0	1	62.0892153604
164	551	0	0	0	52.4589476927
164	561	0	0	0	81.4923888715
164	563	1	0	1	56.7607117725
164	569	1	0	1	39.3119943065
164	573	8	0	8	42.0694038587
164	577	1	0	1	34.0618457798
164	579	2	0	2	32.9852448974
164	581	2	0	2	26.5767201933
165	1	2	0	2	70.8460881331
165	7	1	0	1	59.2414868945
165	13	1	0	1	55.5309616129
165	28	1	1	0	68.6164324919
165	36	2	0	2	45.1880445858
165	70	24	12	12	31.5477698661
165	71	28	3	25	23.2198560952
165	72	1	0	1	34.3052536403
165	73	228	0	228	31.4871068167
165	74	34	8	26	27.0691833768
165	75	22	6	16	29.8616268659
165	76	10	2	8	28.8117047612
165	77	1	0	1	34.3945499381
165	78	53	2	51	26.8992640695
165	79	3	1	2	34.4969682671
165	80	4	0	4	32.7646092921
165	81	13	0	13	32.3687786317
165	82	15	2	13	29.0065686038
165	83	8	0	8	29.9833890312
165	84	34	15	19	30.0385793476
165	85	27	0	27	25.0609525893
165	86	26	1	25	22.3039042069
165	87	65	4	61	27.0267528111
165	88	17	0	17	25.007146968
165	90	1	0	1	25.9070756259
165	92	1	0	1	36.4479407852
165	95	1	0	1	38.3366091335
165	96	3	1	2	28.9698115196
165	98	4	1	3	18.3480105423
165	99	1	0	1	34.0872104168
165	103	14	0	14	32.0929550005
165	107	2	1	1	16.2064635755
165	110	1	0	1	32.7505180258
165	112	5	1	4	35.1971759135
165	113	19	0	19	27.7500453686
165	115	1	0	1	43.2059682652
165	116	1	1	0	28.1491479225
165	117	1	0	1	25.5031474917
165	119	3	0	3	21.2424530684
165	123	0	0	0	46.4281663355
165	137	0	0	0	16.9718723911
165	140	2	0	2	28.3441061966
165	142	4	0	4	27.8425881872
165	143	1	1	0	30.8120492095
165	146	2	0	2	21.6468042351
165	154	2	1	1	18.3600012308
165	155	14	3	11	19.3589643388
165	156	1	0	1	24.3796483189
165	157	12	5	7	7.28711708849
165	158	40	22	18	4.45958011869
165	159	6	0	6	12.1889593521
165	160	10	9	1	13.1655165172
165	162	2	0	2	25.806241763
165	163	7	0	7	19.5248064396
165	164	23	7	16	15.6780854716
165	166	23	1	22	21.0379571064
165	167	6	3	3	11.7409906474
165	168	64	38	26	11.5605459344
165	169	5	0	5	31.0767140088
165	170	3	1	2	10.7604367686
165	171	21	10	11	17.4639255031
165	172	185	47	138	8.98376678106
165	173	20	3	17	5.33547284632
165	175	13	2	11	12.4518286363
165	176	1	0	1	24.6648200622
165	177	283	63	220	5.55692863542
165	180	24	0	24	5.25846992414
165	220	1	0	1	134.924673085
165	247	1	0	1	53.0812697641
165	257	1	0	1	57.3137626472
165	277	1	0	1	79.6075954337
165	307	1	0	1	68.8842369645
165	310	0	0	0	59.9953899233
165	313	1	0	1	53.5073792943
165	319	26	5	21	27.5150225945
165	323	2	0	2	17.8173528208
165	326	1	0	1	31.5697990263
165	329	5	2	3	27.3235056476
165	338	1	0	1	50.4304964089
165	341	1	0	1	60.4620231896
165	345	0	0	0	97.3309908209
165	347	1	0	1	34.017311877
165	348	1	0	1	42.0762676295
165	349	3	1	2	37.6905533938
165	355	1	0	1	36.2767680131
165	375	3	0	3	85.7911806249
165	379	1	0	1	49.4869438356
165	385	1	0	1	44.733376691
165	406	1	1	0	69.4952163013
165	408	5	2	3	68.2276114519
165	411	2	2	0	63.2129342083
165	415	1	0	1	57.5530853293
165	438	1	0	1	89.7852505265
165	454	1	0	1	39.5215832399
165	455	2	0	2	31.8777157324
165	469	0	0	0	58.4637621054
165	470	0	0	0	51.3125596482
165	475	0	0	0	45.1198903714
165	477	1	0	1	66.0079354722
165	484	0	0	0	80.8977163028
165	503	1	0	1	61.0929624393
165	524	3	0	3	69.8001033899
165	540	1	0	1	95.568979349
165	554	1	0	1	54.0690248087
165	555	1	0	1	48.7332263849
165	563	2	1	1	41.3468708573
165	564	1	0	1	51.2443589261
165	566	1	0	1	34.9720366825
165	567	1	0	1	39.1418973142
165	568	1	0	1	19.9141672492
165	569	2	0	2	24.3844224555
165	573	51	1	50	26.4092733969
165	576	3	0	3	12.4017069565
165	577	2	0	2	21.2366260327
165	581	19	0	19	11.0434349632
165	585	1	0	1	42.6699666572
165	586	1	0	1	52.1304482231
165	587	2	0	2	43.348144924
166	1	12	0	12	73.2733223941
166	7	3	0	3	62.6082338392
166	13	1	0	1	59.1195812056
166	32	1	0	1	55.7947299437
166	36	3	0	3	48.726593516
166	42	2	0	2	50.8952533696
166	43	1	0	1	97.5561325068
166	50	1	0	1	72.0073475929
166	56	1	1	0	81.2880173152
166	59	1	0	1	91.2497947429
166	70	182	21	161	25.9530868549
166	71	39	0	39	24.8575020075
166	72	12	0	12	29.8979182793
166	73	892	0	892	30.854536515
166	74	81	3	78	26.6137372326
166	75	70	7	63	30.7499418733
166	76	65	1	64	24.1584679492
166	77	9	1	8	30.8991834839
166	78	161	0	161	25.2587126329
166	79	8	0	8	31.6808396741
166	80	9	0	9	29.5973722256
166	81	51	0	51	28.7374883089
166	82	122	21	101	25.8742218385
166	83	42	15	27	28.6882166028
166	84	71	11	60	29.7066496489
166	85	129	0	129	21.5498843119
166	86	44	0	44	22.7228983842
166	87	101	16	85	28.7743909617
166	88	27	10	17	27.1851888752
166	89	4	1	3	35.4783559326
166	90	18	0	18	17.2006730173
166	92	9	2	7	29.3375951527
166	95	5	0	5	38.8005618562
166	96	15	6	9	15.8760128062
166	97	1	0	1	25.1042805112
166	98	2	0	2	20.0680529822
166	99	1	0	1	41.5304608563
166	102	1	0	1	46.1736255601
166	103	25	0	25	34.9035494135
166	104	1	0	1	40.5232050126
166	107	1	0	1	23.9999268845
166	108	1	0	1	20.9164628482
166	109	12	0	12	22.0648087817
166	110	7	2	5	37.9216185836
166	111	2	0	2	32.4700683515
166	112	15	4	11	37.7532711899
166	113	48	0	48	32.3950205138
166	116	17	0	17	21.9371688288
166	117	2	1	1	29.3293280632
166	118	5	0	5	19.0377763487
166	119	12	10	2	16.675675125
166	120	3	0	3	34.8130037107
166	121	1	0	1	29.60755721
166	140	1	0	1	36.589218307
166	142	10	2	8	41.210949207
166	146	4	0	4	28.4198247155
166	154	1	0	1	36.4107932629
166	155	383	350	33	8.63733326628
166	156	48	6	42	9.8017167567
166	157	3	0	3	27.1981333591
166	158	29	26	3	16.5888886834
166	159	54	28	26	8.868623642
166	160	3	0	3	30.2172849227
166	161	1	0	1	33.6620828144
166	162	40	18	22	7.30009200627
166	163	7	0	7	40.0016288003
166	164	26	10	16	18.0976982225
166	165	5	0	5	21.0379571064
166	167	2	0	2	32.5578870601
166	168	55	21	34	19.3872237686
166	169	52	21	31	14.3934495682
166	170	11	1	10	14.2789840326
166	171	223	0	223	13.516592126
166	172	90	0	90	22.6634633651
166	173	2	0	2	20.5785961101
166	175	22	7	15	13.1772029101
166	177	148	0	148	18.2896957489
166	179	4	0	4	16.4769213987
166	180	1	0	1	26.0490209999
166	183	3	0	3	105.990399189
166	245	3	0	3	42.8895221952
166	268	1	0	1	91.0895915533
166	276	1	0	1	58.5881794083
166	277	3	0	3	68.0877539113
166	279	1	0	1	65.4356793581
166	293	1	0	1	57.6326819301
166	303	1	0	1	73.131292444
166	307	1	1	0	65.0716166698
166	310	3	0	3	39.7497598034
166	313	1	0	1	32.8308542187
166	314	1	0	1	38.8276857894
166	318	7	1	6	15.2870653503
166	319	302	27	275	20.8654221381
166	320	15	0	15	25.9828475676
166	321	7	1	6	13.8589330737
166	323	24	0	24	19.1222183968
166	324	5	2	3	21.1053421281
166	325	4	1	3	31.0163021058
166	326	35	5	30	13.2898469235
166	327	6	1	5	24.6995556676
166	328	12	0	12	9.87433715664
166	329	106	4	102	7.3240720522
166	330	1	0	1	27.4922147571
166	331	6	2	4	11.2374471549
166	332	4	1	3	42.1461798377
166	334	2	0	2	39.0568794333
166	336	1	0	1	31.4741425678
166	338	48	0	48	30.1201196719
166	340	1	0	1	49.8567879486
166	341	7	1	6	39.4839320422
166	342	2	0	2	40.5364978703
166	345	1	0	1	77.779080267
166	347	18	1	17	13.5629574155
166	348	2	0	2	23.1236968044
166	349	86	28	58	18.5141544185
166	350	3	1	2	37.4677666916
166	351	7	1	6	18.8250446589
166	353	23	1	22	21.0321313819
166	354	9	2	7	11.4413040399
166	355	4	1	3	22.013971916
166	357	7	0	7	23.6385605718
166	359	2	0	2	35.3613344552
166	361	3	0	3	27.5752906874
166	364	6	0	6	30.3749113924
166	365	0	0	0	29.2856999572
166	366	2	0	2	30.5360649845
166	367	11	6	5	17.7726073458
166	373	1	0	1	54.7969453113
166	375	8	0	8	65.2743831635
166	377	1	0	1	49.6611117174
166	380	1	0	1	54.2039726173
166	385	0	0	0	63.7419182487
166	391	1	0	1	64.2947582732
166	394	1	0	1	74.7536036426
166	396	1	1	0	83.3518686266
166	401	1	0	1	91.923094211
166	403	1	0	1	101.538200637
166	406	2	0	2	90.3837688279
166	408	6	1	5	88.8920990588
166	411	1	0	1	83.5792853891
166	414	1	0	1	96.8511819176
166	415	2	0	2	78.261463321
166	453	1	0	1	75.8522736684
166	460	0	0	0	66.7969858617
166	465	0	0	0	83.993975509
166	466	1	0	1	91.555354864
166	472	1	0	1	74.4550693774
166	480	1	0	1	82.0968771875
166	483	1	0	1	117.76480581
166	491	2	0	2	90.6030588792
166	499	0	0	0	84.9044328071
166	503	3	0	3	82.1186533669
166	507	2	0	2	146.184856129
166	535	0	0	0	114.121916168
166	540	1	0	1	106.04587173
166	554	0	0	0	66.7972332468
166	558	1	0	1	69.9323935216
166	563	2	0	2	52.6304897527
166	566	3	0	3	52.7421259982
166	568	1	0	1	39.6865370081
166	569	1	0	1	34.9624156158
166	570	1	0	1	33.5053302862
166	571	0	0	0	54.5820469253
166	573	54	0	54	41.1174323029
166	576	2	0	2	20.6470150662
166	577	7	4	3	26.3935084959
166	581	10	0	10	27.0447245525
166	585	5	0	5	43.6614799892
166	587	2	1	1	37.4629525831
167	1	1	0	1	74.8759581904
167	32	1	0	1	64.0755086976
167	36	2	0	2	49.9382164831
167	59	1	0	1	71.3716560236
167	70	24	0	24	41.140860837
167	71	30	2	28	31.5532273407
167	72	2	0	2	43.3006456325
167	73	210	17	193	39.4430254332
167	74	40	4	36	35.5356277847
167	75	26	4	22	37.419766101
167	76	11	0	11	38.4044098173
167	78	42	2	40	35.8003047976
167	79	7	0	7	42.940459721
167	80	1	0	1	41.4936963089
167	81	18	3	15	41.2898025547
167	82	19	1	18	38.1236266037
167	83	14	0	14	38.364983985
167	84	36	10	26	38.0561386989
167	85	21	0	21	34.7839912217
167	86	18	1	17	31.2578207696
167	87	46	4	42	34.6468115077
167	88	11	0	11	32.7917055828
167	89	1	0	1	50.5460928166
167	90	4	0	4	36.7243566882
167	100	2	0	2	51.2220412964
167	103	9	2	7	38.5127759606
167	107	0	0	0	23.6688820009
167	109	2	0	2	41.9964795469
167	110	2	0	2	37.9018448355
167	112	5	0	5	41.362463536
167	113	18	1	17	33.9296786655
167	114	1	0	1	44.8751417722
167	116	1	0	1	38.2225472791
167	120	2	0	2	45.611231162
167	127	0	0	0	27.5158246146
167	131	1	0	1	45.3267342978
167	135	2	1	1	17.2374123269
167	137	0	0	0	21.3635769416
167	140	1	0	1	32.4075258557
167	142	6	0	6	28.2107288246
167	144	1	0	1	21.9019577823
167	146	1	0	1	27.9951297814
167	147	1	0	1	22.4821356339
167	154	12	0	12	15.8840577122
167	155	14	2	12	30.9809026363
167	156	1	0	1	36.0097930091
167	157	28	9	19	9.14359344266
167	158	4	0	4	16.0522991339
167	159	2	1	1	23.6971805113
167	160	17	1	16	14.5882875907
167	161	11	4	7	7.23822288245
167	163	37	27	10	11.5969170775
167	164	15	5	10	25.5565524079
167	165	6	0	6	11.7409906474
167	166	14	2	12	32.5578870601
167	168	53	10	43	20.9626226364
167	169	1	0	1	42.7035091409
167	170	1	0	1	20.1980655606
167	171	10	0	10	28.4926772613
167	172	212	28	184	16.5656128017
167	173	9	0	9	12.7556721488
167	175	5	1	4	23.7453070425
167	176	3	1	2	13.715335665
167	177	141	24	117	16.4074875453
167	178	4	3	1	7.23685960205
167	179	1	0	1	46.6872964226
167	180	7	1	6	6.53128898444
167	252	1	0	1	72.2536744335
167	281	0	0	0	80.6294625547
167	309	1	0	1	68.9841845965
167	319	15	1	14	34.5327899573
167	322	1	0	1	28.0838007885
167	323	3	1	2	24.1572041137
167	329	4	1	3	38.412799291
167	331	1	0	1	26.8622121059
167	332	1	0	1	73.7023784313
167	338	2	0	2	61.237892466
167	348	1	0	1	53.7867353034
167	375	1	0	1	97.5201095156
167	379	1	0	1	37.9350449281
167	380	2	0	2	22.5995034685
167	385	1	0	1	33.661382071
167	387	1	0	1	40.307277511
167	392	0	0	0	30.2868831483
167	401	2	0	2	59.859509804
167	406	1	0	1	57.8339637629
167	408	2	0	2	56.4916704687
167	415	3	0	3	45.8213399802
167	416	1	0	1	64.9711171746
167	417	1	0	1	46.1651910581
167	441	0	0	0	73.9089385358
167	455	6	0	6	20.2985713589
167	458	1	0	1	39.2866149842
167	460	1	0	1	34.2844382964
167	462	1	0	1	31.9763947447
167	496	1	0	1	43.1985830778
167	503	1	0	1	49.922761076
167	507	1	0	1	128.443018691
167	524	4	0	4	61.4329016555
167	536	0	0	0	84.4856292969
167	540	0	0	0	88.7503134633
167	551	0	0	0	35.1098910615
167	554	4	1	3	46.9099623181
167	555	2	0	2	44.1539333089
167	560	1	0	1	41.6149070611
167	563	1	0	1	35.9838218678
167	566	5	2	3	25.0552263402
167	568	15	8	7	9.05957016058
167	569	4	0	4	22.2921313527
167	573	136	37	99	20.1916471223
167	576	5	1	4	17.8247535471
167	577	2	0	2	24.058256309
167	578	1	0	1	16.5515797055
167	579	4	0	4	19.7668702632
167	580	1	0	1	11.7022614299
167	581	67	3	64	10.550400005
167	585	1	0	1	43.7752257621
168	0	1	0	1	46.8113984968
168	1	16	1	15	60.3319146519
168	7	2	0	2	48.8658637096
168	27	1	0	1	60.5471329469
168	31	1	0	1	33.514058868
168	36	7	1	6	34.644155983
168	46	1	0	1	69.2266604693
168	48	1	0	1	59.1006724805
168	50	1	0	1	53.6327920061
168	65	1	0	1	73.5929279526
168	70	91	28	63	20.3094724939
168	71	109	61	48	11.6805339009
168	72	5	0	5	22.8353182845
168	73	1070	511	559	19.9514286714
168	74	169	46	123	15.5086804004
168	75	115	0	115	18.4147749363
168	76	49	3	46	17.560303127
168	77	13	0	13	22.8626596679
168	78	349	10	339	15.3762765976
168	79	21	7	14	22.9412582424
168	80	6	0	6	21.2343690734
168	81	55	10	45	20.8731987862
168	82	71	16	55	17.5476927687
168	83	51	0	51	18.422851932
168	84	138	9	129	18.5015202844
168	85	154	44	110	13.873149007
168	86	124	59	65	10.7664348132
168	87	216	67	149	15.6020199844
168	88	69	0	69	13.5682191115
168	89	2	1	1	30.08962342
168	90	7	0	7	16.0890742001
168	92	3	0	3	25.2599311486
168	95	12	1	11	27.0125981988
168	96	4	0	4	20.3282355809
168	98	8	1	7	6.89905854138
168	100	1	0	1	33.671042979
168	103	40	0	40	21.0237553346
168	104	1	0	1	30.5300157988
168	107	22	9	13	5.63800853368
168	109	4	0	4	21.1035227528
168	110	3	0	3	22.3577555772
168	111	2	0	2	30.4544214224
168	112	7	0	7	24.1690617601
168	113	126	37	89	16.9664795336
168	114	2	0	2	29.0946863632
168	116	10	0	10	17.2608503374
168	117	7	0	7	14.3823363718
168	118	5	1	4	13.7159241843
168	119	15	0	15	11.0050045929
168	121	4	0	4	13.791263131
168	122	1	0	1	27.4585148445
168	124	0	0	0	38.1573555276
168	129	1	0	1	28.9431388821
168	137	1	0	1	9.78277175291
168	140	4	1	3	19.0444346166
168	142	21	5	16	21.9695454005
168	144	1	0	1	15.8224926422
168	146	4	0	4	11.2115278786
168	154	8	2	6	17.9090357777
168	155	92	3	89	13.1477732043
168	156	9	0	9	17.6186091078
168	157	7	0	7	12.208482735
168	158	27	6	21	10.8102875013
168	159	11	7	4	13.253528358
168	160	12	4	8	11.8387620877
168	161	2	0	2	18.1839587586
168	162	1	0	1	20.8004948438
168	163	13	0	13	23.5800845109
168	164	195	152	43	4.61063416534
168	165	8	1	7	11.5605459344
168	166	56	1	55	19.3872237686
168	167	6	3	3	20.9626226364
168	169	8	0	8	23.8496858942
168	170	2	0	2	17.6128077657
168	171	136	36	100	8.68635249039
168	172	390	74	316	4.79119330783
168	173	11	2	9	16.161577035
168	175	100	6	94	6.21406634393
168	176	2	1	1	31.0184942314
168	177	271	28	243	6.23825122564
168	179	1	0	1	28.3866888007
168	180	3	1	2	15.6779187719
168	183	1	0	1	108.341755294
168	190	1	0	1	108.749190236
168	241	1	0	1	141.500772459
168	251	1	0	1	38.4595181361
168	275	1	0	1	74.1121379884
168	277	0	0	0	68.5353722121
168	281	0	0	0	59.7040576414
168	307	1	0	1	57.3791846796
168	310	0	0	0	53.8196822025
168	319	45	1	44	33.9576117158
168	320	2	0	2	36.0052931867
168	321	2	0	2	30.5419167349
168	323	2	0	2	26.0971639334
168	324	1	0	1	37.7255402518
168	325	2	0	2	41.5270733229
168	326	2	0	2	32.4202282924
168	328	1	0	1	25.1731400861
168	329	13	0	13	26.7051167433
168	332	1	0	1	60.8107136908
168	338	7	1	6	49.1924672302
168	341	1	0	1	57.3767114355
168	347	1	0	1	29.4138696383
168	348	0	0	0	35.2414287066
168	349	7	0	7	37.8926540078
168	350	1	1	0	48.7806414232
168	353	2	0	2	38.4347512502
168	354	1	0	1	30.0953022919
168	355	1	0	1	39.7771600054
168	367	3	0	3	36.3517538122
168	375	5	0	5	79.645485748
168	380	1	0	1	43.2866940837
168	385	2	1	1	54.6044607372
168	392	0	0	0	51.0727185889
168	396	1	0	1	69.1960128053
168	400	1	0	1	80.7259975305
168	401	1	0	1	79.6642885897
168	408	6	2	4	75.7040756424
168	411	0	0	0	71.3419146386
168	414	1	0	1	81.8284296938
168	417	2	0	2	66.0128028665
168	426	1	0	1	113.459029434
168	427	1	0	1	89.8953178467
168	433	1	0	1	111.805356906
168	438	0	0	0	98.6659496832
168	441	0	0	0	94.1468914412
168	442	1	0	1	95.7794630133
168	444	1	0	1	99.7948599117
168	453	1	0	1	62.0815944741
168	465	0	0	0	66.15755284
168	469	0	0	0	59.938508166
168	471	0	0	0	67.2937930222
168	472	0	0	0	55.3554923902
168	482	1	0	1	90.627776067
168	485	0	0	0	92.8724657873
168	489	1	0	1	91.223144299
168	501	0	0	0	81.0996446696
168	503	1	0	1	66.3058820306
168	505	0	0	0	85.4908041844
168	512	0	0	0	117.638988939
168	520	0	0	0	78.9606090291
168	523	0	0	0	98.2659520467
168	524	1	0	1	81.1871945159
168	537	1	0	1	95.663381482
168	540	0	0	0	107.129457766
168	551	0	0	0	49.0335408507
168	552	1	0	1	76.1018071327
168	554	1	0	1	65.6006164435
168	555	1	0	1	60.1853462072
168	563	3	1	2	52.8903140566
168	566	5	0	5	45.7110397272
168	568	1	1	0	29.9576431354
168	569	0	0	0	35.7136177477
168	573	69	0	69	37.9344336115
168	575	0	0	0	44.0051232513
168	577	4	0	4	31.2484217579
168	579	3	0	3	29.6715935677
168	581	12	7	5	22.5947186991
169	0	2	0	2	50.9482965209
169	1	6	0	6	64.187550081
169	7	1	0	1	54.5590291595
169	13	1	0	1	51.4156724779
169	32	2	0	2	45.2285966105
169	36	7	0	7	41.8357740814
169	39	1	0	1	42.5643757861
169	48	0	0	0	76.8617985958
169	49	2	0	2	66.6698600189
169	50	1	0	1	69.0774092666
169	56	1	0	1	77.3953558576
169	60	1	0	1	71.7441638033
169	70	321	39	282	17.0429460953
169	71	44	0	44	21.953722815
169	72	27	0	27	20.7304885993
169	73	897	223	674	24.1420688882
169	74	68	18	50	21.4111052726
169	75	60	0	60	25.1515285072
169	76	153	2	151	16.6937569045
169	77	18	4	14	22.1366199473
169	78	177	16	161	19.7073196027
169	79	24	2	22	23.2124073659
169	80	9	1	8	21.4017606173
169	81	90	0	90	20.4433167687
169	82	107	0	107	18.9161519158
169	83	41	5	36	22.1318278838
169	84	93	0	93	23.538116534
169	85	175	51	124	16.3583203335
169	86	45	11	34	19.9878134166
169	87	70	7	63	24.4034367842
169	88	33	9	24	23.6947740901
169	89	10	7	3	24.2144233863
169	90	85	19	66	10.3186174777
169	92	14	4	10	18.4002682039
169	94	6	1	5	12.1036403735
169	95	9	0	9	31.1833291
169	96	164	112	52	5.19277745335
169	97	5	0	5	11.4334756889
169	98	4	3	1	19.9529786077
169	102	1	0	1	36.1514704749
169	103	27	0	27	29.6077184595
169	104	2	0	2	31.3990832581
169	105	1	0	1	29.3167944757
169	107	2	0	2	25.7341145652
169	108	2	0	2	6.73348505153
169	109	60	42	18	11.4819793222
169	110	3	0	3	33.6252768333
169	111	4	0	4	19.8813593291
169	112	20	1	19	31.7128627763
169	113	59	14	45	28.9749845927
169	114	1	0	1	37.2116504388
169	116	58	15	43	14.216378319
169	117	2	0	2	26.2466964088
169	118	6	0	6	13.925810159
169	119	10	0	10	14.258747319
169	120	2	0	2	25.8035891279
169	121	1	0	1	27.2134887174
169	122	2	0	2	13.8251433475
169	138	1	0	1	47.8425265672
169	142	2	0	2	42.0650383594
169	147	0	0	0	54.5766803303
169	155	397	0	397	11.7249784325
169	156	102	21	81	6.69777392054
169	158	9	0	9	27.1693090224
169	159	2	0	2	20.7336193531
169	162	66	1	65	7.10397514576
169	164	9	0	9	19.9892716483
169	165	2	0	2	31.0767140088
169	166	127	0	127	14.3934495682
169	168	33	7	26	23.8496858942
169	170	1	0	1	27.6566364122
169	171	93	25	68	15.163333428
169	172	25	0	25	28.5096135954
169	173	4	0	4	32.5224270323
169	175	15	6	9	19.1264625581
169	177	35	0	35	26.4258321929
169	179	46	0	46	4.72317996832
169	183	1	0	1	91.6236926865
169	186	1	0	1	82.5547267486
169	208	0	0	0	66.312109419
169	245	1	0	1	29.5830649399
169	251	2	0	2	19.9884752511
169	276	2	0	2	44.328364913
169	277	5	2	3	53.7747999323
169	293	1	0	1	43.9901423686
169	305	1	0	1	49.7369972967
169	309	1	0	1	49.2819270897
169	310	6	0	6	29.981005032
169	314	1	0	1	31.5939976313
169	319	52	1	51	34.5429425696
169	320	2	0	2	40.1512669162
169	321	13	0	13	26.4375022647
169	323	7	3	4	33.4685553035
169	324	1	0	1	32.7945453274
169	326	2	0	2	22.1327624898
169	327	1	0	1	37.1719803621
169	329	31	13	18	16.6235029747
169	331	1	0	1	25.6221928125
169	332	1	0	1	40.2391365095
169	334	1	0	1	39.7133167475
169	338	29	0	29	30.6150045733
169	339	1	0	1	36.571908288
169	341	2	0	2	35.5825693324
169	347	54	3	51	8.89558639485
169	348	37	6	31	11.3941169606
169	349	23	6	17	24.2153224621
169	350	7	1	6	25.3047557943
169	352	2	0	2	16.9599234748
169	353	48	0	48	17.4778561496
169	354	4	0	4	14.1998934554
169	355	1	0	1	32.3059495606
169	357	3	0	3	31.318187781
169	367	2	1	1	27.2523283399
169	371	1	0	1	63.5652295434
169	375	4	0	4	55.7958923019
169	377	2	0	2	40.945943179
169	379	1	0	1	80.5632313538
169	385	0	0	0	75.6584364457
169	394	0	0	0	85.8211865735
169	406	3	0	3	99.7902164856
169	408	7	0	7	98.9174178045
169	411	0	0	0	94.1542545417
169	419	1	0	1	107.880436255
169	439	0	0	0	128.550673874
169	444	0	0	0	123.276441286
169	447	0	0	0	123.926734828
169	451	1	0	1	84.9986361245
169	466	1	0	1	96.6829633125
169	469	0	0	0	83.1516314579
169	484	0	0	0	98.0392822987
169	492	1	0	1	105.126357105
169	496	1	1	0	81.9532109791
169	503	1	0	1	90.1341000925
169	524	2	1	1	97.6212639068
169	548	0	0	0	158.721545773
169	558	1	0	1	83.2501668136
169	569	1	0	1	48.9962400253
169	571	1	0	1	67.8524997231
169	573	11	2	9	54.5316226734
169	576	1	0	1	34.302559412
169	579	1	0	1	42.0284113248
169	581	2	0	2	39.5886567941
169	585	1	0	1	57.697474895
169	586	0	0	0	64.4162380969
170	1	3	0	3	77.7546190568
170	27	1	0	1	77.9588938863
170	35	1	0	1	61.9183992355
170	36	0	0	0	52.1297836164
170	42	1	0	1	55.7896487299
170	70	48	3	45	33.9157449166
170	71	18	10	8	28.2439715148
170	72	2	0	2	37.4044043261
170	73	270	91	179	36.150009216
170	74	41	1	40	31.4961060746
170	75	15	0	15	35.0994356755
170	76	10	0	10	31.4211171791
170	77	5	0	5	37.9225998717
170	78	52	0	52	30.7626153314
170	79	10	0	10	38.3426681131
170	80	1	0	1	36.3516450931
170	81	21	4	17	35.7165424011
170	82	20	2	18	32.350996347
170	83	11	2	9	34.2495176316
170	84	28	4	24	34.7443380043
170	85	48	4	44	27.8488375684
170	86	28	6	22	26.6454506603
170	87	38	0	38	32.4468059153
170	88	17	0	17	30.4536262306
170	89	1	0	1	44.1768342848
170	90	1	0	1	26.2428773695
170	92	4	1	3	38.3710819816
170	95	2	0	2	43.8087147716
170	96	4	1	3	27.3885105317
170	98	1	0	1	22.7175830528
170	103	8	0	8	38.2865335353
170	107	2	0	2	23.2315376964
170	109	6	1	5	31.9620097832
170	110	1	0	1	39.9405112514
170	111	1	0	1	42.6679199263
170	112	7	0	7	41.4264723771
170	113	28	0	28	34.4722640195
170	116	7	0	7	29.949967963
170	117	1	0	1	31.7215532734
170	118	2	1	1	26.1854327425
170	119	4	0	4	22.9469479659
170	120	1	1	0	41.537759319
170	121	1	0	1	31.2997463372
170	142	3	1	2	37.7276376339
170	155	115	60	55	17.3055712278
170	156	9	1	8	21.5260792683
170	157	1	0	1	18.0465854751
170	158	46	2	44	7.55195948009
170	159	57	27	30	7.28718645438
170	160	5	2	3	23.5980172401
170	162	1	0	1	20.9887003811
170	163	2	0	2	29.8899612916
170	164	23	4	19	19.8183750837
170	165	8	0	8	10.7604367686
170	166	185	0	185	14.2789840326
170	167	3	0	3	20.1980655606
170	168	51	0	51	17.6128077657
170	169	9	2	7	27.6566364122
170	171	58	1	57	18.5493587107
170	172	123	0	123	17.6875991967
170	173	10	3	7	7.44268566312
170	175	15	1	14	14.1050519811
170	177	242	4	238	12.2818586628
170	178	1	0	1	27.428327249
170	180	2	2	0	14.2522731944
170	245	1	0	1	53.3576477359
170	276	1	0	1	71.8838938297
170	303	1	0	1	79.3391178795
170	319	197	0	197	17.0326264124
170	320	3	0	3	18.3948120184
170	321	7	1	6	16.5223306546
170	322	1	1	0	14.3164492467
170	323	29	11	18	8.51182024313
170	324	2	0	2	22.549151193
170	325	4	0	4	23.914290747
170	326	3	0	3	21.8064483775
170	327	4	0	4	23.4552664612
170	328	6	0	6	11.6272821517
170	329	19	0	19	18.7198894875
170	330	1	0	1	17.8816721127
170	331	14	4	10	6.76238123465
170	332	1	0	1	53.6244066963
170	338	8	2	6	41.1206352827
170	341	3	0	3	52.0118693042
170	345	1	0	1	92.0343925929
170	348	1	0	1	37.3282505293
170	349	5	0	5	28.0002096114
170	353	4	1	3	34.5192559934
170	355	2	0	2	25.5755438984
170	357	0	0	0	30.086065734
170	361	1	0	1	30.5888017215
170	365	1	0	1	36.4483864631
170	367	1	0	1	23.7798023109
170	369	1	0	1	74.990639512
170	375	2	0	2	79.2398314788
170	377	0	0	0	63.5510861803
170	385	1	0	1	49.5997462879
170	392	0	0	0	47.4278021725
170	396	1	0	1	70.3765031352
170	401	1	0	1	78.2136301657
170	404	1	0	1	73.6937915057
170	408	4	0	4	75.4869724475
170	415	2	0	2	64.9528239866
170	417	1	0	1	64.69285244
170	419	1	0	1	83.4075288016
170	433	1	0	1	108.149237794
170	441	0	0	0	91.4295448749
170	442	1	0	1	94.6831803992
170	451	1	0	1	63.5293503758
170	455	1	0	1	40.2366424943
170	466	0	0	0	81.6360387591
170	501	1	0	1	87.1433835437
170	524	1	0	1	69.9883870706
170	535	1	0	1	102.104157303
170	536	0	0	0	84.7767238289
170	540	0	0	0	93.5627524555
170	548	0	0	0	133.137012776
170	551	0	0	0	33.71965409
170	554	0	0	0	53.3268697401
170	561	1	0	1	64.1259395919
170	563	3	0	3	39.4375726169
170	566	1	0	1	38.4796402727
170	567	1	0	1	39.0033115986
170	569	0	0	0	21.5282090327
170	570	3	0	3	21.7558713633
170	572	1	0	1	28.5114861254
170	573	45	0	45	26.9562653672
170	575	2	0	2	29.8341330261
170	576	12	1	11	6.67181676077
170	577	8	0	8	14.5117979076
170	579	3	0	3	14.6034798182
170	581	22	10	12	12.9069175557
170	585	2	1	1	35.1243316874
171	0	1	0	1	46.9780731168
171	1	21	8	13	60.6889734646
171	5	1	0	1	67.0645045684
171	7	1	0	1	49.7057916959
171	29	3	0	3	68.43021952
171	32	2	0	2	44.3517814754
171	36	18	3	15	35.6211020451
171	39	1	0	1	40.2004903084
171	42	1	0	1	38.3653324627
171	43	0	0	0	84.3077822459
171	46	1	0	1	73.3861096534
171	47	1	0	1	77.655193387
171	49	1	0	1	57.3268711913
171	50	1	0	1	58.6094882517
171	59	0	0	0	78.4190173249
171	60	1	0	1	60.7388215595
171	70	233	0	233	15.3732595086
171	71	98	5	93	11.4271073596
171	72	27	8	19	18.877477747
171	73	1369	668	701	18.2664708944
171	74	163	2	161	13.7181384157
171	75	127	10	117	17.7285951675
171	76	102	10	92	12.8783658223
171	77	10	3	7	19.4706982353
171	78	398	6	392	12.6519053621
171	79	18	0	18	19.9791436416
171	80	12	5	7	17.9388528051
171	81	79	33	46	17.2489232583
171	82	129	31	98	13.9425938649
171	83	63	15	48	16.2014827734
171	84	149	31	118	16.9625242685
171	85	424	375	49	9.38740234136
171	86	134	7	127	9.35418921617
171	87	258	1	257	15.4908245035
171	88	76	0	76	13.7778876556
171	89	13	0	13	25.6416775202
171	90	24	3	21	8.46461409246
171	92	13	0	13	19.9321115112
171	95	17	4	13	26.199156398
171	96	11	3	8	11.8676709635
171	98	10	3	7	6.59952100224
171	99	1	0	1	28.016066776
171	100	1	0	1	32.8700927437
171	102	1	0	1	34.631871892
171	103	72	0	72	21.6471685066
171	104	2	1	1	28.6356508629
171	105	1	0	1	29.0255858126
171	107	13	1	12	11.3885597882
171	109	13	3	10	14.1232564617
171	110	8	0	8	24.4524128611
171	111	8	1	7	24.5345415591
171	112	22	0	22	24.6169292292
171	113	144	72	72	18.897012072
171	114	1	0	1	30.1801135802
171	116	34	9	25	11.4599546319
171	117	8	4	4	15.8340343281
171	118	4	3	1	7.6506767178
171	119	36	7	29	4.39764462507
171	120	5	0	5	23.1953986183
171	121	2	1	1	16.0920121918
171	122	1	0	1	20.4274052068
171	124	0	0	0	44.8636000662
171	134	0	0	0	28.1279323826
171	140	9	1	8	23.1593553409
171	141	1	0	1	46.6014248843
171	142	14	0	14	28.6292636513
171	144	1	0	1	23.4035372071
171	145	2	1	1	36.1261211063
171	146	6	1	5	15.0702483023
171	154	2	0	2	26.4658844165
171	155	408	155	253	5.31574849733
171	156	39	3	36	9.05431545624
171	157	1	0	1	20.3784078007
171	158	3	1	2	14.5404843681
171	159	17	0	17	11.6842957611
171	160	2	0	2	20.4878956233
171	162	7	0	7	12.7177255366
171	163	3	2	1	32.2323834922
171	164	58	10	48	5.22805951542
171	165	5	1	4	17.4639255031
171	166	104	3	101	13.516592126
171	167	2	0	2	28.4926772613
171	168	79	23	56	8.68635249039
171	169	21	0	21	15.163333428
171	170	6	2	4	18.5493587107
171	172	91	53	38	13.3757501869
171	173	3	0	3	20.4833148769
171	175	59	31	28	5.10584732039
171	177	83	55	28	12.1392126253
171	178	1	0	1	34.509330182
171	179	2	0	2	19.7162288325
171	180	1	0	1	22.4759286703
171	183	1	0	1	101.925099937
171	188	1	0	1	100.351733301
171	214	2	0	2	73.063304646
171	220	1	0	1	117.46552241
171	243	1	0	1	123.607182152
171	245	5	0	5	35.161410307
171	251	1	0	1	30.8907146829
171	257	1	0	1	41.6210000278
171	264	1	0	1	47.4081922746
171	277	7	1	6	62.5131748069
171	281	0	0	0	53.2716626647
171	296	1	0	1	46.472369074
171	307	1	0	1	54.6675775885
171	310	3	0	3	45.1359785504
171	313	1	0	1	39.6705965617
171	318	2	0	2	28.6966947779
171	319	84	0	84	32.1865864966
171	320	0	0	0	35.7719022105
171	321	1	0	1	26.7561486808
171	323	8	0	8	26.6315763908
171	326	1	0	1	26.7382545262
171	327	4	0	4	37.1584572054
171	328	1	0	1	21.8451358736
171	329	35	4	31	20.5508221225
171	331	1	0	1	20.4729106452
171	332	3	0	3	53.0008991179
171	334	8	1	7	51.0038039017
171	336	1	0	1	40.9589141618
171	338	18	1	17	41.8111442325
171	341	4	0	4	49.2186109466
171	345	1	0	1	81.2047515931
171	347	5	1	4	21.1463159681
171	348	4	0	4	26.5554527506
171	349	13	4	9	31.5392975399
171	350	4	0	4	40.1795682477
171	353	5	0	5	30.3106585861
171	354	1	0	1	22.7499554255
171	355	2	1	1	35.4165219679
171	357	2	0	2	37.1101286932
171	367	2	0	2	31.287642889
171	368	1	0	1	62.6576717297
171	373	1	0	1	62.5527079278
171	375	4	1	3	70.9591611106
171	385	1	0	1	62.0384905148
171	396	1	0	1	77.7344147436
171	400	1	0	1	89.1456298096
171	408	7	0	7	84.1173324156
171	411	3	0	3	79.5799079005
171	413	1	0	1	91.6116949872
171	415	3	0	3	73.4433422162
171	417	1	0	1	74.2442999361
171	424	1	0	1	130.397638607
171	426	1	0	1	121.91500459
171	441	0	0	0	102.251076118
171	460	1	0	1	60.8411813623
171	465	0	0	0	74.7043293482
171	466	0	0	0	81.8338159439
171	469	0	0	0	68.3424071447
171	475	0	0	0	57.3490165402
171	476	1	0	1	60.4795822815
171	482	2	0	2	98.6578432974
171	485	0	0	0	101.150500107
171	494	1	0	1	65.1224962861
171	496	1	0	1	66.7929311164
171	503	1	0	1	74.9828125651
171	504	0	0	0	66.3624328837
171	507	1	0	1	151.795457848
171	512	1	0	1	123.464055407
171	524	1	0	1	86.7746558504
171	540	0	0	0	111.561801265
171	551	1	0	1	52.131903053
171	555	0	0	0	63.8764819825
171	557	0	0	0	66.5435869845
171	563	1	0	1	57.2033058376
171	566	1	0	1	52.4344898634
171	569	0	0	0	39.4146564075
171	571	0	0	0	55.9370994797
171	572	0	0	0	46.9802791049
171	573	34	0	34	43.1998064926
171	576	1	0	1	24.7414813037
171	577	5	1	4	33.0605688641
171	579	4	0	4	32.7314314663
171	581	6	0	6	27.6344850776
171	585	4	3	1	53.2168239193
172	0	1	0	1	48.5785667288
172	1	18	1	17	61.8624791179
172	7	2	0	2	50.2585620539
172	13	2	0	2	46.5479997562
172	15	2	0	2	51.8620885245
172	19	1	0	1	48.5280636847
172	21	1	0	1	61.2881368041
172	24	3	0	3	54.8504922488
172	32	1	0	1	48.8486657655
172	34	2	0	2	40.8221714
172	36	7	2	5	36.2101768526
172	41	0	0	0	38.7490335288
172	42	2	0	2	40.7810880942
172	46	1	0	1	68.4928672433
172	48	1	0	1	57.1482807022
172	60	1	0	1	53.8463147212
172	70	106	27	79	24.583007544
172	71	152	14	138	15.1271532762
172	72	8	0	8	26.7760302382
172	73	1186	224	962	23.2396439648
172	74	184	70	114	19.1022736001
172	75	146	29	117	21.4040240582
172	76	76	22	54	21.8522281941
172	77	8	0	8	26.626294304
172	78	306	126	180	19.2661809332
172	79	23	6	17	26.5602709556
172	80	8	1	7	25.0202365584
172	81	70	0	70	24.7726406853
172	82	93	24	69	21.5690977258
172	83	43	3	40	21.979488915
172	84	192	59	133	21.8137216372
172	85	128	18	110	18.2711560766
172	86	136	6	130	14.6999622648
172	87	329	109	220	18.5695428426
172	88	98	23	75	16.6076002878
172	89	8	0	8	34.0355018926
172	90	11	0	11	20.8646490078
172	92	11	0	11	29.535932008
172	95	9	0	9	29.6585240134
172	96	4	0	4	25.1059513537
172	98	6	0	6	11.204281267
172	100	1	1	0	36.129961436
172	102	2	0	2	39.6163238316
172	103	48	8	40	23.2757098642
172	107	49	0	49	7.49181480541
172	109	2	0	2	25.7775867073
172	110	8	0	8	23.7724783428
172	111	3	0	3	34.8242067415
172	112	30	5	25	26.3453581574
172	113	134	14	120	18.8533100921
172	114	2	0	2	30.7608518945
172	116	11	0	11	21.7907360984
172	117	3	1	2	16.7751619819
172	118	3	0	3	18.3707520473
172	119	9	0	9	15.7690534317
172	120	2	0	2	29.3681541974
172	121	6	0	6	15.8210123722
172	124	0	0	0	35.8620192619
172	131	1	0	1	46.1073751415
172	133	0	0	0	27.8121052466
172	134	2	0	2	21.9930315541
172	135	4	0	4	21.1279013129
172	136	1	0	1	27.9415753722
172	137	3	0	3	8.32926366258
172	140	7	4	3	19.4305548557
172	142	38	2	36	20.1265388093
172	144	2	0	2	13.3289098259
172	146	2	1	1	12.7227070817
172	147	3	0	3	26.7523945104
172	154	27	11	16	13.8020324518
172	155	97	34	63	17.4537204762
172	156	10	2	8	22.1439208387
172	157	52	12	40	7.56552996767
172	158	68	0	68	10.1700737879
172	159	19	5	14	15.2230120769
172	160	79	9	70	7.59701263392
172	161	4	2	2	13.3936369195
172	162	2	0	2	25.019070896
172	163	39	6	33	18.8593595917
172	164	130	51	79	9.31860517781
172	165	37	9	28	8.98376678106
172	166	78	2	76	22.6634633651
172	167	12	0	12	16.5656128017
172	168	419	53	366	4.79119330783
172	169	14	5	9	28.5096135954
172	170	5	1	4	17.6875991967
172	171	97	26	71	13.3757501869
172	173	19	5	14	14.2236370181
172	175	60	11	49	9.98731187222
172	176	2	0	2	26.2274578167
172	177	801	210	591	5.45882090796
172	178	1	0	1	21.6557746317
172	180	9	4	5	11.9362887906
172	183	2	0	2	112.664719071
172	245	2	0	2	44.7848837275
172	270	1	0	1	76.8823009726
172	272	1	0	1	81.5397633961
172	277	1	0	1	72.7740886577
172	303	1	0	1	64.6595301954
172	305	1	0	1	62.5899628049
172	310	0	0	0	58.4397644115
172	313	1	0	1	52.7314824177
172	318	1	0	1	35.4969552394
172	319	64	0	64	34.6502876538
172	320	5	1	4	35.8020715948
172	323	8	0	8	25.8073807787
172	325	1	0	1	41.2317973585
172	326	3	1	2	35.2092741472
172	327	1	0	1	40.8929195744
172	329	15	3	12	29.8595927526
172	330	1	0	1	34.6088099338
172	332	3	0	3	64.612846545
172	334	1	0	1	61.7202880024
172	338	5	2	3	52.7569037953
172	345	0	0	0	94.5273630617
172	347	1	0	1	33.6566157447
172	348	1	0	1	39.9024260565
172	349	4	0	4	40.9533577166
172	350	3	0	3	53.53512265
172	353	2	1	1	42.5321024301
172	358	1	0	1	77.4595599434
172	367	2	0	2	38.7429402527
172	375	3	0	3	84.2908671064
172	385	4	0	4	50.0899474517
172	392	2	0	2	46.4595467112
172	394	1	0	1	58.8135029122
172	396	1	0	1	64.414380911
172	397	1	0	1	60.7721542365
172	406	1	0	1	71.4931541206
172	408	20	3	17	70.9130595388
172	411	4	0	4	66.5690379486
172	412	1	0	1	80.7463002336
172	413	0	0	0	78.8300259628
172	415	3	0	3	60.2612033799
172	426	1	0	1	108.668608069
172	433	1	0	1	107.083118501
172	435	1	0	1	86.3960181779
172	437	1	0	1	118.45731565
172	438	1	0	1	93.9387878335
172	441	1	0	1	89.3966410584
172	442	0	0	0	90.9911460405
172	444	1	0	1	95.0130885326
172	450	1	0	1	40.7745150293
172	455	1	0	1	34.2689656435
172	456	1	0	1	30.5933622512
172	457	1	0	1	53.1001416976
172	459	2	0	2	55.7086998667
172	460	2	0	2	47.5138061335
172	466	0	0	0	69.2304453498
172	469	0	0	0	55.8582934467
172	471	2	0	2	64.1767012217
172	475	1	0	1	44.1686701164
172	476	0	0	0	50.3895520118
172	486	0	0	0	83.286965671
172	489	0	0	0	88.0967470996
172	507	0	0	0	143.894527673
172	512	1	0	1	113.733252545
172	524	2	0	2	77.4436677856
172	529	0	0	0	106.502901184
172	548	0	0	0	145.181896133
172	551	0	0	0	46.7505332244
172	552	0	0	0	73.8065879507
172	553	1	0	1	93.3470536986
172	554	4	1	3	62.1869796138
172	555	0	0	0	57.4871015265
172	561	1	0	1	74.3619529652
172	563	4	0	4	49.9126438852
172	566	2	0	2	41.5368270968
172	567	3	1	2	47.2408200265
172	568	5	0	5	25.6203247254
172	569	1	0	1	33.2884819357
172	570	1	0	1	36.4160331545
172	571	0	0	0	46.0617481706
172	572	1	0	1	44.0203247103
172	573	135	18	117	34.5861264577
172	576	3	0	3	21.0532637486
172	577	2	0	2	30.0268589022
172	579	2	0	2	27.7726228349
172	580	1	0	1	25.7298251285
172	581	45	3	42	19.7386807545
172	585	4	1	3	51.4650681354
172	586	1	0	1	60.7990557156
172	587	1	0	1	51.2102385153
173	1	1	0	1	76.0335976936
173	13	2	0	2	60.7415239616
173	36	6	5	1	50.3482737426
173	42	1	0	1	54.6884429814
173	70	31	9	22	35.3784068789
173	71	16	5	11	27.7992336173
173	73	266	80	186	36.0534460896
173	74	35	0	35	31.5208970546
173	75	24	3	21	34.5748056456
173	76	8	1	7	32.6916318363
173	78	62	24	38	31.1728722443
173	79	6	0	6	38.844822634
173	80	1	0	1	37.0161751366
173	81	14	0	14	36.5395579854
173	82	23	0	23	33.1386593627
173	83	11	1	10	34.4185552447
173	84	22	0	22	34.6043756741
173	85	15	2	13	28.9441446788
173	86	26	4	22	26.6587735255
173	87	34	0	34	31.7635207034
173	88	11	0	11	29.7297953108
173	89	1	0	1	45.5452242694
173	90	1	0	1	28.8838497094
173	92	1	0	1	40.1729562083
173	96	1	0	1	31.2089192455
173	98	2	0	2	22.625630812
173	99	1	0	1	39.3839503971
173	102	1	0	1	52.81730426
173	103	3	0	3	37.0600606328
173	104	1	0	1	46.6715436138
173	109	2	0	2	34.595700458
173	112	4	0	4	40.1878400925
173	113	24	5	19	32.8071264557
173	116	2	1	1	31.7295434735
173	117	1	0	1	30.4300644299
173	118	2	0	2	27.8884037054
173	119	2	0	2	24.6409819448
173	121	2	0	2	29.6783497374
173	131	1	0	1	55.5242769814
173	142	5	2	3	33.0804066715
173	144	1	0	1	26.0372407335
173	146	4	0	4	26.7538670684
173	148	0	0	0	46.1543431903
173	150	0	0	0	39.1429650833
173	154	3	0	3	23.0292239488
173	155	26	2	24	21.1229182817
173	156	2	0	2	25.9525888952
173	157	8	0	8	11.8614465959
173	158	18	1	17	5.95427213432
173	159	4	0	4	12.0335924751
173	160	10	0	10	18.2658769779
173	161	2	0	2	16.5263205538
173	163	1	0	1	22.760267583
173	164	17	11	6	19.7923130707
173	165	25	0	25	5.33547284632
173	166	23	0	23	20.5785961101
173	167	9	0	9	12.7556721488
173	168	48	21	27	16.161577035
173	169	1	0	1	32.5224270323
173	170	8	1	7	7.44268566312
173	171	17	16	1	20.4833148769
173	172	167	19	148	14.2236370181
173	174	1	0	1	30.8961178433
173	175	8	2	6	15.3947987254
173	176	2	0	2	26.4547144539
173	177	229	19	210	9.92378842526
173	179	1	0	1	35.9646213517
173	180	27	10	17	6.98786959371
173	183	1	0	1	122.345473735
173	208	0	0	0	98.5655148674
173	245	1	0	1	55.5362716836
173	247	0	0	0	54.9311052054
173	276	1	0	1	76.024807082
173	277	2	0	2	82.996489441
173	310	1	0	1	60.2808173783
173	319	49	4	45	22.9985967538
173	320	2	0	2	22.5497048182
173	321	1	0	1	23.8238342637
173	323	3	0	3	12.9115053094
173	329	6	0	6	25.8738617355
173	334	1	0	1	56.6787723412
173	338	6	0	6	48.520735097
173	341	1	0	1	59.2386275377
173	344	1	0	1	53.4423354951
173	349	1	0	1	35.4337099329
173	356	1	0	1	47.6540342241
173	373	1	0	1	75.1564128696
173	375	2	0	2	85.8529792063
173	385	2	0	2	43.3453663072
173	389	0	0	0	61.7150632165
173	392	1	0	1	40.8129832274
173	394	1	0	1	54.177264264
173	406	2	0	2	70.1104241941
173	408	6	1	5	68.4245347924
173	411	1	0	1	63.0189388506
173	416	1	0	1	77.1678754344
173	442	0	0	0	87.8124263743
173	444	1	0	1	93.2000217917
173	456	1	0	1	32.0658823095
173	461	1	0	1	28.4843597555
173	466	0	0	0	74.3196824852
173	487	2	0	2	86.8056119804
173	491	0	0	0	74.9520552398
173	505	1	0	1	85.3269818704
173	507	1	0	1	131.544155355
173	512	1	0	1	103.005036824
173	537	1	0	1	79.9601120601
173	548	0	0	0	131.952841543
173	552	1	0	1	59.9490751856
173	554	3	0	3	50.1667027344
173	555	1	0	1	44.0853525195
173	563	2	1	1	36.9886762886
173	566	1	0	1	32.7693721978
173	568	3	0	3	19.1120154671
173	569	5	1	4	19.5679636079
173	570	1	0	1	22.1977349294
173	573	92	28	64	22.7220857453
173	576	14	11	3	7.13155974861
173	577	5	1	4	15.9014216561
173	579	3	0	3	13.6063551824
173	580	2	0	2	14.7488707559
173	581	90	0	90	7.2048926666
173	585	3	0	3	37.3350419671
174	1	4	0	4	70.5253318038
174	7	1	0	1	59.5191543741
174	36	2	0	2	48.6580673346
174	70	14	0	14	49.3229274244
174	71	6	1	5	38.9062684618
174	72	2	0	2	50.1163999852
174	73	143	97	46	44.8792499841
174	74	23	6	17	42.4128729456
174	75	33	0	33	42.4950241516
174	76	6	2	4	46.8844073412
174	77	1	0	1	49.3510773509
174	78	21	3	18	43.3737965691
174	81	10	0	10	48.1887523793
174	82	14	2	12	45.7612675641
174	83	8	2	6	44.6796435375
174	84	31	2	29	43.7967155821
174	85	6	0	6	43.9520861626
174	86	3	0	3	39.650360525
174	87	31	23	8	40.2940691134
174	88	5	1	4	39.0461815859
174	89	1	0	1	56.7344490248
174	92	2	0	2	53.9243968197
174	98	1	0	1	37.4511657758
174	103	3	0	3	41.5571415388
174	107	4	0	4	31.7588733833
174	110	2	0	2	39.0305650255
174	112	2	0	2	43.5385140628
174	113	22	7	15	37.4632095579
174	117	3	0	3	37.5399818732
174	124	1	0	1	28.0185163609
174	128	1	0	1	17.6669087731
174	135	0	0	0	8.23672312509
174	140	2	0	2	33.0679303476
174	141	4	0	4	5.59749112989
174	142	17	2	15	24.498217034
174	144	1	0	1	22.2799042742
174	146	1	1	0	33.2458419648
174	147	14	11	3	7.62897237467
174	151	1	0	1	27.7927016013
174	152	2	0	2	20.3864964469
174	154	14	5	9	15.6516880584
174	157	1	0	1	21.6733907132
174	158	2	0	2	32.5669543518
174	160	4	0	4	20.7400325824
174	161	1	0	1	15.1967500473
174	163	55	9	46	8.90220858384
174	164	2	0	2	36.4776152695
174	165	1	0	1	28.1709596394
174	166	1	0	1	48.8541613444
174	167	5	0	5	18.6096464993
174	168	5	0	5	32.3257424352
174	171	4	0	4	41.0056514709
174	172	35	0	35	27.6620900303
174	173	1	0	1	30.8961178433
174	176	13	0	13	6.64648184147
174	177	10	7	3	30.7334400926
174	178	3	1	2	12.2647306321
174	180	2	0	2	23.9693386568
174	277	1	0	1	95.3355926779
174	310	0	0	0	86.1014392312
174	319	4	1	3	53.1424212298
174	349	1	0	1	65.8448568437
174	379	2	0	2	31.7825821898
174	385	1	0	1	31.6043897998
174	406	3	0	3	44.5586975529
174	407	1	0	1	39.829689881
174	408	17	2	15	44.7405148891
174	411	2	1	1	41.5411433075
174	415	2	0	2	34.4374556199
174	416	1	0	1	51.7985460806
174	427	1	0	1	58.3687908859
174	442	2	0	2	64.9221036862
174	450	1	0	1	18.8862919208
174	451	1	0	1	29.4418791038
174	453	1	0	1	31.0012630218
174	454	0	0	0	16.5136484062
174	455	12	3	9	11.1559179239
174	456	6	3	3	4.34588905504
174	460	4	0	4	20.9030893647
174	462	1	0	1	21.6345943775
174	469	1	0	1	30.9084324245
174	475	5	0	5	16.9539057188
174	495	1	0	1	41.0913364249
174	504	1	0	1	26.1413588352
174	524	2	0	2	65.1730227423
174	563	0	0	0	47.1579917539
174	568	1	0	1	19.0475319398
174	572	1	0	1	52.168358767
174	573	6	2	4	32.9579790594
174	577	2	0	2	42.2052596126
174	581	1	0	1	28.9539748249
175	1	13	4	9	63.9835698777
175	15	1	0	1	54.7530176341
175	32	4	0	4	48.4411683571
175	36	3	1	2	38.5261082627
175	41	1	1	0	42.5914662699
175	48	1	0	1	65.1548202034
175	60	1	0	1	61.2196683479
175	65	2	0	2	79.3323244082
175	70	79	12	67	20.1715156122
175	71	50	25	25	14.3067098718
175	72	7	0	7	23.4633029535
175	73	515	0	515	22.0578902435
175	74	75	0	75	17.4044243371
175	75	46	8	38	21.0986617884
175	76	40	8	32	17.5593175297
175	77	3	0	3	23.8932102777
175	78	200	45	155	16.6614093139
175	79	8	0	8	24.2695977921
175	80	2	0	2	22.3036818892
175	81	24	0	24	21.7064160018
175	82	29	1	28	18.3157422562
175	83	20	2	18	20.1445946259
175	84	61	0	61	20.6617319436
175	85	132	31	101	13.883434058
175	86	66	0	66	12.5866247443
175	87	135	4	131	18.5332454705
175	88	48	3	45	16.5941919114
175	89	2	1	1	30.4246599491
175	90	12	3	9	13.5615288126
175	92	4	0	4	24.8669130988
175	95	11	0	11	29.7859033326
175	96	5	1	4	16.5616850145
175	98	7	1	6	8.77644973617
175	102	2	0	2	38.7590490849
175	103	33	0	33	24.5381962935
175	107	9	1	8	11.0908462699
175	109	4	0	4	19.2283215446
175	110	3	1	2	26.6898803675
175	111	1	0	1	29.5854303925
175	112	5	0	5	27.6419538193
175	113	81	4	77	21.0943257997
175	114	1	0	1	32.985536892
175	116	5	2	3	16.3935252943
175	117	4	2	2	18.159259464
175	118	5	2	3	12.5489092895
175	119	18	5	13	9.27913608672
175	120	2	0	2	27.4534669968
175	121	2	0	2	18.0043368669
175	129	1	0	1	33.8419036082
175	138	0	0	0	38.3749782048
175	140	2	0	2	24.2796784583
175	142	5	0	5	28.0887382659
175	146	2	0	2	16.1073573997
175	147	1	0	1	36.7360117655
175	154	2	0	2	23.7427418133
175	155	143	26	117	7.602069635
175	156	16	1	15	12.5163464184
175	157	2	0	2	16.1403168704
175	158	8	2	6	9.44448444163
175	159	14	6	8	8.04304191616
175	160	5	0	5	17.5550254594
175	162	2	0	2	15.0536940348
175	163	5	2	3	28.5425644166
175	164	75	4	71	6.00045776519
175	165	3	1	2	12.4518286363
175	166	48	15	33	13.1772029101
175	168	134	53	81	6.21406634393
175	169	5	0	5	19.1264625581
175	170	3	1	2	14.1050519811
175	171	211	60	151	5.10584732039
175	172	100	65	35	9.98731187222
175	173	3	0	3	15.3947987254
175	176	4	1	3	35.3569176621
175	177	85	9	76	7.3477577798
175	179	1	0	1	23.3861784056
175	180	3	0	3	17.5615584505
175	183	0	0	0	107.030436115
175	188	1	0	1	105.402692159
175	225	1	0	1	92.2079026389
175	245	3	2	1	40.177481092
175	257	1	0	1	46.4057083192
175	260	1	1	0	42.0690154717
175	277	2	0	2	67.6070453519
175	281	0	0	0	58.3773691305
175	310	4	0	4	48.7988316736
175	319	56	0	56	29.1264339406
175	320	3	0	3	32.013226305
175	321	2	0	2	24.8484372714
175	322	3	0	3	28.2285968258
175	323	3	0	3	22.4778174811
175	324	1	0	1	32.1470545865
175	325	1	0	1	37.5401434586
175	326	2	1	1	26.2744834733
175	329	7	0	7	20.4985233982
175	331	1	0	1	17.2066443206
175	333	1	0	1	57.8886787396
175	334	1	0	1	52.0777543797
175	338	17	0	17	43.0221727771
175	341	2	0	2	51.4613715198
175	347	3	0	3	23.6862234501
175	348	1	0	1	30.423995658
175	349	11	1	10	31.6881431179
175	350	0	0	0	44.4131697577
175	351	1	0	1	31.7624480075
175	353	2	0	2	32.5467102014
175	358	1	0	1	72.0115426285
175	373	1	0	1	65.6143871447
175	375	2	0	2	74.6762111261
175	392	0	0	0	53.9888652106
175	395	1	0	1	68.8419510535
175	406	1	0	1	80.6859315865
175	407	1	0	1	76.4860153902
175	408	1	0	1	79.7928555271
175	415	3	0	3	69.1058422037
175	426	1	0	1	117.62005121
175	431	1	0	1	104.353333218
175	442	1	0	1	99.7206394538
175	455	0	0	0	43.1398775137
175	459	1	0	1	64.1181007931
175	464	0	0	0	69.0647924186
175	475	1	0	1	54.0799033161
175	491	0	0	0	77.7810251499
175	503	1	0	1	71.2905253267
175	507	2	0	2	146.807398186
175	524	3	0	3	81.6757698059
175	551	0	0	0	47.3575164046
175	554	1	0	1	65.5481246771
175	563	0	0	0	52.2107925424
175	568	1	0	1	32.3021278827
175	569	0	0	0	34.4847818404
175	573	20	3	17	38.1025477566
175	576	3	0	3	19.9720849565
175	577	3	0	3	28.543200351
175	581	4	0	4	22.5323667224
176	1	2	0	2	75.0835101526
176	36	1	0	1	52.1216131342
176	42	1	0	1	58.1586675348
176	47	1	0	1	62.3528679552
176	59	1	0	1	61.9215912153
176	70	19	0	19	49.6322821653
176	71	7	2	5	39.2925074533
176	72	3	0	3	50.9330313064
176	73	283	0	283	46.0849032467
176	74	31	0	31	43.0584216421
176	75	52	0	52	43.773082592
176	76	10	3	7	47.0423199527
176	77	2	0	2	50.3489276471
176	78	62	32	30	43.7919521267
176	79	6	0	6	49.9215115762
176	80	2	0	2	48.903894494
176	81	22	1	21	48.9432819715
176	82	16	6	10	46.2055822099
176	83	12	0	12	45.5741766979
176	84	52	7	45	44.8735578678
176	85	10	0	10	43.7984888122
176	86	13	2	11	39.6820122261
176	87	52	0	52	41.3196030441
176	88	23	7	16	39.8255290085
176	89	2	0	2	57.8673769191
176	90	1	0	1	47.055202251
176	92	1	0	1	54.4315387681
176	95	3	0	3	50.0308836853
176	103	17	0	17	43.5016777273
176	107	5	0	5	31.6274538647
176	109	1	0	1	51.721565856
176	110	1	0	1	41.5424934437
176	112	10	0	10	45.8152508334
176	113	55	1	54	39.1331917747
176	117	2	0	2	38.6896144534
176	119	1	0	1	41.9495202858
176	124	1	0	1	33.9799604959
176	135	3	0	3	11.6626079442
176	141	5	1	4	10.0005880383
176	142	32	2	30	28.0181609816
176	144	3	0	3	24.2409201046
176	145	8	0	8	34.1032928145
176	146	3	1	2	34.1796719418
176	147	9	3	6	13.6519366121
176	148	0	0	0	38.1994885806
176	154	23	1	22	16.9528760074
176	155	7	0	7	42.9244926867
176	156	1	0	1	47.8731714364
176	157	9	0	9	19.2174238279
176	158	3	1	2	29.1223790915
176	160	19	3	16	20.4438748956
176	161	13	0	13	12.8469864887
176	162	1	0	1	50.0253988297
176	163	157	25	132	8.41917025247
176	164	4	1	3	35.479297774
176	165	2	0	2	24.6648200622
176	166	10	0	10	45.6982457713
176	167	27	13	14	13.715335665
176	168	33	9	24	31.0184942314
176	169	2	0	2	54.4491269408
176	170	2	0	2	33.8955510192
176	171	7	1	6	39.4940813973
176	172	122	0	122	26.2274578167
176	173	4	1	3	26.4547144539
176	174	9	5	4	6.64648184147
176	175	3	1	2	35.3569176621
176	177	63	0	63	28.2109659312
176	178	15	3	12	6.58042761266
176	307	1	0	1	79.8744124584
176	319	9	0	9	47.8532930145
176	329	2	0	2	51.8809809113
176	330	1	0	1	41.8539813596
176	338	1	0	1	74.8444576717
176	349	2	0	2	61.8519557293
176	355	1	0	1	58.6959628328
176	379	1	0	1	28.9152690627
176	385	6	0	6	27.2657359275
176	386	0	0	0	31.5148949612
176	396	3	0	3	38.2579321989
176	398	1	0	1	58.1999885188
176	406	6	0	6	45.3425382176
176	407	1	0	1	41.1551673153
176	408	43	0	43	44.6921114425
176	411	8	0	8	40.5544691502
176	415	6	0	6	34.0563633979
176	416	1	0	1	52.5764865726
176	417	1	1	0	35.2620956023
176	427	1	0	1	58.8945397893
176	438	1	0	1	68.2747572769
176	442	0	0	0	64.7999171018
176	450	4	0	4	15.5249209251
176	453	1	1	0	31.0673267828
176	454	1	1	0	15.5465607227
176	455	64	1	63	8.18823458992
176	456	4	4	0	5.73139330853
176	457	1	0	1	27.2927322692
176	458	0	0	0	26.6228270645
176	460	14	0	14	21.3939773575
176	461	1	0	1	9.10164213921
176	466	1	0	1	48.4414886334
176	469	1	0	1	36.515770274
176	475	3	0	3	21.5443342423
176	495	1	0	1	44.9421015605
176	501	0	0	0	53.2565678319
176	507	1	0	1	127.427645424
176	524	1	0	1	59.8604759197
176	540	1	0	1	88.9162274538
176	554	0	0	0	48.0999425001
176	555	2	0	2	49.0173891773
176	563	1	0	1	40.5923321709
176	566	4	1	3	23.5620610012
176	567	1	0	1	35.0415863539
176	568	12	6	6	12.4833591659
176	571	1	0	1	30.4228634839
176	573	84	25	59	26.3154578449
176	575	2	0	2	36.2802945701
176	576	2	0	2	31.2703702212
176	577	0	0	0	36.3186904667
176	578	4	0	4	15.2129161715
176	579	1	0	1	31.6206011578
176	580	0	0	0	20.8515826848
176	581	17	6	11	23.4333074533
176	586	1	0	1	63.7296945873
177	1	8	0	8	66.3518564034
177	8	1	0	1	86.9323751607
177	15	0	0	0	56.553699393
177	28	1	0	1	63.9148724171
177	35	1	0	1	49.8381956391
177	36	6	0	6	40.6487089683
177	37	1	0	1	53.9000389332
177	41	1	0	1	43.6479897771
177	45	2	0	2	69.5190221913
177	46	2	0	2	73.8960532923
177	48	2	0	2	62.5747491286
177	59	2	0	2	75.0131341209
177	65	1	0	1	77.8378762164
177	70	87	51	36	25.992605605
177	71	99	0	99	17.8972478173
177	72	4	0	4	28.7881968146
177	73	1125	132	993	26.1630044701
177	74	165	0	165	21.6710387762
177	75	105	0	105	24.6528197588
177	76	32	3	29	23.2582688489
177	77	4	0	4	28.9164116709
177	78	316	4	312	21.4218104128
177	79	18	4	14	29.0568416718
177	80	5	1	4	27.28632111
177	81	46	4	42	26.8656174767
177	82	122	23	99	23.4902475388
177	83	50	0	50	24.5798648118
177	84	169	15	154	24.7129989155
177	85	97	5	92	19.5060642542
177	86	92	0	92	16.8508102552
177	87	280	111	169	21.8398389697
177	88	63	15	48	19.8062946738
177	89	4	0	4	35.9995798662
177	90	7	1	6	20.5081058161
177	92	4	0	4	30.8910147698
177	95	6	0	6	33.2435882501
177	96	3	0	3	23.8732298073
177	97	2	0	2	37.6213693707
177	98	7	5	2	12.8550844757
177	102	1	0	1	42.9051991423
177	103	33	3	30	27.1882777253
177	107	19	3	16	11.4460179173
177	109	3	2	1	25.9859160683
177	110	5	0	5	28.2683751639
177	112	12	0	12	30.3259155563
177	113	94	0	94	23.0157927267
177	116	7	1	6	22.6020730312
177	117	7	1	6	20.5481452656
177	118	1	0	1	18.8390274031
177	119	2	1	1	15.7428054209
177	120	2	1	1	32.0839515524
177	121	4	0	4	19.8598850051
177	122	1	0	1	32.3620844704
177	128	1	0	1	22.8086154082
177	133	0	0	0	33.1134538207
177	135	0	0	0	25.0858963296
177	137	2	0	2	13.704341755
177	140	2	0	2	24.4184919888
177	142	32	2	30	25.5845483112
177	144	1	0	1	18.75388552
177	145	2	0	2	34.2682968508
177	146	4	0	4	17.0584535649
177	147	1	0	1	30.8947252978
177	151	1	0	1	46.2170128365
177	154	10	1	9	18.3743075193
177	155	99	54	45	14.7655510075
177	156	10	1	9	19.7670341708
177	157	35	0	35	9.10284340017
177	158	105	0	105	4.87789647528
177	159	23	2	21	10.1490944588
177	160	26	0	26	12.3105734778
177	161	6	0	6	15.6438466511
177	162	4	1	3	21.8368278353
177	163	18	4	14	21.8374777355
177	164	78	2	76	10.135422072
177	165	47	0	47	5.55692863542
177	166	101	1	100	18.2896957489
177	167	5	1	4	16.4074875453
177	168	281	3	278	6.23825122564
177	169	7	2	5	26.4258321929
177	170	13	4	9	12.2818586628
177	171	78	4	74	12.1392126253
177	172	668	472	196	5.45882090796
177	173	18	6	12	9.92378842526
177	174	1	0	1	30.7334400926
177	175	72	5	67	7.3477577798
177	176	1	0	1	28.2109659312
177	178	1	0	1	22.7399126083
177	179	1	0	1	30.5843235361
177	180	12	1	11	10.3477346069
177	183	1	0	1	113.709108845
177	212	1	0	1	85.0266796831
177	245	2	0	2	46.3042026937
177	247	0	0	0	48.0445393598
177	251	1	0	1	43.0106050142
177	252	1	0	1	56.4099066281
177	258	1	0	1	54.2449495046
177	277	4	0	4	74.0607731529
177	281	0	0	0	65.0283044683
177	284	1	0	1	74.258408923
177	291	1	0	1	82.272554948
177	305	1	0	1	64.9317703886
177	309	1	0	1	57.2836992215
177	310	0	0	0	55.9050211099
177	311	0	0	0	63.6765305969
177	312	1	0	1	65.5269070935
177	319	120	0	120	29.2008584089
177	320	5	1	4	30.5324553265
177	323	8	1	7	20.5391408189
177	325	4	0	4	36.0026959239
177	326	3	0	3	30.2813693505
177	327	3	1	2	35.4344743427
177	328	1	0	1	21.6720931351
177	329	18	2	16	25.2461667943
177	330	1	0	1	29.5410967984
177	331	1	0	1	17.834344957
177	332	3	0	3	60.4358230491
177	333	1	0	1	63.3226180555
177	334	2	1	1	57.1804725323
177	336	1	0	1	49.5074366555
177	338	28	2	26	48.3569851261
177	341	1	0	1	57.6265958493
177	345	0	0	0	92.792440349
177	347	2	0	2	30.351000038
177	349	7	0	7	36.1741498651
177	353	1	0	1	38.8757206685
177	357	1	0	1	39.9418609118
177	358	1	0	1	72.0529927451
177	364	1	0	1	42.4644265327
177	366	2	0	2	39.59786375
177	368	1	0	1	62.0505806845
177	375	6	0	6	81.7745922533
177	379	2	0	2	54.3416702282
177	380	1	0	1	39.0068649919
177	385	1	0	1	49.899485733
177	387	1	0	1	56.4658838122
177	391	2	0	2	48.6349305985
177	392	4	0	4	46.6743543511
177	396	2	0	2	66.400646676
177	397	1	0	1	62.8431549434
177	401	1	0	1	76.1086494665
177	406	4	0	4	73.4814194435
177	408	19	11	8	72.5026624246
177	409	1	0	1	76.1016772885
177	411	1	0	1	67.7446312637
177	415	3	0	3	61.8142300112
177	416	1	0	1	80.6918465786
177	417	1	0	1	62.4102783942
177	421	1	0	1	90.759340496
177	438	2	0	2	94.639558714
177	441	0	0	0	90.2852878763
177	442	1	0	1	92.4000945858
177	454	1	0	1	43.5182251143
177	455	1	0	1	35.8839241615
177	456	1	0	1	33.1389957946
177	459	1	1	0	56.7766474052
177	460	2	0	2	49.5884616529
177	465	0	0	0	65.7129085232
177	466	0	0	0	73.2668814032
177	469	3	0	3	60.0391856281
177	470	1	0	1	52.3670758667
177	474	1	0	1	81.8157695738
177	475	0	0	0	47.5846872937
177	477	0	0	0	67.3557367286
177	484	0	0	0	80.549796414
177	501	1	0	1	80.1204860747
177	503	3	0	3	64.380393938
177	507	1	0	1	141.154530382
177	510	1	0	1	126.291455854
177	512	1	0	1	111.916043553
177	524	6	0	6	75.355468171
177	536	1	0	1	94.0817592942
177	537	0	0	0	89.5692742017
177	540	2	0	2	101.012401303
177	548	1	0	1	141.819321165
177	549	0	0	0	128.22617369
177	551	0	0	0	42.797738125
177	554	1	0	1	59.5808562596
177	555	2	1	1	53.9618638508
177	557	0	0	0	55.0599981514
177	563	4	0	4	46.7215252267
177	566	6	0	6	40.4084024167
177	567	1	0	1	44.6661449443
177	568	5	2	3	25.0619918898
177	569	5	0	5	29.4774197939
177	571	1	0	1	44.2228160348
177	572	1	0	1	39.347847089
177	573	189	109	80	31.9342507373
177	576	2	0	2	16.2102018799
177	577	6	0	6	25.2209414881
177	578	1	0	1	32.5418583685
177	579	4	0	4	23.4607601215
177	580	3	0	3	23.3493947029
177	581	34	0	34	16.4667620765
177	584	1	0	1	59.2932488686
177	585	3	1	2	46.5760849083
178	1	3	0	3	75.507901759
178	24	1	0	1	66.3698481167
178	36	0	0	0	51.4581704077
178	39	1	0	1	61.0848329113
178	50	1	0	1	56.5578175734
178	70	17	0	17	45.9270460399
178	71	17	0	17	35.8436737884
178	72	2	0	2	47.6497303655
178	73	190	27	163	43.2326990965
178	74	27	12	15	39.7565708932
178	75	25	6	19	41.0331962022
178	76	3	0	3	43.2473281363
178	78	38	6	32	40.2756805651
178	79	3	0	3	46.9423187738
178	81	8	0	8	45.6344546998
178	82	17	1	16	42.6690462538
178	83	7	0	7	42.4471124021
178	84	27	1	26	41.9255018114
178	85	9	2	7	39.7966403703
178	86	23	7	16	35.9166337363
178	87	45	2	43	38.3989628525
178	88	10	1	9	36.7151867367
178	89	1	0	1	54.7793862263
178	90	1	0	1	42.444922037
178	92	3	0	3	50.8327701122
178	95	1	0	1	48.0487929746
178	98	1	1	0	32.7670290394
178	100	1	0	1	53.6900658248
178	103	10	1	9	41.4063476078
178	107	3	0	3	27.9491084474
178	109	3	0	3	47.4327728443
178	110	2	0	2	40.0630402674
178	112	1	0	1	44.0025142252
178	113	27	0	27	36.8757575218
178	116	4	1	3	43.3880553609
178	117	1	0	1	35.9490158349
178	120	1	0	1	49.3525509629
178	131	1	0	1	40.4485194969
178	135	2	0	2	13.6351669993
178	137	1	0	1	24.3208647916
178	138	1	0	1	42.0414200107
178	140	3	0	3	34.2062861585
178	141	1	0	1	16.4929718856
178	142	8	0	8	28.0993951824
178	143	2	0	2	25.3906636607
178	146	2	0	2	31.3740697709
178	147	7	0	7	17.7032285036
178	154	20	18	2	15.7914044269
178	155	9	0	9	37.4979889112
178	156	1	0	1	42.5064014751
178	157	14	10	4	14.1853072633
178	158	7	0	7	23.0613938786
178	159	2	0	2	30.7701225915
178	160	18	0	18	17.2772604782
178	161	13	1	12	8.74188049417
178	162	1	0	1	44.3432980883
178	163	94	68	26	8.17315502373
178	164	5	0	5	30.962840196
178	165	9	0	9	18.6460275942
178	166	8	0	8	39.6385683195
178	167	53	7	46	7.23685960205
178	168	38	0	38	26.3761787197
178	169	2	1	1	49.1629422383
178	171	6	1	5	34.509330182
178	172	105	6	99	21.6557746317
178	173	1	0	1	19.9877189047
178	174	2	1	1	12.2647306321
178	175	5	0	5	30.0483520751
178	176	12	3	9	6.58042761266
178	177	73	0	73	22.7399126083
178	180	1	0	1	13.6097336713
178	245	1	0	1	65.7785345885
178	252	1	0	1	77.2969048469
178	281	0	0	0	85.3956931245
178	319	11	4	7	41.2949419727
178	320	2	0	2	38.6641361007
178	323	1	0	1	30.9675660338
178	338	0	0	0	68.4729631369
178	348	1	0	1	60.3867057219
178	367	1	0	1	51.0204717097
178	375	1	0	1	104.363380823
178	379	1	0	1	32.1804771821
178	380	1	0	1	17.1683945574
178	384	1	0	1	20.1677074986
178	385	1	0	1	28.9603446965
178	391	2	0	2	26.1424020396
178	407	1	0	1	46.972254533
178	408	11	2	9	49.7652996548
178	411	0	0	0	45.0719524847
178	417	1	0	1	39.736061027
178	421	1	0	1	68.2030268807
178	438	1	0	1	72.2900414883
178	454	1	0	1	20.884639548
178	455	9	0	9	13.2362223918
178	456	1	0	1	12.3053786524
178	457	1	0	1	33.3240224304
178	460	3	0	3	27.1591323618
178	461	1	0	1	10.6757606078
178	467	1	0	1	21.8961764298
178	500	1	0	1	42.6058349488
178	503	1	0	1	42.6920789494
178	505	0	0	0	65.5899923455
178	507	2	0	2	126.893765246
178	524	2	0	2	59.3940100391
178	549	0	0	0	114.978072246
178	554	1	0	1	46.2083678109
178	555	1	0	1	45.4834435674
178	558	1	0	1	41.6717353558
178	563	1	0	1	37.0702487063
178	566	5	2	3	22.4656080586
178	568	17	1	16	7.81373715883
178	573	93	12	81	21.8513035188
178	575	1	0	1	31.5770628349
178	576	1	0	1	24.691923021
178	577	2	0	2	29.9749788096
178	578	3	0	3	13.4755930545
178	579	6	0	6	25.3558314277
178	580	2	0	2	15.1137177071
178	581	30	4	26	16.9004830706
178	585	2	0	2	48.3122028021
179	0	1	0	1	54.1794002423
179	1	2	0	2	67.1789099803
179	18	1	0	1	51.2143187142
179	24	1	0	1	65.4713950606
179	35	1	0	1	58.6434872394
179	39	1	0	1	45.5571735052
179	41	1	0	1	51.9840045765
179	70	181	21	160	20.9252718888
179	71	18	3	15	26.5984234122
179	72	6	3	3	24.3742691335
179	73	390	0	390	28.27801118
179	74	34	9	25	25.851794962
179	75	27	1	26	29.4571333022
179	76	76	2	74	20.9265039589
179	77	11	2	9	25.8483296142
179	78	94	60	34	24.1441525373
179	79	19	0	19	26.9705592479
179	80	4	0	4	25.2911712331
179	81	39	13	26	24.3420479396
179	82	55	11	44	23.1586714894
179	83	14	0	14	26.3487390679
179	84	58	1	57	27.7869011847
179	85	89	0	89	20.9256916138
179	86	25	0	25	24.6643038472
179	87	40	1	39	28.8855864756
179	88	12	1	11	28.2741445048
179	89	7	0	7	26.8977854485
179	90	24	1	23	14.9373061784
179	92	15	4	11	21.490910122
179	95	4	0	4	34.9671887566
179	96	79	46	33	9.68369996676
179	97	6	4	2	8.72891438107
179	99	1	0	1	42.6053598104
179	100	1	0	1	40.1657249512
179	101	1	0	1	21.8298841702
179	103	10	0	10	33.8815736774
179	105	1	0	1	32.1829611205
179	107	1	0	1	30.4399937502
179	108	2	0	2	8.18305585301
179	109	17	0	17	15.2123309678
179	111	4	0	4	21.9404439592
179	112	13	4	9	35.826923696
179	113	28	0	28	33.4947372351
179	114	1	0	1	41.2217928914
179	116	33	16	17	18.5162070256
179	117	1	0	1	30.8280946211
179	118	1	0	1	18.5656975749
179	119	7	3	4	18.98156262
179	120	3	0	3	29.3266097701
179	122	2	1	1	15.9425253862
179	123	1	0	1	25.8895090462
179	140	1	0	1	39.2563950601
179	142	7	0	7	46.7738724698
179	146	2	0	2	32.3731524384
179	155	120	2	118	15.8226655839
179	156	39	1	38	10.8794208646
179	158	4	0	4	30.8913481553
179	162	34	1	33	9.53988249901
179	163	2	0	2	51.8140951613
179	164	7	0	7	24.6417703965
179	165	1	0	1	34.9765353034
179	166	45	0	45	16.4769213987
179	168	8	0	8	28.3866888007
179	169	232	38	194	4.72317996832
179	170	1	0	1	30.5019866039
179	171	34	0	34	19.7162288325
179	172	14	2	12	32.985161195
179	173	1	0	1	35.9646213517
179	175	2	0	2	23.3861784056
179	177	11	0	11	30.5843235361
179	183	1	0	1	89.9801263283
179	245	2	0	2	30.6974820043
179	247	1	0	1	19.9634523538
179	249	1	0	1	27.7449680603
179	251	1	0	1	19.3336993309
179	264	1	0	1	44.5262622104
179	276	1	0	1	42.3944546147
179	277	1	0	1	53.062311224
179	309	1	0	1	51.6153017319
179	310	14	1	13	25.456181025
179	313	1	0	1	20.1034660609
179	314	1	0	1	26.8725045567
179	316	1	0	1	29.5284448781
179	317	0	0	0	37.3501982244
179	319	34	1	33	35.1923808034
179	321	4	0	4	26.6732025502
179	323	2	0	2	35.4728320918
179	326	5	2	3	21.2182190971
179	329	10	3	7	16.6316139005
179	330	1	0	1	43.3035011797
179	331	1	0	1	27.5475448039
179	332	1	0	1	35.8523921534
179	334	1	0	1	35.7516361607
179	336	0	0	0	22.9381073871
179	337	1	0	1	19.105359652
179	338	44	0	44	26.8093274191
179	341	4	0	4	31.0029080427
179	344	1	0	1	36.1222861136
179	345	2	0	2	62.3575333464
179	347	65	35	30	6.20953023514
179	348	48	4	44	7.099930814
179	349	15	2	13	22.1008641087
179	350	5	0	5	21.4353695697
179	351	1	0	1	18.3403756954
179	352	4	2	2	12.3425366307
179	353	41	2	39	13.3950401628
179	354	4	3	1	12.5922683691
179	357	0	0	0	29.418103241
179	359	0	0	0	40.8877967528
179	364	0	0	0	40.6851653227
179	366	1	0	1	43.2116649478
179	373	1	0	1	42.9946762642
179	375	6	0	6	51.320224277
179	376	1	0	1	54.3324640793
179	408	6	0	6	103.065233014
179	415	1	0	1	92.3773012391
179	453	1	0	1	89.6608223481
179	466	1	0	1	101.373378899
179	493	0	0	0	118.244100617
179	554	1	0	1	83.2620199954
179	566	1	0	1	68.6601371205
179	569	1	0	1	51.438751237
179	573	8	1	7	57.455170563
179	577	1	0	1	42.746007418
179	581	1	0	1	42.8793498217
180	1	2	0	2	72.9362540109
180	20	0	0	0	69.9891470469
180	70	17	0	17	35.9751766947
180	71	21	11	10	26.9969700208
180	72	1	0	1	38.4757218447
180	73	214	34	180	35.1639154171
180	74	26	4	22	30.9487628711
180	75	18	1	17	33.339509105
180	76	11	0	11	33.2258932678
180	78	57	1	56	30.9815258994
180	79	6	2	4	38.4177404891
180	81	11	2	9	36.4955992706
180	82	14	0	14	33.2037388423
180	83	13	6	7	33.8466037208
180	84	26	1	25	33.7327392434
180	85	17	0	17	29.5137521373
180	86	16	1	15	26.3701084688
180	87	50	0	50	30.5057311195
180	88	13	0	13	28.5416278359
180	89	1	0	1	45.7390131214
180	90	2	0	2	30.8547678403
180	92	0	0	0	40.9184268986
180	95	3	1	2	41.5282741689
180	96	1	0	1	34.1201589455
180	97	1	0	1	47.6657001509
180	102	1	0	1	51.5309420075
180	103	14	0	14	35.0598448943
180	107	8	5	3	19.4198567839
180	109	2	0	2	36.3010045202
180	110	2	0	2	35.1330097915
180	111	1	1	0	46.0593796722
180	112	3	1	2	38.0745026154
180	113	28	0	28	30.5539156359
180	116	2	0	2	32.7776679167
180	117	1	0	1	28.6549521809
180	119	1	0	1	26.0457684416
180	120	1	0	1	41.2758130747
180	135	1	0	1	20.7302118959
180	137	0	0	0	18.636251626
180	140	1	0	1	30.156058832
180	142	9	0	9	27.9249635298
180	144	0	0	0	21.0145633549
180	146	1	0	1	24.4302400373
180	147	3	0	3	26.4673015832
180	154	3	0	3	16.8013056692
180	155	16	0	16	24.6044887288
180	157	22	0	22	6.24226588157
180	158	19	1	18	9.52102213808
180	159	2	0	2	17.1824513641
180	160	9	2	7	13.0555031704
180	161	1	1	0	9.60216387409
180	162	1	0	1	31.0401628843
180	163	6	3	3	15.7743968615
180	164	14	0	14	20.1222115307
180	165	39	7	32	5.25846992414
180	166	22	4	18	26.0490209999
180	167	14	0	14	6.53128898444
180	168	48	4	44	15.6779187719
180	169	2	0	2	36.3264426411
180	170	4	1	3	14.2522731944
180	171	13	0	13	22.4759286703
180	172	175	0	175	11.9362887906
180	173	44	0	44	6.98786959371
180	175	2	1	1	17.5615584505
180	176	1	0	1	19.8584313256
180	177	235	6	229	10.3477346069
180	178	1	0	1	13.6097336713
180	183	1	0	1	123.925566775
180	245	1	0	1	56.2987109684
180	262	1	0	1	70.7897579431
180	277	0	0	0	84.180706838
180	293	1	0	1	79.6876460674
180	310	0	0	0	65.2184435675
180	319	18	0	18	29.8549060278
180	320	2	0	2	28.8258951807
180	322	1	0	1	24.3368811762
180	323	4	1	3	19.6009870067
180	325	1	0	1	33.7574532586
180	329	4	0	4	32.0358584764
180	332	1	0	1	67.4130957711
180	336	1	0	1	57.4456829934
180	338	3	0	3	54.991746915
180	341	1	0	1	65.3283642464
180	348	1	0	1	47.3338146209
180	349	1	0	1	42.0477702911
180	350	1	0	1	61.5869489902
180	353	1	0	1	47.0802202862
180	357	2	0	2	44.3323256409
180	375	1	0	1	90.994170215
180	385	0	0	0	39.5831075314
180	392	0	0	0	36.4706776189
180	394	1	0	1	49.5004322693
180	408	6	1	5	63.0158222104
180	415	1	0	1	52.3486878506
180	417	1	0	1	52.6439693351
180	442	2	0	2	82.7140541235
180	445	1	0	1	89.3663008752
180	466	0	0	0	67.3885416401
180	469	1	0	1	54.6884313865
180	491	0	0	0	67.9658042897
180	520	0	0	0	63.5400037799
180	548	1	0	1	133.400594108
180	554	1	0	1	50.2518903497
180	555	1	0	1	45.8961154388
180	561	1	0	1	62.4686633811
180	563	1	0	1	38.1418139176
180	566	1	0	1	30.1206444795
180	568	5	0	5	14.7409626433
180	569	0	0	0	22.2181259616
180	571	1	0	1	34.2488799417
180	572	1	0	1	34.3070607816
180	573	64	0	64	22.676129311
180	575	1	0	1	29.951740296
180	576	1	0	1	13.4132556457
180	577	9	0	9	21.2499201555
180	579	4	0	4	17.7948603986
180	580	2	1	1	13.8006120955
180	581	49	9	40	8.59078455345
180	585	1	0	1	42.2389355022
181	1	26	0	26	73.4335677239
181	5	1	0	1	82.9659896062
181	24	1	0	1	82.6733293825
181	26	1	0	1	93.8541845161
181	28	3	0	3	69.2775569276
181	32	1	1	0	63.5634790008
181	36	2	0	2	78.9740960998
181	70	7	0	7	75.9171140275
181	73	90	25	65	78.9809892617
181	74	7	0	7	82.0635520327
181	75	3	0	3	81.3260766685
181	76	1	0	1	78.6375754486
181	78	8	1	7	81.4964100402
181	79	3	0	3	75.1215688684
181	80	0	0	0	76.1564804515
181	81	5	1	4	76.1708594293
181	82	12	0	12	79.1050578051
181	83	1	0	1	79.4737399603
181	84	12	0	12	80.1670918745
181	85	2	0	2	82.2351288304
181	87	4	0	4	83.7197095418
181	88	1	0	1	85.2286693056
181	90	1	0	1	80.9749511703
181	92	1	0	1	70.9774738887
181	96	4	1	3	78.8073068564
181	103	2	0	2	82.2355195884
181	110	1	0	1	85.2204969876
181	111	1	0	1	65.6624987214
181	112	2	0	2	80.5554946411
181	113	8	0	8	86.2574655012
181	120	4	0	4	73.1357221379
181	122	1	0	1	69.0117797729
181	123	1	0	1	61.0104283045
181	131	1	0	1	122.197734077
181	142	5	1	4	100.35166049
181	146	1	0	1	90.8605806314
181	150	1	0	1	124.912061667
181	177	0	0	0	101.320114883
181	182	16	3	13	21.543458377
181	183	1378	243	1135	12.9829045542
181	184	90	1	89	11.3077191755
181	185	23	9	14	17.2730266579
181	186	277	30	247	8.19907224769
181	187	24	5	19	19.4979611521
181	188	90	0	90	14.3725576021
181	189	4	1	3	18.3389146985
181	190	40	0	40	20.1046219268
181	191	2	0	2	35.6023905746
181	194	2	0	2	27.2636790103
181	196	1	0	1	46.5813334497
181	198	1	0	1	55.4684107262
181	199	1	0	1	42.6566990168
181	200	2	0	2	39.2763786203
181	202	3	0	3	38.6486036255
181	204	1	0	1	36.5260145543
181	206	6	0	6	34.336117077
181	207	3	0	3	31.9753829654
181	208	22	0	22	39.3282678178
181	209	2	0	2	32.6242780382
181	211	4	0	4	41.8356289088
181	212	12	0	12	30.343488886
181	213	2	0	2	37.3067974117
181	214	2	0	2	40.5369801756
181	216	1	0	1	26.7919601716
181	217	5	0	5	27.4497531208
181	218	2	0	2	21.7733981845
181	219	2	0	2	34.6188324297
181	220	78	9	69	29.3484142956
181	222	5	0	5	23.4691436039
181	223	11	3	8	25.253741784
181	224	7	0	7	26.0437284754
181	225	6	0	6	27.1248132444
181	226	2	0	2	33.6739229528
181	227	4	0	4	19.0768358357
181	228	1	0	1	35.0098416438
181	229	35	2	33	27.7040859967
181	230	1	0	1	31.2002546721
181	231	1	0	1	22.4993732102
181	232	7	1	6	22.3951250327
181	233	2	0	2	24.4799376097
181	234	5	0	5	17.3784229639
181	235	36	10	26	11.0972446842
181	236	39	1	38	16.148856445
181	237	2	1	1	26.6056996478
181	238	51	4	47	11.4657978523
181	239	10	2	8	20.989435444
181	241	3	1	2	52.752162018
181	242	2	0	2	45.9076709389
181	243	8	0	8	39.8526255194
181	244	5	0	5	48.3388787978
181	245	5	1	4	56.0840529138
181	251	1	0	1	59.0923696192
181	257	2	0	2	54.4171778256
181	262	5	0	5	41.1401156118
181	265	5	0	5	27.7023352778
181	266	29	1	28	16.4706941878
181	267	1	0	1	21.2436600595
181	268	58	0	58	9.52705551102
181	269	1	0	1	20.8776829065
181	270	1	0	1	33.3428473038
181	271	183	23	160	11.0650493823
181	272	19	10	9	21.8157872529
181	273	2	0	2	29.6030274425
181	274	3	0	3	35.0779830667
181	275	8	1	7	25.9286504033
181	276	2	0	2	34.6998428293
181	277	245	10	235	28.4478898191
181	278	69	63	6	8.26044543981
181	279	2	0	2	36.7106344132
181	280	4	1	3	20.917680395
181	281	2	0	2	36.3974738811
181	282	4	0	4	34.3908533026
181	284	2	0	2	28.794182586
181	285	7	1	6	18.3436513543
181	286	1	0	1	39.9055061307
181	287	2	0	2	25.3871575215
181	290	6	0	6	15.5661761425
181	291	1	0	1	25.5680061387
181	292	1	0	1	30.1846729186
181	293	5	2	3	38.5874920528
181	294	2	0	2	48.4732887911
181	303	0	0	0	63.5897797503
181	305	3	0	3	43.8017447627
181	307	7	2	5	53.8649586061
181	309	2	0	2	60.6801294614
181	415	1	0	1	158.152815597
181	466	0	0	0	152.248775583
181	468	1	0	1	124.901899408
181	471	1	0	1	133.626443002
181	507	1	0	1	239.285165805
182	1	46	0	46	86.2046121644
182	3	1	0	1	88.9376172603
182	9	1	0	1	85.3831048413
182	13	1	0	1	92.9856931993
182	15	1	0	1	93.031469283
182	25	1	0	1	101.978114798
182	28	3	0	3	82.7775896076
182	31	1	0	1	104.515610746
182	32	2	0	2	80.1608986778
182	33	1	0	1	98.4273078884
182	34	1	0	1	114.122848258
182	36	5	0	5	96.2390261962
182	43	1	0	1	135.273964403
182	53	1	0	1	113.797843598
182	59	1	0	1	140.249505553
182	60	1	0	1	122.511514826
182	64	1	0	1	113.254586865
182	65	2	0	2	125.170642955
182	70	9	1	8	96.1291101755
182	73	75	1	74	98.5186751815
182	74	7	0	7	101.924602716
182	75	6	0	6	100.79688295
182	76	3	0	3	98.8736387729
182	78	7	0	7	101.503846693
182	79	1	0	1	94.7459587653
182	81	6	0	6	96.0687376763
182	82	18	2	16	99.1507755974
182	83	1	0	1	99.2206258313
182	84	7	1	6	99.783048037
182	85	3	0	3	102.546956294
182	86	2	0	2	106.005323796
182	88	1	0	1	104.959886294
182	89	3	0	3	86.8881725204
182	90	1	0	1	101.712538348
182	92	3	0	3	91.1727301199
182	95	1	0	1	94.9388219542
182	96	1	0	1	99.8320927584
182	99	1	0	1	106.904508713
182	100	0	0	0	90.9241857094
182	101	1	0	1	82.2332533203
182	103	2	0	2	101.235437034
182	105	1	0	1	86.4697791288
182	107	1	0	1	113.792806192
182	110	1	0	1	103.839757899
182	111	1	0	1	85.9799114332
182	112	3	0	3	99.2598411451
182	113	10	1	9	105.468875317
182	114	0	0	0	98.6671793202
182	115	0	0	0	84.4077344626
182	120	0	0	0	92.4938349372
182	122	0	0	0	89.7459928268
182	131	1	0	1	138.616301372
182	140	1	0	1	109.739897024
182	142	9	1	8	118.847671022
182	164	1	0	1	111.918525985
182	166	1	0	1	114.437908396
182	169	1	0	1	100.060316872
182	172	1	0	1	120.688355564
182	177	0	0	0	121.860959561
182	181	8	0	8	21.543458377
182	183	1264	498	766	8.56404398122
182	184	19	1	18	14.0847071266
182	185	13	2	11	12.7951832696
182	186	39	13	26	21.0830115738
182	187	10	1	9	26.6515918559
182	188	53	3	50	19.3223466144
182	189	17	4	13	5.19858264012
182	190	250	4	246	12.318948847
182	191	3	2	1	34.4845366537
182	192	1	0	1	40.4908989087
182	193	1	0	1	26.5259757678
182	194	1	0	1	32.1293955767
182	195	1	0	1	45.5667412995
182	196	1	0	1	53.1674749203
182	198	2	0	2	58.0549500313
182	199	1	0	1	54.8315740943
182	200	1	0	1	49.1897455646
182	202	1	0	1	45.2220167001
182	204	1	1	0	56.6482431893
182	207	4	0	4	49.9340721384
182	208	17	2	15	56.3173439807
182	209	3	0	3	49.7981010007
182	210	1	0	1	46.5247882605
182	211	1	0	1	56.4906853678
182	213	2	0	2	52.2163436879
182	214	1	0	1	59.3657809951
182	216	7	2	5	13.3503814115
182	217	3	0	3	21.536511154
182	218	2	0	2	22.1704149618
182	219	5	1	4	26.58909624
182	220	159	4	155	18.008736208
182	221	4	0	4	15.4526484158
182	222	84	39	45	7.92092257042
182	223	2	1	1	34.8115274579
182	225	8	3	5	42.415017306
182	226	1	0	1	47.6582014159
182	229	20	3	17	40.4300499115
182	231	1	0	1	42.8473669149
182	232	1	0	1	40.3214134062
182	234	3	0	3	34.4231515096
182	235	3	0	3	32.0716020665
182	236	2	0	2	36.2086125769
182	239	3	0	3	35.7092620554
182	240	1	0	1	48.4277828897
182	242	5	2	3	38.3232209484
182	243	3	0	3	32.6075266473
182	244	4	0	4	43.5407614931
182	245	4	1	3	75.9344580087
182	249	1	0	1	71.0491666099
182	250	0	0	0	67.3903470972
182	251	1	0	1	80.2145059177
182	254	2	0	2	70.6268412541
182	257	3	1	2	72.8936242128
182	258	2	0	2	73.9484112032
182	260	1	0	1	76.3907285014
182	262	2	0	2	61.2503539591
182	265	1	0	1	40.811686665
182	266	3	0	3	31.6672351282
182	267	1	0	1	35.4229703208
182	268	7	1	6	24.4027782868
182	271	7	1	6	32.5912362727
182	272	3	0	3	43.3314211473
182	274	2	0	2	54.6699895148
182	275	2	0	2	43.2403831318
182	276	2	0	2	56.1827395732
182	277	100	12	88	47.9190019992
182	279	1	0	1	54.5623518021
182	281	2	0	2	56.8738851184
182	282	4	0	4	55.4169950899
182	284	1	0	1	50.3275164002
182	287	2	1	1	46.6505092642
182	293	3	1	2	59.9896962561
182	294	0	0	0	69.4226800969
182	303	2	0	2	76.3500476854
182	305	2	0	2	60.8845250042
182	307	3	0	3	69.1009842339
182	338	0	0	0	110.906345678
182	346	1	0	1	62.7745165793
182	375	2	0	2	78.3683791258
182	397	1	0	1	175.563523816
182	426	1	0	1	222.785869217
182	465	1	0	1	164.798558783
182	471	1	0	1	148.446113238
182	487	1	0	1	157.251168731
182	491	3	0	3	160.694634309
182	494	1	0	1	157.378386474
182	496	1	1	0	163.42921366
182	552	1	0	1	185.286484657
182	573	1	0	1	153.312074577
183	0	3	0	3	82.1803953089
183	1	233	2	231	80.8334819204
183	2	1	0	1	91.0051407842
183	3	2	0	2	82.2852653326
183	5	10	0	10	89.6911671257
183	6	1	0	1	98.7925938301
183	7	5	0	5	85.2970239436
183	12	1	0	1	86.0198967569
183	13	5	0	5	86.6085852543
183	15	12	0	12	87.0342890888
183	17	0	0	0	95.8927524792
183	18	1	0	1	85.5775115191
183	19	3	0	3	79.6222623131
183	20	1	0	1	95.0673596599
183	21	3	0	3	89.978730852
183	23	1	0	1	90.580651634
183	24	3	0	3	90.8134292414
183	27	1	0	1	101.21702399
183	28	20	1	19	77.1198167089
183	29	1	0	1	104.358095884
183	30	1	0	1	101.483020254
183	31	1	0	1	97.6255983502
183	32	5	1	4	73.3744585915
183	33	1	0	1	91.9234577761
183	34	1	0	1	107.653462517
183	35	2	0	2	95.6166224539
183	36	27	17	10	89.265602255
183	39	1	0	1	78.4169497419
183	45	1	0	1	137.363686976
183	46	3	0	3	112.114725217
183	48	3	0	3	123.506325754
183	50	4	0	4	112.612187666
183	55	3	0	3	120.163519839
183	59	1	0	1	134.847500119
183	62	1	0	1	127.268640065
183	65	3	0	3	120.326984721
183	68	1	0	1	117.094346716
183	70	49	0	49	88.0846035144
183	71	10	0	10	97.9352437686
183	72	4	0	4	86.1226054316
183	73	928	0	928	90.7229853749
183	74	44	0	44	94.0142226454
183	75	75	6	69	93.028403254
183	76	13	1	12	90.8226349701
183	77	1	0	1	86.5566127278
183	78	73	1	72	93.5392236876
183	79	14	0	14	86.9139820484
183	80	2	0	2	88.0648531577
183	81	46	0	46	88.1388831041
183	82	113	2	111	91.1699410416
183	83	34	0	34	91.3493290951
183	84	127	0	127	91.9602713372
183	85	15	1	14	94.4707889199
183	86	11	0	11	98.0069343384
183	87	24	0	24	95.5131096538
183	88	12	1	11	97.100266105
183	89	14	0	14	79.0113961921
183	90	7	0	7	93.4773187636
183	92	12	0	12	83.1296461921
183	95	10	0	10	87.4412164759
183	96	6	0	6	91.4877052897
183	98	1	0	1	101.508145017
183	100	1	0	1	83.6963749838
183	101	3	0	3	74.0474882245
183	102	2	0	2	78.2699146395
183	103	33	0	33	93.6397433107
183	104	1	0	1	82.7984694866
183	106	2	0	2	74.0872264972
183	109	2	0	2	87.8118408235
183	110	9	0	9	96.3873020635
183	111	5	0	5	77.8873808694
183	112	19	1	18	91.7689586161
183	113	73	0	73	97.8012341956
183	115	1	0	1	76.1492767348
183	116	2	0	2	91.1479403232
183	117	2	0	2	98.1136812802
183	118	1	0	1	94.8728082757
183	120	4	0	4	84.7550474297
183	121	1	0	1	99.5627049941
183	124	2	0	2	118.415538008
183	128	1	0	1	117.661431589
183	129	0	0	0	98.2302611438
183	131	4	0	4	132.035808892
183	140	2	0	2	102.237779459
183	142	85	17	68	111.461185561
183	144	2	0	2	112.965731291
183	145	2	0	2	110.369475164
183	147	2	0	2	129.751707582
183	151	1	0	1	125.252641178
183	154	1	0	1	120.00421551
183	155	1	0	1	101.647165173
183	163	2	0	2	128.397470874
183	164	2	0	2	103.816719866
183	169	2	0	2	91.6236926865
183	171	1	0	1	101.925099937
183	172	1	0	1	112.664719071
183	177	4	0	4	113.709108845
183	181	375	37	338	12.9829045542
183	182	479	176	303	8.56404398122
183	184	406	148	258	7.85959536751
183	185	300	77	223	10.1104810392
183	186	954	294	660	13.4324016386
183	187	242	0	242	21.4635894866
183	188	705	16	689	13.8265368999
183	189	59	21	38	6.11626348098
183	190	1170	802	368	12.0523676477
183	191	37	8	29	33.1145042496
183	192	8	3	5	37.4162409037
183	193	19	4	15	24.3237651096
183	194	24	0	24	28.2152970109
183	196	70	15	55	49.3657733649
183	198	12	0	12	55.8710276894
183	199	2	0	2	49.0794989296
183	200	5	2	3	44.1080750661
183	201	2	0	2	58.28712796
183	202	6	0	6	41.2330473013
183	204	5	0	5	48.4421640828
183	205	1	0	1	54.0243935522
183	206	2	0	2	45.4102981197
183	207	23	5	18	42.3013946966
183	208	259	5	254	49.0292539022
183	209	33	9	24	42.3917992341
183	210	7	0	7	39.366114776
183	211	18	4	14	49.9405622513
183	212	37	6	31	41.9666999022
183	213	19	0	19	45.5309609427
183	214	18	0	18	51.5423154122
183	215	1	0	1	57.5700508917
183	216	33	10	23	16.6295029635
183	217	68	9	59	21.4430341495
183	218	45	0	45	19.1367589468
183	219	24	1	23	27.9483277025
183	220	1039	111	928	20.4895746713
183	221	30	1	29	15.3854266297
183	222	143	30	113	11.9414778533
183	223	50	0	50	29.3774892521
183	224	12	0	12	35.54173336
183	225	80	10	70	35.4472661761
183	226	6	1	5	41.1928472378
183	227	64	0	64	24.0833765065
183	228	4	0	4	41.0593591646
183	229	374	140	234	34.1903916966
183	230	12	0	12	34.6773126137
183	231	5	0	5	34.5324765002
183	232	18	0	18	32.583575889
183	233	6	0	6	35.4126315167
183	234	21	0	21	26.7856217654
183	235	31	4	27	23.5798708957
183	236	96	0	96	27.9149009557
183	237	14	0	14	37.920808933
183	238	48	0	48	20.282482129
183	239	47	1	46	28.7242580391
183	240	2	0	2	47.7242331574
183	241	14	0	14	47.2273246287
183	242	45	9	36	39.9623480885
183	243	50	0	50	33.8883056508
183	244	44	0	44	44.0836571125
183	245	31	7	24	67.992887037
183	246	2	0	2	70.7616137812
183	247	2	0	2	70.2560627428
183	249	0	0	0	62.6260554399
183	250	3	0	3	59.3366331707
183	251	5	0	5	71.8260780764
183	252	1	0	1	57.4709670242
183	253	2	0	2	58.3967440342
183	254	3	0	3	62.4144777239
183	255	1	0	1	57.8561255884
183	256	0	0	0	73.1334656523
183	257	10	1	9	65.4199456808
183	260	4	0	4	68.7613926855
183	261	1	0	1	61.360417542
183	262	18	14	4	53.1880503803
183	264	7	5	2	60.3053318433
183	265	5	0	5	34.746509562
183	266	88	3	85	24.6325888606
183	267	4	0	4	28.8415507685
183	268	161	38	123	16.9525708063
183	269	1	0	1	25.4315955095
183	270	6	1	5	41.5043026565
183	271	79	6	73	24.0392039195
183	272	23	0	23	34.7684069379
183	273	1	0	1	42.3992153989
183	274	7	0	7	46.7521275429
183	275	15	1	14	35.9186856037
183	276	9	0	9	47.6518721011
183	277	1188	137	1051	40.001469624
183	278	18	2	16	20.2655852237
183	279	6	1	5	47.1996158872
183	280	8	0	8	32.4509406182
183	281	24	1	23	48.6811153562
183	282	34	9	25	47.0432909377
183	283	2	0	2	51.1782220557
183	284	2	0	2	41.7740816546
183	285	6	1	5	31.0435774488
183	286	2	0	2	52.6052017876
183	287	12	2	10	38.1902217404
183	288	6	0	6	29.0967929382
183	289	1	0	1	46.2488382062
183	290	6	1	5	26.862421548
183	291	7	0	7	38.1129687593
183	292	1	0	1	42.9132064807
183	293	15	2	13	51.4498540685
183	294	1	0	1	61.0056077596
183	295	1	0	1	46.5154583904
183	298	0	0	0	48.6815371611
183	303	6	0	6	70.9203222378
183	304	3	0	3	75.5054773466
183	305	15	0	15	53.8231411714
183	307	14	0	14	62.7335381376
183	309	2	0	2	69.991274512
183	319	1	0	1	124.971295391
183	320	1	0	1	131.173913815
183	329	1	0	1	106.367498386
183	338	1	0	1	102.395787067
183	345	14	0	14	56.0463686162
183	346	3	0	3	57.8765227499
183	349	1	0	1	107.808987703
183	350	1	0	1	72.8371287328
183	353	1	0	1	94.5465183334
183	366	1	0	1	131.87318231
183	369	0	0	0	78.023387848
183	375	7	0	7	70.6498581112
183	377	1	0	1	77.0972216542
183	408	0	0	0	179.615607912
183	415	2	0	2	169.574675693
183	416	2	0	2	185.59462549
183	426	1	0	1	215.63487728
183	438	1	0	1	204.756224256
183	465	1	0	1	158.084491086
183	466	2	0	2	161.993428401
183	468	1	0	1	135.077743348
183	469	6	0	6	150.012115494
183	470	0	0	0	141.094876936
183	471	15	1	14	142.487039202
183	475	4	0	4	146.953130673
183	476	1	0	1	130.930434953
183	478	1	0	1	168.307838303
183	480	1	0	1	146.758825423
183	488	2	0	2	157.017668393
183	491	3	0	3	154.488082051
183	501	1	0	1	173.862820145
183	503	1	0	1	165.712826147
183	505	1	0	1	174.518832264
183	507	1	0	1	252.163643335
183	515	1	0	1	217.340503925
183	527	1	0	1	204.368179148
183	573	2	0	2	145.052738838
183	581	1	0	1	129.533476281
184	0	1	0	1	74.7490777283
184	1	19	1	18	73.0691177689
184	5	1	0	1	81.8602785339
184	7	1	0	1	77.7690214939
184	13	1	0	1	79.1821415414
184	15	1	0	1	79.4471495963
184	20	1	0	1	87.3021434733
184	24	1	0	1	83.1403261516
184	34	1	0	1	100.28194099
184	36	1	0	1	82.2044402528
184	39	1	0	1	71.308851344
184	46	1	0	1	104.290937101
184	58	1	0	1	108.062170844
184	68	1	0	1	109.592587744
184	70	3	0	3	82.3121815732
184	73	45	2	43	84.5271475221
184	75	5	0	5	86.7920344039
184	76	1	0	1	85.0604288615
184	77	1	0	1	80.4838221949
184	78	4	0	4	87.6137063967
184	79	0	0	0	80.7747309613
184	80	1	0	1	82.0261823489
184	81	1	0	1	82.1569801699
184	82	5	1	4	85.2751052903
184	83	2	0	2	85.2688684098
184	84	10	0	10	85.8042195715
184	85	1	0	1	88.755723618
184	87	2	0	2	89.3461654449
184	88	2	0	2	90.9982501615
184	90	2	0	2	88.129889066
184	96	2	0	2	86.4667327833
184	103	1	0	1	87.1752966491
184	110	1	0	1	89.7584912638
184	112	1	1	0	85.1826954038
184	113	5	0	5	91.4260819432
184	128	1	0	1	111.099425929
184	142	3	0	3	104.763033614
184	177	1	0	1	108.140507886
184	181	77	0	77	11.3077191755
184	182	24	1	23	14.0847071266
184	183	1423	569	854	7.85959536751
184	185	17	2	15	17.5801689101
184	186	100	13	87	16.2539139519
184	187	14	0	14	26.6040805846
184	188	50	0	50	19.4008842533
184	189	2	0	2	13.6491289021
184	190	273	34	239	8.81145904433
184	191	1	0	1	40.1153537925
184	192	1	0	1	43.4910588515
184	196	2	0	2	54.7489911691
184	199	0	0	0	52.6943374941
184	206	1	0	1	45.6437730513
184	207	3	2	1	43.221977205
184	208	15	2	13	50.4844747613
184	209	4	1	3	43.769117916
184	211	2	0	2	52.5446371372
184	212	2	0	2	41.6137109904
184	214	2	0	2	51.8445532282
184	217	4	0	4	29.0457637276
184	218	3	0	3	25.8407699049
184	219	1	0	1	35.7129658271
184	220	51	4	47	28.3487103683
184	221	2	0	2	23.1245385953
184	222	8	2	6	19.4993192012
184	223	3	0	3	33.8692034215
184	225	7	0	7	37.7901699199
184	226	1	0	1	44.1005959356
184	227	5	0	5	27.9823487132
184	229	21	5	16	37.6009306543
184	231	1	0	1	33.70706131
184	232	1	0	1	33.5714551194
184	234	1	0	1	28.275036943
184	235	2	0	2	22.2502022116
184	236	6	1	5	27.4441112036
184	238	6	0	6	21.9407365043
184	239	1	0	1	31.3165322666
184	242	3	0	3	47.7034030008
184	243	2	1	1	41.6039804896
184	244	1	0	1	51.5855688294
184	245	1	0	1	62.0517005621
184	250	0	0	0	53.6263564154
184	257	2	1	1	58.8192265454
184	265	5	2	3	27.1179318688
184	266	39	10	29	17.5837490067
184	267	4	0	4	21.4498375909
184	268	89	10	79	10.4637232355
184	269	2	0	2	17.6141110576
184	270	4	0	4	34.026758381
184	271	20	1	19	21.0203160102
184	272	1	0	1	31.971384313
184	274	1	0	1	40.8124058383
184	275	6	0	6	29.1614151865
184	276	2	0	2	43.8057585953
184	277	90	1	89	34.0868390914
184	278	3	0	3	15.8559999283
184	280	2	0	2	26.7386073134
184	281	0	0	0	43.3325289523
184	282	1	0	1	42.2839918416
184	283	1	0	1	43.7248829885
184	284	1	0	1	38.3022563848
184	285	1	0	1	26.764709735
184	287	3	0	3	33.933100751
184	290	4	0	4	21.2396376929
184	292	2	0	2	40.8117279776
184	293	1	0	1	48.8667649299
184	301	1	0	1	55.3652377424
184	303	2	0	2	63.1621160482
184	305	3	0	3	46.8186471292
184	307	3	2	1	55.2858221757
184	319	1	0	1	120.805143114
184	322	0	0	0	124.931348601
184	358	1	0	1	151.96684748
184	487	1	0	1	144.013691655
185	0	2	0	2	89.9275537988
185	1	21	0	21	89.5176256584
185	3	1	0	1	89.6965774648
185	13	1	0	1	94.3271453664
185	23	2	0	2	99.0817970904
185	28	3	0	3	85.5912460969
185	35	1	0	1	103.368788928
185	36	3	0	3	96.1984785184
185	39	3	0	3	85.4993795658
185	56	1	0	1	121.280587418
185	65	1	1	0	129.274318118
185	70	4	0	4	92.7983429504
185	73	81	4	77	96.1017203673
185	74	6	0	6	99.0794955053
185	75	7	1	6	98.4595969613
185	76	5	0	5	95.4989574264
185	77	1	0	1	91.7631674446
185	78	6	4	2	98.4567766819
185	79	1	0	1	92.2263345869
185	81	7	0	7	93.1862751686
185	82	9	1	8	96.0548785093
185	83	3	0	3	96.5336668046
185	84	9	0	9	97.2648343124
185	85	1	0	1	99.0458675573
185	86	3	0	3	102.802112402
185	87	4	0	4	100.812998994
185	89	1	0	1	84.2649457389
185	90	2	0	2	97.4881589629
185	95	3	0	3	93.4919763592
185	96	1	0	1	95.0214134789
185	103	1	0	1	99.4551486588
185	107	1	0	1	110.774221925
185	110	0	0	0	102.476746551
185	111	2	0	2	82.5226872715
185	112	4	0	4	97.807944577
185	113	13	1	12	103.439262801
185	119	1	0	1	102.203138201
185	131	1	0	1	139.355264131
185	142	17	0	17	117.609887606
185	145	1	0	1	117.116222949
185	171	1	0	1	105.948934928
185	177	0	0	0	117.93630061
185	181	27	6	21	17.2730266579
185	182	42	0	42	12.7951832696
185	183	1833	37	1796	10.1104810392
185	184	24	7	17	17.5801689101
185	186	121	0	121	12.1035875804
185	187	75	11	64	14.0418077976
185	188	246	0	246	7.37944920871
185	189	15	0	15	7.66209063419
185	190	34	0	34	21.7283593505
185	191	8	2	6	23.0802136052
185	193	5	2	3	14.4362664648
185	194	5	0	5	19.3795273188
185	196	10	0	10	40.5124372658
185	202	1	0	1	32.5028006117
185	206	1	0	1	42.8653685615
185	208	27	4	23	44.7883650866
185	209	1	0	1	38.5179641414
185	211	4	1	3	44.2414471486
185	212	3	0	3	40.3400973222
185	213	4	0	4	40.1036885361
185	214	2	0	2	48.6752302796
185	216	15	11	4	9.85812405744
185	217	50	3	47	11.4725410125
185	218	33	19	14	9.5635384757
185	219	9	0	9	18.3036277834
185	220	422	1	421	12.0848922791
185	221	61	0	61	5.86208829115
185	222	50	24	26	8.53448682588
185	223	15	0	15	22.1710157282
185	224	3	0	3	31.8498692037
185	225	11	0	11	30.7044429003
185	226	2	0	2	35.4196104063
185	227	11	1	10	18.216781025
185	228	2	0	2	34.2450573079
185	229	53	10	43	28.1201725838
185	230	1	0	1	26.6760397027
185	233	1	0	1	33.2651024918
185	234	2	0	2	23.9783190506
185	235	5	0	5	24.8706955572
185	236	12	0	12	27.5447117899
185	237	3	0	3	36.0849161031
185	238	8	0	8	18.3428641539
185	239	9	2	7	24.1873735598
185	240	0	0	0	37.6379996917
185	241	2	0	2	37.4066764141
185	242	8	2	6	30.2079818555
185	243	13	0	13	24.0867767894
185	244	11	3	8	34.0290431602
185	245	4	0	4	73.1713915811
185	251	1	0	1	75.2780373033
185	257	4	1	3	71.6901936328
185	260	1	0	1	74.6849198666
185	262	3	0	3	58.2064762387
185	264	1	0	1	66.9448725385
185	266	5	0	5	32.4832714803
185	268	4	0	4	24.6947516486
185	269	1	0	1	34.6205143666
185	270	2	0	2	49.6486331247
185	271	7	0	7	27.2615790477
185	272	6	2	4	36.7016819625
185	274	3	1	2	52.3007552392
185	276	2	0	2	50.3023928273
185	277	134	2	132	45.7062281549
185	279	1	0	1	53.9168057041
185	281	0	0	0	53.3391953552
185	282	1	0	1	50.9371138108
185	284	1	0	1	44.1704391698
185	286	1	0	1	56.3093650501
185	287	2	0	2	41.7719236531
185	288	1	0	1	36.0182242822
185	290	1	0	1	32.8176414019
185	291	1	0	1	38.373585337
185	294	1	0	1	60.5350196743
185	303	1	0	1	79.607713951
185	307	4	1	3	70.6185479786
185	345	3	0	3	51.4488801957
185	382	0	0	0	197.586335173
185	464	1	0	1	149.975632857
185	466	1	0	1	169.394255998
185	469	1	0	1	157.14541674
185	484	1	0	1	153.744935264
185	568	1	0	1	142.789294527
185	573	1	0	1	148.764704786
186	0	1	0	1	80.4414278669
186	1	36	3	33	81.3600029226
186	3	1	0	1	79.8421303828
186	9	1	0	1	77.509294185
186	12	1	0	1	87.8224780726
186	15	2	0	2	86.0888881199
186	28	3	0	3	77.1200094522
186	32	1	0	1	70.7623277964
186	36	5	0	5	85.8505307782
186	39	1	0	1	75.3503265206
186	46	2	1	1	113.079454876
186	70	8	0	8	81.130014332
186	71	2	0	2	91.3376492099
186	72	2	0	2	79.66598668
186	73	107	0	107	84.7128426845
186	74	3	0	3	87.5369602384
186	75	11	1	10	87.0897120349
186	76	4	0	4	83.810259961
186	78	10	0	10	86.853979596
186	79	1	0	1	80.8173327507
186	81	2	0	2	81.6520319296
186	82	18	1	17	84.444840089
186	83	4	0	4	85.0508968003
186	84	14	1	13	85.8362660548
186	85	3	0	3	87.3136589906
186	86	1	0	1	91.1417144848
186	87	3	0	3	89.372219437
186	88	4	0	4	90.783994992
186	89	3	0	3	72.8566296994
186	90	2	0	2	85.5912269911
186	92	3	0	3	76.2413011588
186	95	2	0	2	82.4939641649
186	96	2	0	2	83.025302673
186	98	1	0	1	94.3777239203
186	102	1	0	1	74.1145597763
186	103	6	0	6	88.2904421152
186	112	9	1	8	86.78510863
186	113	11	3	8	92.1625647111
186	131	1	0	1	129.205946296
186	134	1	0	1	101.780595067
186	142	13	0	13	106.595011988
186	143	1	0	1	114.942346102
186	151	1	0	1	122.261821696
186	177	0	0	0	106.069793021
186	181	234	14	220	8.19907224769
186	182	39	5	34	21.0830115738
186	183	2478	518	1960	13.4324016386
186	184	36	0	36	16.2539139519
186	185	45	14	31	12.1035875804
186	187	129	1	128	11.3537893996
186	188	343	14	329	6.75134020413
186	189	7	0	7	16.4761602691
186	190	68	0	68	24.1648038052
186	191	6	0	6	27.4712316857
186	192	3	1	2	28.6592287854
186	193	5	0	5	18.9191494985
186	194	18	0	18	19.1216509385
186	196	11	1	10	38.9629497409
186	198	3	1	2	47.4194265658
186	199	1	0	1	36.4836342858
186	200	2	1	1	32.2964918428
186	202	1	0	1	30.9132212739
186	203	1	0	1	41.1436209839
186	205	3	0	3	41.1059309106
186	206	2	0	2	32.2239635683
186	207	6	0	6	28.9300267899
186	208	44	4	40	35.5969746639
186	209	13	3	10	28.9628833776
186	210	2	0	2	25.9540969102
186	211	4	0	4	36.7421639494
186	212	9	0	9	29.1095229143
186	213	10	1	9	32.2801530597
186	214	3	1	2	38.2923404782
186	216	3	0	3	21.926073888
186	217	14	1	13	20.3462172072
186	218	13	3	10	13.9704055291
186	219	6	0	6	27.4548061689
186	220	175	25	150	23.4499685784
186	221	10	0	10	16.9483590456
186	222	17	2	15	20.0833661727
186	223	30	2	28	17.7740472471
186	224	9	0	9	22.1116942406
186	225	36	0	36	22.1102649522
186	226	1	0	1	28.1073200157
186	227	30	0	30	11.7592900817
186	229	132	5	127	21.3995397012
186	230	4	0	4	23.6212416123
186	231	4	1	3	22.2120589493
186	232	13	0	13	19.259034473
186	233	3	0	3	22.2859395833
186	234	20	17	3	13.3957581234
186	235	18	3	15	12.7977380785
186	236	60	1	59	15.6379947571
186	237	9	4	5	24.9384465928
186	238	96	52	44	6.97136671864
186	239	52	25	27	15.4304569615
186	241	1	0	1	44.9600700419
186	242	3	0	3	38.2859740493
186	243	13	2	11	32.3280705664
186	244	10	0	10	40.3382712985
186	245	9	1	8	61.7791318508
186	247	0	0	0	60.4695340723
186	252	1	0	1	49.7828101838
186	254	1	0	1	55.0787548978
186	257	1	1	0	60.974868417
186	260	1	0	1	63.7069749452
186	262	5	0	5	46.8431522543
186	265	1	0	1	35.8529637579
186	266	10	1	9	24.6177052591
186	268	17	6	11	17.6770363602
186	270	1	0	1	41.2971397007
186	271	38	3	35	15.6921690226
186	272	15	1	14	24.6181071647
186	274	2	0	2	41.3127846514
186	275	2	0	2	33.4522378195
186	276	2	0	2	38.2509460252
186	277	199	36	163	34.9483320705
186	278	14	1	13	15.5105169097
186	279	1	0	1	43.8008006967
186	280	1	0	1	27.6830040342
186	281	9	0	9	41.8502080206
186	282	10	0	10	39.1681432362
186	284	2	1	1	32.1070774999
186	285	6	0	6	23.6084226508
186	286	1	0	1	44.447049848
186	287	6	1	5	29.990615759
186	288	1	0	1	26.7233053577
186	290	1	0	1	22.7635379662
186	291	4	0	4	26.4069062309
186	292	2	0	2	31.4840774622
186	293	7	0	7	40.2839125649
186	294	1	0	1	48.8847011968
186	298	1	0	1	36.6357514283
186	302	1	0	1	43.809415643
186	303	1	0	1	71.5537441429
186	305	4	0	4	51.0469484308
186	307	2	0	2	61.4878649368
186	308	1	0	1	56.6346105417
186	319	2	0	2	114.929101507
186	345	1	0	1	42.6214647515
186	346	1	0	1	45.9941440788
186	392	0	0	0	152.007365118
186	472	1	0	1	137.22156507
186	475	1	0	1	142.386256045
186	491	1	0	1	152.413331317
186	507	1	0	1	242.545717487
186	573	0	0	0	136.763822991
187	0	1	0	1	90.227012409
187	1	27	0	27	91.9344824496
187	5	2	0	2	101.737141742
187	15	1	0	1	96.1479260482
187	31	0	0	0	103.27159141
187	36	2	0	2	94.808388864
187	39	1	0	1	84.5846567958
187	50	1	0	1	121.472980701
187	59	1	0	1	144.794407644
187	65	1	0	1	131.94468325
187	70	6	0	6	87.8386864367
187	71	1	0	1	98.2063761624
187	73	63	3	60	92.0905233677
187	74	5	1	4	94.5389156033
187	75	6	1	5	94.491715358
187	76	1	0	1	90.437927867
187	78	5	0	5	93.7040606552
187	79	1	0	1	88.1798623396
187	80	0	0	0	88.8752214022
187	81	2	0	2	88.7169413516
187	82	9	1	8	91.2924359915
187	83	1	0	1	92.215171752
187	84	4	0	4	93.1192434992
187	86	2	0	2	97.8024603213
187	87	4	0	4	96.6043303219
187	89	3	0	3	80.2873461396
187	92	2	0	2	83.0709332397
187	103	3	0	3	96.0840449293
187	104	1	0	1	86.1190985139
187	112	4	0	4	94.8305176643
187	113	3	0	3	99.7225839715
187	136	1	0	1	120.352404138
187	140	1	0	1	104.94920396
187	142	14	0	14	114.549988025
187	143	1	0	1	123.025981975
187	155	1	0	1	98.41720695
187	177	0	0	0	111.936779638
187	181	27	6	21	19.4979611521
187	182	4	1	3	26.6515918559
187	183	759	54	705	21.4635894866
187	184	8	1	7	26.6040805846
187	185	29	1	28	14.0418077976
187	186	144	75	69	11.3537893996
187	188	452	14	438	7.64694395638
187	189	2	0	2	21.4530103353
187	190	12	0	12	33.4040774356
187	191	58	34	24	16.9523190896
187	192	14	1	13	17.3110131152
187	193	27	13	14	9.67264562787
187	194	183	139	44	7.76950934516
187	195	1	0	1	25.1011789001
187	196	22	0	22	28.1583178927
187	198	7	0	7	36.0886569435
187	199	2	0	2	28.1825691892
187	200	3	2	1	22.7172975291
187	201	2	1	1	36.9326540406
187	202	6	1	5	20.0166202085
187	204	1	0	1	35.9818203467
187	206	2	0	2	30.9389834548
187	207	4	1	3	26.602942845
187	208	78	2	76	31.4874059205
187	209	19	1	18	25.6375021298
187	210	3	1	2	21.8188134167
187	211	7	1	6	30.2960656762
187	212	10	0	10	29.4593609919
187	213	10	0	10	26.274390357
187	214	1	0	1	36.2694344772
187	216	3	0	3	21.0617571712
187	217	33	18	15	14.5104301338
187	218	82	0	82	7.25789784481
187	219	17	0	17	20.4302798404
187	220	209	3	206	20.1688053664
187	221	12	0	12	15.0022773143
187	222	11	0	11	22.1213127311
187	223	171	48	123	8.15996473462
187	224	3	0	3	19.4712639508
187	225	44	1	43	17.4885959484
187	226	2	1	1	21.5163504165
187	227	183	18	165	5.22532340143
187	228	4	0	4	20.2148066354
187	229	423	317	106	14.2103860032
187	230	29	1	28	13.2147170084
187	231	1	0	1	24.9248846439
187	232	12	2	10	18.6600558201
187	234	22	7	15	13.713550278
187	235	3	0	3	20.065056834
187	236	32	5	27	19.7632148133
187	237	3	0	3	25.2906741373
187	238	33	1	32	11.505268922
187	239	74	0	74	11.7083362227
187	241	3	0	3	35.386270141
187	242	8	0	8	29.3503006025
187	243	10	3	7	23.9065924012
187	244	13	0	13	30.1685344553
187	245	2	0	2	69.3618708537
187	246	3	2	1	70.1974720009
187	247	1	0	1	64.8271509881
187	252	1	0	1	56.543721677
187	257	4	0	4	69.6846605796
187	262	0	0	0	54.7166441508
187	264	1	0	1	65.7302613759
187	266	4	0	4	35.7405203512
187	268	2	1	1	29.0130824072
187	271	6	1	5	24.5054745469
187	272	5	0	5	30.5171755006
187	273	1	1	0	41.0232188991
187	275	1	0	1	43.7189594351
187	276	1	0	1	43.8908633472
187	277	116	0	116	44.0520700439
187	278	1	0	1	26.0673196225
187	280	0	0	0	37.2940575823
187	281	2	0	2	49.5635705902
187	282	5	0	5	46.195448886
187	283	1	0	1	60.7884570664
187	286	1	0	1	50.9976387029
187	287	3	0	3	37.3021773638
187	291	1	0	1	29.8365303543
187	292	1	0	1	34.9023924485
187	293	5	0	5	43.5317081491
187	297	1	0	1	43.7746967128
187	303	1	0	1	82.2130977381
187	305	1	0	1	60.7566337832
187	307	2	0	2	71.6416290085
187	338	1	0	1	91.6743875601
187	341	1	0	1	80.9530642958
187	345	5	0	5	37.8606247251
187	371	1	0	1	43.8188711535
187	375	2	0	2	54.2579501814
187	377	1	0	1	63.8697568904
187	469	0	0	0	155.521273318
187	475	3	0	3	150.344814208
187	491	1	0	1	161.720225692
187	502	1	0	1	177.320143106
187	526	1	0	1	194.913910192
187	573	1	0	1	141.819213142
188	1	38	2	36	87.8036988003
188	5	3	0	3	97.3303490023
188	7	1	0	1	90.6772077884
188	13	1	0	1	91.4724311646
188	21	1	0	1	96.9811085828
188	23	1	0	1	97.0819184057
188	28	6	1	5	83.6284065187
188	32	1	0	1	77.4887505388
188	33	1	0	1	96.4163173787
188	36	2	0	2	92.6014785732
188	39	1	0	1	82.0942427787
188	42	1	0	1	86.5978359041
188	46	1	0	1	119.497724753
188	48	0	0	0	129.18788595
188	50	1	0	1	118.228863414
188	55	1	0	1	126.695132362
188	65	1	0	1	127.775334863
188	70	4	0	4	87.6356482479
188	71	5	1	4	97.881994173
188	73	97	1	96	91.3383514608
188	74	7	0	7	94.1026892337
188	75	7	0	7	93.7202681169
188	76	1	0	1	90.3021930434
188	78	8	3	5	93.3916241309
188	79	0	0	0	87.4380127562
188	81	8	0	8	88.2244375824
188	82	12	1	11	90.9801212814
188	83	2	0	2	91.642732335
188	84	9	1	8	92.4478508851
188	85	2	0	2	93.7756701291
188	87	3	0	3	95.9778928178
188	88	1	0	1	97.3667689679
188	90	5	0	5	91.9134736554
188	92	2	0	2	82.7657514289
188	95	1	0	1	89.2080830504
188	96	1	0	1	89.2144129908
188	99	1	0	1	101.873605681
188	101	1	0	1	73.0933727903
188	103	4	0	4	94.9736350938
188	104	1	0	1	84.6343192016
188	110	1	1	0	98.1795874034
188	111	1	0	1	77.3671647021
188	112	3	0	3	93.4943917673
188	113	10	0	10	98.8180747979
188	120	1	0	1	85.6876883887
188	140	1	0	1	103.791315735
188	142	12	1	11	113.301189693
188	143	0	0	0	121.661762126
188	146	2	0	2	103.095812554
188	164	1	0	1	102.881160068
188	169	1	0	1	88.5703679938
188	181	64	18	46	14.3725576021
188	182	30	9	21	19.3223466144
188	183	2249	0	2249	13.8265368999
188	184	20	4	16	19.4008842533
188	185	128	17	111	7.37944920871
188	186	365	8	357	6.75134020413
188	187	415	75	340	7.64694395638
188	189	7	2	5	14.1569830482
188	190	71	25	46	25.8086428802
188	191	25	4	21	21.4622693579
188	192	7	0	7	24.0901936424
188	193	18	1	17	12.6228862919
188	194	53	7	46	14.6291184745
188	196	12	1	11	35.6237573893
188	198	3	0	3	42.8209791481
188	199	2	0	2	35.6197559353
188	202	10	2	8	27.4778366628
188	204	3	0	3	39.8044212354
188	205	1	0	1	44.8045800599
188	206	3	0	3	35.5232321348
188	207	3	0	3	31.6416004275
188	208	49	10	39	37.4523796122
188	209	4	1	3	31.1463106458
188	210	3	0	3	27.622961532
188	211	8	0	8	37.1907166724
188	212	6	1	5	33.1304326885
188	213	11	1	10	32.9619433415
188	214	5	0	5	41.3042294917
188	215	0	0	0	46.881424074
188	216	4	1	3	16.4058151177
188	217	30	0	30	13.6104395628
188	218	80	68	12	7.40128365252
188	219	12	0	12	20.7045835829
188	220	277	1	276	17.1793737696
188	221	19	3	16	10.8158779004
188	222	33	1	32	15.9100949721
188	223	54	1	53	15.6855745212
188	224	6	0	6	24.4704847507
188	225	23	0	23	23.3883706937
188	226	1	0	1	28.3552649461
188	227	56	3	53	11.0231918638
188	228	1	0	1	27.6053874345
188	229	180	90	90	21.1094853998
188	230	8	0	8	20.8539552268
188	231	2	0	2	27.1026608212
188	232	3	1	2	22.5325932738
188	233	2	0	2	26.0155821527
188	234	11	5	6	16.7182889204
188	235	4	1	3	19.062934858
188	236	37	7	30	20.873663192
188	237	3	0	3	28.8669986612
188	238	34	0	34	11.5260868329
188	239	36	0	36	16.822495711
188	241	2	0	2	38.3944906166
188	242	15	0	15	31.6209696279
188	243	22	0	22	25.6231187779
188	244	14	2	12	33.9932558008
188	245	4	0	4	68.4168596358
188	246	2	0	2	69.9566796665
188	247	3	0	3	66.3201869872
188	249	1	0	1	60.2340206055
188	251	1	1	0	69.5257568063
188	252	1	0	1	56.2514023669
188	253	1	0	1	55.1120252811
188	254	1	0	1	61.5864290188
188	257	3	0	3	67.7209183487
188	262	3	0	3	53.5032175584
188	266	1	0	1	30.7929819407
188	268	11	1	10	23.4390568137
188	270	1	0	1	47.7132378725
188	271	12	2	10	22.3724566546
188	272	5	0	5	30.7154500071
188	275	5	0	5	40.0873180133
188	277	164	1	163	41.698591794
188	278	1	0	1	22.1502237615
188	280	2	0	2	34.4275966781
188	281	4	0	4	48.4774222188
188	282	9	0	9	45.661091589
188	284	1	0	1	38.2384760656
188	285	1	0	1	30.2831588092
188	286	2	1	1	50.8534126981
188	287	4	0	4	36.5015902349
188	291	3	1	2	31.6774084851
188	292	1	0	1	36.8268707724
188	293	6	1	5	45.6514199077
188	297	2	0	2	47.5144212031
188	303	1	0	1	77.9623004654
188	304	2	0	2	80.8440698041
188	305	2	0	2	57.7606147512
188	307	2	0	2	68.1069186617
188	309	1	0	1	74.7911681614
188	338	1	0	1	95.349398998
188	342	0	0	0	94.4425731853
188	345	2	0	2	44.1700139178
188	350	1	0	1	67.2474449007
188	371	1	0	1	50.0073647792
188	375	1	0	1	59.933746389
188	466	1	0	1	166.011074263
188	469	0	0	0	153.538571316
188	471	2	0	2	147.738081198
188	475	2	0	2	149.098904339
188	491	1	0	1	159.143164047
189	1	5	0	5	86.7141321947
189	14	1	0	1	96.2916477977
189	36	1	0	1	95.3818558946
189	70	1	0	1	93.9804319544
189	73	16	0	16	96.7262937046
189	74	1	0	1	99.9732391754
189	76	1	0	1	96.7136023108
189	78	0	0	0	99.4740645719
189	80	1	0	1	94.0320359167
189	84	3	0	3	97.9539015396
189	86	1	0	1	103.923541636
189	95	1	0	1	93.5182291217
189	110	1	0	1	102.469966188
189	113	1	0	1	103.840193363
189	142	1	0	1	117.551267094
189	164	1	0	1	109.671902797
189	181	6	0	6	18.3389146985
189	182	86	0	86	5.19858264012
189	183	395	10	385	6.11626348098
189	184	2	0	2	13.6491289021
189	185	9	8	1	7.66209063419
189	186	13	1	12	16.4761602691
189	187	6	0	6	21.4530103353
189	188	11	1	10	14.1569830482
189	190	31	3	28	15.111280147
189	191	1	0	1	30.0275537275
189	196	1	0	1	48.1502802815
189	207	2	0	2	45.0963448735
189	208	1	0	1	51.3317685459
189	212	1	0	1	45.5855956832
189	214	1	0	1	54.608284412
189	216	4	2	2	10.8814103411
189	217	1	0	1	17.4018015436
189	219	1	0	1	23.2132382934
189	220	33	4	29	15.1258632061
189	221	4	0	4	11.1596892478
189	222	41	16	25	5.86459735597
189	223	0	0	0	29.612950019
189	224	2	1	1	38.060203376
189	227	1	0	1	25.1685734086
189	229	7	1	6	35.2652893472
189	230	1	0	1	34.2966434673
189	232	1	0	1	35.5693215343
189	234	1	0	1	29.6488565704
189	235	2	0	2	28.1972198259
189	236	2	0	2	31.9391823156
189	238	1	0	1	23.4071298369
189	241	1	0	1	42.4968950611
189	242	1	0	1	35.1926299218
189	243	2	0	2	29.2517919325
189	244	1	0	1	39.8977703093
189	245	2	2	0	73.9504602769
189	262	1	0	1	59.0984313795
189	266	1	0	1	30.741401001
189	268	1	0	1	23.0682860635
189	271	2	0	2	29.3386978563
189	275	1	0	1	42.0306797676
189	276	1	0	1	52.9650870373
189	277	15	2	13	45.9956803931
189	278	1	0	1	26.0669322474
189	281	0	0	0	54.5128145491
189	282	1	0	1	52.6975192231
189	284	1	0	1	46.979262989
189	307	1	0	1	68.8011202461
189	476	1	0	1	137.008401092
189	573	0	0	0	150.772279075
190	0	3	0	3	77.8593442937
190	1	217	6	211	74.65339677
190	4	1	0	1	83.3752664005
190	5	2	0	2	82.7462431313
190	6	1	0	1	91.5654343253
190	7	4	0	4	80.5146748049
190	8	1	0	1	81.2651230223
190	12	1	0	1	78.7457391198
190	13	6	0	6	82.2765735116
190	14	0	0	0	85.7302847437
190	15	4	0	4	81.9437781392
190	18	1	0	1	81.7348962901
190	19	2	0	2	75.5377454946
190	20	2	0	2	88.7866020976
190	23	6	0	6	84.6755091144
190	24	1	0	1	85.2116004399
190	28	12	1	11	71.4476567031
190	31	2	0	2	94.3902738489
190	32	7	1	6	70.030310197
190	33	1	0	1	87.8363526706
190	34	1	0	1	103.436424548
190	35	6	0	6	91.1119761895
190	36	19	0	19	86.2732774336
190	39	2	0	2	75.3449334119
190	41	1	0	1	90.4940516799
190	42	2	0	2	79.9069084044
190	44	1	0	1	111.027936552
190	59	2	0	2	128.607660921
190	60	2	0	2	111.226174062
190	65	2	0	2	113.247755082
190	66	0	0	0	102.521538376
190	68	2	0	2	112.274647652
190	70	11	0	11	88.4664871606
190	71	6	1	5	97.7945849051
190	73	215	13	202	90.1240165106
190	74	9	2	7	93.8163590841
190	75	18	0	18	92.3196140446
190	76	4	0	4	91.2133316512
190	78	28	3	25	93.5557644623
190	79	1	0	1	86.4705927367
190	80	3	0	3	87.8503744004
190	81	17	0	17	88.0542712195
190	82	16	0	16	91.2666119757
190	83	12	2	10	91.0207593568
190	84	24	0	24	91.4502550493
190	85	11	1	10	94.9469192522
190	86	6	0	6	98.1329919299
190	87	16	0	16	94.9599020358
190	88	6	0	6	96.6939520652
190	89	6	0	6	78.7946481397
190	90	3	0	3	94.7212160647
190	92	8	0	8	83.5429283232
190	95	3	0	3	85.8895427996
190	96	7	0	7	93.375045416
190	102	2	0	2	76.1861449242
190	103	12	0	12	92.3544011417
190	104	1	0	1	81.2845854214
190	109	2	0	2	88.9729746098
190	110	3	0	3	94.6491327703
190	111	3	0	3	78.5618191191
190	112	10	0	10	90.170694572
190	113	45	0	45	96.7248488579
190	116	4	0	4	91.8641065505
190	117	2	0	2	97.4101662767
190	118	2	0	2	95.6807815969
190	119	1	0	1	98.8968115438
190	120	2	0	2	83.9981293009
190	129	1	0	1	95.5394376976
190	131	3	0	3	127.995086016
190	139	1	0	1	129.099632612
190	142	22	1	21	109.464908847
190	145	1	0	1	107.441370588
190	146	1	0	1	101.983881797
190	147	1	0	1	127.773064216
190	155	0	0	0	103.38367678
190	164	1	0	1	104.353240943
190	166	3	0	3	108.542236899
190	168	3	0	3	108.749190236
190	169	1	0	1	94.1722601356
190	171	5	0	5	103.040923732
190	172	1	0	1	112.821827825
190	175	2	0	2	108.121149111
190	177	2	0	2	114.428613444
190	181	14	1	13	20.1046219268
190	182	127	11	116	12.318948847
190	183	1482	666	816	12.0523676477
190	184	62	13	49	8.81145904433
190	185	11	0	11	21.7283593505
190	186	42	9	33	24.1648038052
190	187	12	0	12	33.4040774356
190	188	49	6	43	25.8086428802
190	189	3	0	3	15.111280147
190	191	1	1	0	44.7815276224
190	192	0	0	0	49.4478885196
190	194	3	0	3	40.2668430457
190	195	1	0	1	55.5848031366
190	196	6	0	6	61.4040962316
190	198	2	0	2	67.8187654432
190	199	1	0	1	60.5629805445
190	202	1	1	0	53.2657947814
190	204	0	0	0	56.5081502405
190	206	1	0	1	54.4351374196
190	207	2	0	2	51.9326086912
190	208	27	2	25	59.1129462841
190	209	5	0	5	52.3983761741
190	211	7	0	7	60.8514579209
190	212	9	1	8	50.4249845352
190	213	4	0	4	56.3616937306
190	214	5	1	4	60.6363977813
190	216	1	0	1	25.4209806576
190	218	2	0	2	31.0816724934
190	219	1	0	1	38.2825643167
190	220	113	0	113	29.9629950068
190	221	6	2	4	26.2163481022
190	222	35	0	35	19.961958903
190	223	2	1	1	41.1642721433
190	224	1	0	1	45.6516524679
190	225	6	0	6	46.1374597663
190	227	2	0	2	35.5894373177
190	229	29	0	29	45.5189223704
190	231	1	0	1	42.514959879
190	232	4	0	4	42.2420484706
190	233	1	0	1	44.5413070299
190	234	2	0	2	36.8102818728
190	235	1	0	1	31.0566564301
190	236	11	0	11	36.2500559492
190	237	2	0	2	46.7097012353
190	238	2	0	2	30.3689164104
190	239	7	2	5	39.5393040848
190	241	2	0	2	57.5144307197
190	242	5	1	4	50.2123317946
190	243	5	0	5	44.3274604406
190	244	2	0	2	55.0084088642
190	245	17	0	17	68.1363448648
190	246	1	0	1	71.88102086
190	247	1	0	1	74.0157850799
190	249	2	0	2	65.3615692229
190	251	3	0	3	74.1840481018
190	253	6	1	5	62.0284991323
190	254	4	0	4	63.8428706716
190	255	2	0	2	56.9717057227
190	256	1	0	1	71.3880305038
190	257	8	0	8	63.9845576472
190	258	2	0	2	64.2679410202
190	259	1	0	1	51.2543266972
190	260	4	0	4	67.7791375625
190	261	0	0	0	58.2280169224
190	262	6	0	6	54.0591461257
190	263	1	0	1	58.0818361691
190	264	3	1	2	58.4213890003
190	265	4	0	4	30.391352175
190	266	44	0	44	23.1775901588
190	267	2	0	2	25.9172459058
190	268	37	10	27	17.6667220135
190	269	1	0	1	20.3327117263
190	270	9	0	9	37.6211178743
190	271	24	1	23	29.6078506367
190	272	9	1	8	40.4866426592
190	273	2	0	2	45.7936919627
190	274	4	0	4	47.1636884565
190	275	12	4	8	34.649925358
190	276	1	0	1	51.7922425711
190	277	290	5	285	40.6061378313
190	278	4	0	4	24.1116335787
190	279	3	0	3	45.7220235218
190	280	3	0	3	33.6787554032
190	281	5	0	5	50.263027063
190	282	13	0	13	49.7171124175
190	283	2	0	2	47.150738891
190	284	5	0	5	46.5174696462
190	285	4	0	4	34.7583128241
190	286	1	0	1	55.2556394453
190	287	8	1	7	41.8097459088
190	289	3	0	3	42.5875623475
190	290	3	0	3	28.4745374782
190	292	1	0	1	49.4464071503
190	293	5	0	5	57.3392696482
190	294	1	0	1	67.8790589402
190	303	10	0	10	64.8804193169
190	305	5	0	5	51.3796774525
190	306	1	0	1	57.3486326888
190	307	18	8	10	58.5379981158
190	308	2	0	2	51.6751148484
190	310	0	0	0	83.4322046015
190	315	1	0	1	73.0981663888
190	319	1	0	1	128.295731171
190	323	0	0	0	127.455769424
190	329	1	0	1	109.710057894
190	338	0	0	0	108.144215437
190	345	3	0	3	66.2364986468
190	348	1	0	1	88.385868706
190	375	0	0	0	79.7645738335
190	392	0	0	0	158.201653615
190	406	1	0	1	176.160589357
190	408	2	0	2	177.555254761
190	411	1	0	1	175.118537503
190	415	1	0	1	167.788971102
190	427	1	0	1	189.822758708
190	465	2	0	2	154.290720934
190	469	1	0	1	146.186447115
190	472	1	0	1	135.835938394
190	475	2	0	2	144.35777685
190	476	1	0	1	126.386473506
190	477	1	0	1	148.950270329
190	480	1	0	1	142.254942331
190	484	0	0	0	139.045809729
190	488	1	0	1	151.487796979
190	491	1	0	1	149.647347613
190	503	1	0	1	162.906718528
190	514	1	0	1	233.463835432
190	537	0	0	0	203.068890018
190	573	2	0	2	146.205379464
191	1	7	0	7	108.731311042
191	5	1	0	1	118.436824824
191	7	1	0	1	110.919682168
191	36	6	0	6	111.644875002
191	49	1	0	1	132.432379565
191	70	1	0	1	103.726743387
191	71	1	0	1	114.137753547
191	73	33	0	33	108.319704059
191	74	3	0	3	110.56041584
191	75	3	0	3	110.724718093
191	77	1	0	1	103.747719303
191	78	3	0	3	109.644120275
191	79	0	0	0	104.416118942
191	80	1	0	1	105.00742802
191	81	1	0	1	104.797599912
191	82	6	0	6	107.242134654
191	84	1	0	1	109.296435571
191	85	1	0	1	109.494812615
191	87	1	0	1	112.742248649
191	92	1	0	1	99.0523718865
191	94	1	0	1	91.9719876408
191	95	1	0	1	107.173688912
191	96	1	0	1	103.391630969
191	101	1	0	1	89.1013680759
191	103	5	0	5	112.500003635
191	104	1	0	1	102.731237377
191	110	3	0	3	116.028018011
191	111	1	0	1	93.6516851574
191	112	4	0	4	111.359129431
191	113	2	0	2	116.017920678
191	118	1	0	1	109.11414545
191	120	1	0	1	103.047941543
191	142	12	0	12	130.999229589
191	146	1	0	1	119.73261066
191	155	1	0	1	113.267745254
191	181	4	0	4	35.6023905746
191	182	3	0	3	34.4845366537
191	183	118	15	103	33.1145042496
191	184	2	0	2	40.1153537925
191	185	9	2	7	23.0802136052
191	186	19	1	18	27.4712316857
191	187	54	22	32	16.9523190896
191	188	86	2	84	21.4622693579
191	190	4	1	3	44.7815276224
191	192	116	10	106	9.10100503771
191	193	43	27	16	8.9481972055
191	194	175	93	82	10.6262164314
191	195	50	6	44	11.1199461402
191	196	118	1	117	21.4918304487
191	198	27	1	26	23.6566986474
191	199	2	1	1	29.9553926833
191	200	5	2	3	22.6833720493
191	201	5	2	3	30.2903916046
191	202	28	0	28	15.5429531768
191	203	4	1	3	16.8325437505
191	205	0	0	0	51.6411104738
191	208	31	0	31	39.8036649092
191	209	2	0	2	35.892465555
191	210	1	0	1	31.9786662038
191	211	4	0	4	35.310601747
191	212	4	1	3	42.6085264919
191	213	6	1	5	32.8536612246
191	214	3	0	3	46.4774085931
191	216	7	3	4	22.7435706247
191	217	21	13	8	13.1020445102
191	218	24	15	9	14.3284350451
191	219	58	0	58	11.7090479221
191	220	176	0	176	18.6987618884
191	221	8	1	7	19.0321280259
191	222	4	0	4	27.122091214
191	223	49	3	46	17.2093347085
191	224	3	1	2	31.7182158138
191	225	19	4	15	28.3245673033
191	227	29	8	21	20.535705686
191	228	2	0	2	24.3065805169
191	229	157	3	154	23.1006738611
191	230	46	1	45	15.535017756
191	232	5	0	5	32.6644086241
191	233	3	0	3	36.2247773698
191	234	1	0	1	29.2373876365
191	236	7	3	4	35.9348613448
191	237	3	0	3	38.9188602753
191	238	2	0	2	28.4060074252
191	239	14	1	13	25.4812341412
191	240	12	7	5	14.7001231037
191	241	49	15	34	18.804112093
191	242	122	29	93	13.8679301313
191	243	143	33	110	10.3911627211
191	244	286	0	286	13.2494304908
191	245	1	0	1	85.7828643175
191	246	1	0	1	86.2078592023
191	266	1	0	1	52.0695931706
191	271	4	0	4	41.4553625607
191	272	3	0	3	46.7689820846
191	273	1	0	1	57.4311717012
191	275	1	0	1	60.5905428191
191	276	1	0	1	59.6797685442
191	277	50	1	49	60.9809199877
191	280	0	0	0	54.2433597834
191	281	3	0	3	66.1552301429
191	282	1	0	1	62.5699601881
191	285	1	0	1	48.9243565076
191	286	1	0	1	67.1082227972
191	291	1	0	1	44.9930803602
191	292	1	0	1	49.7665364348
191	293	1	0	1	57.8963555356
191	294	3	0	3	62.3625114393
191	295	0	0	0	55.9617585039
191	296	0	0	0	69.1752505687
191	307	1	0	1	88.560490482
191	329	1	0	1	113.554806709
191	338	1	0	1	102.788298373
191	345	2	0	2	44.4041393199
191	375	2	0	2	61.75161177
191	408	1	0	1	197.65810752
191	417	1	0	1	188.5430679
191	466	1	0	1	185.017864318
191	476	2	0	2	154.893247609
191	488	1	0	1	182.374126371
191	505	2	0	2	197.78785049
191	564	1	0	1	168.346918822
192	1	7	0	7	108.147070459
192	13	1	0	1	109.605057758
192	28	1	0	1	103.61891987
192	71	1	0	1	109.630366415
192	73	13	0	13	104.260749062
192	74	2	0	2	106.188731279
192	78	0	0	0	105.168740997
192	79	0	0	0	100.38777829
192	81	1	0	1	100.536374055
192	82	1	0	1	102.791134939
192	84	1	0	1	105.153123507
192	87	1	0	1	108.524747451
192	88	1	0	1	109.587667561
192	89	1	0	1	92.7101013868
192	90	1	0	1	101.654444629
192	99	1	0	1	116.646651406
192	103	1	0	1	108.737794524
192	107	1	0	1	116.969090701
192	113	2	0	2	112.030823617
192	131	1	0	1	152.166285381
192	134	1	0	1	122.838777167
192	142	3	0	3	127.231389505
192	181	1	0	1	36.7593989273
192	182	1	0	1	40.4908989087
192	183	38	0	38	37.4162409037
192	185	3	0	3	28.0468184409
192	186	8	0	8	28.6592287854
192	187	16	6	10	17.3110131152
192	188	35	0	35	24.0901936424
192	190	1	0	1	49.4478885196
192	191	268	39	229	9.10100503771
192	193	10	2	8	14.0528287442
192	194	130	78	52	9.57312624604
192	195	20	1	19	8.5429392782
192	196	151	42	109	13.0355732792
192	197	1	0	1	23.3809847379
192	198	33	12	21	18.7954185201
192	199	3	0	3	21.0289850979
192	200	20	2	18	13.7523538502
192	201	2	0	2	22.1269531135
192	202	102	18	84	6.44451585241
192	203	7	3	4	12.52650088
192	204	2	0	2	42.0686065482
192	207	8	1	7	31.1410849622
192	208	30	0	30	32.0078708186
192	209	5	0	5	29.0016077551
192	211	8	1	7	26.7883476155
192	212	1	0	1	36.8109534349
192	213	9	0	9	24.8321644207
192	214	2	1	1	39.1297592493
192	216	1	0	1	30.1976416541
192	217	4	0	4	20.4068932834
192	218	7	0	7	18.4863309963
192	219	7	0	7	20.6521685265
192	220	22	11	11	26.7008261103
192	221	1	0	1	25.4348317051
192	223	79	25	54	13.1962827657
192	224	1	0	1	26.0914910374
192	225	30	2	28	22.336416506
192	226	3	0	3	20.8155756741
192	227	16	4	12	18.6301939227
192	228	12	0	12	16.187968667
192	229	229	2	227	17.0220611996
192	230	117	95	22	8.77018536797
192	232	2	0	2	28.0078572936
192	233	1	0	1	31.198221266
192	234	2	0	2	26.0781695118
192	235	1	0	1	35.2982439764
192	236	6	2	4	32.9745725941
192	237	1	0	1	33.5931315747
192	238	1	0	1	27.3262477641
192	239	14	5	9	21.5174692334
192	240	6	0	6	15.3285954887
192	241	9	0	9	24.6213635659
192	242	16	0	16	21.5745924327
192	243	23	6	17	19.2842813563
192	244	63	6	57	18.3144360563
192	245	3	0	3	82.1838897489
192	257	1	0	1	83.8298671183
192	271	1	0	1	40.2408977999
192	276	1	0	1	55.4884024034
192	277	21	0	21	59.1582917596
192	281	0	0	0	63.0900125426
192	282	1	0	1	59.1403574438
192	283	1	0	1	76.9908818361
192	284	1	0	1	50.0045722031
192	292	5	1	4	44.9045764975
192	303	3	0	3	98.5658030984
192	309	1	0	1	93.3294426472
192	322	1	0	1	130.6372209
192	345	2	1	1	35.9899068154
192	346	3	1	2	24.4092534648
192	371	1	0	1	41.7708821475
192	375	1	0	1	53.3109206492
192	493	1	0	1	197.211737553
193	0	1	0	1	99.1828499979
193	1	6	0	6	100.276962634
193	23	1	0	1	109.461189147
193	28	3	0	3	96.0367473684
193	58	1	0	1	136.41861044
193	70	1	0	1	97.5094604874
193	73	15	0	15	101.727297031
193	74	1	0	1	104.201398239
193	75	2	0	2	104.127226049
193	78	1	0	1	103.372131772
193	81	2	0	2	98.374843299
193	82	2	0	2	100.960212893
193	84	4	0	4	102.764196043
193	90	1	0	1	101.102011478
193	92	1	0	1	92.7377800412
193	95	1	0	1	100.144599896
193	101	1	0	1	82.8721580015
193	103	1	0	1	105.675702411
193	112	2	0	2	104.382292349
193	113	5	0	5	109.344460964
193	127	2	0	2	118.214924938
193	142	6	0	6	124.125497412
193	169	1	0	1	96.8342648046
193	181	5	1	4	26.9218899605
193	182	4	0	4	26.5259757678
193	183	158	0	158	24.3237651096
193	184	2	1	1	31.1897373796
193	185	15	10	5	14.4362664648
193	186	25	0	25	18.9191494985
193	187	117	17	100	9.67264562787
193	188	119	38	81	12.6228862919
193	189	1	0	1	21.7496257273
193	190	4	0	4	36.1503849637
193	191	128	89	39	8.9481972055
193	192	15	13	2	14.0528287442
193	194	145	42	103	7.62206924542
193	195	1	0	1	19.4361974864
193	196	14	0	14	26.9792661306
193	198	1	0	1	31.7270321546
193	200	1	0	1	24.9095266673
193	201	1	0	1	36.1073934982
193	202	10	4	6	19.4049506625
193	207	4	0	4	34.7305301922
193	208	13	0	13	38.433877646
193	209	3	1	2	33.3462612794
193	211	1	0	1	35.5836209127
193	214	2	1	1	44.1544722463
193	216	9	1	8	16.4499895473
193	217	61	9	52	7.05167538775
193	218	99	30	69	5.38080852685
193	219	28	0	28	11.1212878081
193	220	255	153	102	13.6343600823
193	221	15	5	10	11.3870637344
193	222	4	1	3	19.7830610962
193	223	32	6	26	13.8314244124
193	224	2	0	2	27.9098178197
193	225	7	2	5	25.1954584498
193	227	25	1	24	14.4548227186
193	228	1	0	1	24.5127942978
193	229	108	1	107	20.678826375
193	230	13	0	13	15.5304848119
193	232	3	0	3	27.7963661202
193	234	3	1	2	23.2645569755
193	235	1	0	1	29.4921843892
193	236	6	0	6	29.4357728622
193	238	5	0	5	20.9626251502
193	239	13	1	12	20.5574638655
193	240	2	0	2	23.6462323851
193	241	7	0	7	26.1487388321
193	242	14	3	11	19.7985256706
193	243	32	1	31	14.2383499612
193	244	32	0	32	21.4266698604
193	245	2	0	2	78.9634755121
193	246	0	0	0	79.8644150589
193	251	1	0	1	78.5790786975
193	254	1	0	1	71.6288112331
193	264	1	0	1	74.9536157857
193	268	1	0	1	36.0613891545
193	270	1	0	1	60.2044733983
193	271	5	0	5	33.6608415045
193	272	1	0	1	40.1806182259
193	274	2	0	2	59.3116155582
193	275	1	0	1	52.3172728355
193	277	27	1	26	53.2491268858
193	281	0	0	0	59.1194346716
193	282	1	0	1	55.8253129978
193	284	2	0	2	47.5292536364
193	285	3	1	2	41.3768481035
193	287	1	0	1	46.878833742
193	293	1	0	1	52.9640595215
193	301	1	0	1	57.6289725681
193	303	1	0	1	90.4630633652
193	305	1	0	1	69.727999581
193	306	1	0	1	82.0755477545
193	307	0	0	0	80.349117233
193	345	1	0	1	44.0923394827
193	375	1	0	1	61.141695698
193	408	1	0	1	191.283740832
194	1	7	0	7	99.3333669145
194	15	1	0	1	103.268884265
194	21	1	0	1	108.436504724
194	23	0	0	0	108.182711922
194	24	1	0	1	107.843224852
194	26	0	0	0	118.938048357
194	36	3	0	3	101.327254041
194	49	1	0	1	122.552595616
194	65	1	0	1	139.323229317
194	70	2	0	2	93.1012607334
194	73	28	2	26	97.7207676636
194	74	2	0	2	99.9397710576
194	76	1	0	1	95.6392941292
194	81	2	0	2	94.1819460337
194	82	6	0	6	96.6182499361
194	84	2	0	2	98.6901579619
194	85	1	0	1	98.8702407181
194	87	1	0	1	102.130905507
194	88	2	0	2	103.308979436
194	92	1	0	1	88.4306224624
194	103	1	0	1	101.938389623
194	112	2	0	2	100.833844613
194	113	2	0	2	105.428426324
194	120	1	0	1	92.4790108077
194	142	2	0	2	120.442396891
194	152	0	0	0	133.175686087
194	181	3	0	3	27.2636790103
194	183	143	49	94	28.2152970109
194	184	3	1	2	34.0035198694
194	185	4	0	4	19.3795273188
194	186	21	0	21	19.1216509385
194	187	184	98	86	7.76950934516
194	188	134	3	131	14.6291184745
194	190	3	0	3	40.2668430457
194	191	164	2	162	10.6262164314
194	192	106	19	87	9.57312624604
194	193	49	7	42	7.62206924542
194	195	5	1	4	17.3893280858
194	196	41	9	32	21.2028313174
194	197	1	0	1	30.3713953918
194	198	2	1	1	28.3683206197
194	199	2	0	2	24.1788601222
194	200	7	0	7	17.6104707078
194	201	1	1	0	30.2299147973
194	202	19	2	17	13.1330809604
194	203	3	1	2	22.0224762852
194	204	2	0	2	38.3496284632
194	205	1	0	1	41.9500445254
194	207	2	0	2	27.9089456724
194	208	26	3	23	31.0517675182
194	209	5	0	5	26.3102184946
194	210	1	0	1	22.3257887739
194	211	6	0	6	27.9657457636
194	212	5	0	5	32.2853167275
194	213	7	2	5	24.6667985219
194	214	3	0	3	37.093072702
194	217	8	3	5	14.63146008
194	218	37	0	37	10.0371432432
194	219	13	2	11	18.1178091838
194	220	63	0	63	21.1908403427
194	221	1	0	1	18.0269608771
194	222	5	0	5	26.2379996379
194	223	171	1	170	6.86647279473
194	224	3	0	3	21.4626959581
194	225	34	2	32	18.3412170546
194	226	2	0	2	19.8980339471
194	227	74	23	51	10.1035038355
194	228	2	0	2	16.8931093802
194	229	390	28	362	13.4455252639
194	230	106	46	60	7.99123351626
194	231	1	0	1	29.4362933678
194	232	3	1	2	22.1067762118
194	234	11	2	9	18.6443405188
194	235	5	0	5	26.8224719391
194	236	16	0	16	25.4070409594
194	237	1	0	1	28.4679168318
194	238	9	4	5	18.4661396
194	239	49	11	38	14.8784277216
194	240	1	0	1	23.3343629033
194	241	8	0	8	29.4220934185
194	242	15	0	15	24.2489761399
194	243	9	2	7	19.7089442002
194	244	42	0	42	23.7015473681
194	245	0	0	0	75.2332722879
194	255	1	0	1	68.3837380508
194	264	1	0	1	72.4603460151
194	268	3	1	2	36.7817164003
194	271	3	0	3	31.5667520802
194	272	3	1	2	36.2202574795
194	274	1	0	1	56.5221992813
194	275	1	0	1	51.0748844399
194	276	1	0	1	49.0563333045
194	277	32	0	32	50.9000124478
194	282	4	0	4	52.0261321633
194	284	1	0	1	43.2342708517
194	285	2	0	2	38.7739768511
194	291	1	0	1	34.3747134248
194	292	1	0	1	39.1779218794
194	294	1	0	1	52.3698778721
194	303	2	0	2	89.6645188409
194	305	2	0	2	67.7826786517
194	307	0	0	0	78.8548636386
194	309	1	0	1	84.9850704312
194	310	1	0	1	69.0790450499
194	338	0	0	0	93.3551962847
194	345	1	0	1	36.5360694615
194	346	2	0	2	30.7995250893
194	475	0	0	0	156.170085707
195	1	1	0	1	116.553360399
195	7	0	0	0	117.899221787
195	38	1	0	1	130.631566509
195	70	1	0	1	107.47090439
195	73	3	0	3	112.621272191
195	75	2	0	2	115.018042855
195	81	1	0	1	108.854554531
195	84	2	0	2	113.494613163
195	111	1	0	1	97.660396207
195	113	1	0	1	120.400941212
195	142	2	0	2	135.635844222
195	183	13	5	8	43.7395075693
195	185	1	0	1	33.861602381
195	187	4	0	4	25.1011789001
195	188	3	0	3	31.1636965002
195	190	1	0	1	55.5848031366
195	191	40	10	30	11.1199461402
195	192	16	2	14	8.5429392782
195	193	1	0	1	19.4361974864
195	194	6	3	3	17.3893280858
195	196	90	4	86	13.4384441081
195	198	28	7	21	12.5394899311
195	200	5	1	4	19.1291832118
195	201	3	0	3	20.9483495988
195	202	15	2	13	11.8845440189
195	203	19	0	19	5.72889762414
195	207	2	0	2	38.8288117444
195	208	8	0	8	38.6949341964
195	211	2	0	2	32.5180141623
195	213	5	2	3	31.4368946114
195	218	3	0	3	24.628621582
195	219	3	0	3	21.8030891969
195	220	6	2	4	29.6041774216
195	221	1	0	1	30.1182927012
195	223	2	0	2	21.7341090535
195	224	1	1	0	34.2907042336
195	225	4	0	4	30.4694772505
195	227	1	0	1	27.0151105421
195	228	1	0	1	23.0611908458
195	229	9	0	9	25.240435702
195	230	14	3	11	17.0805991543
195	236	2	0	2	41.5174259522
195	239	2	1	1	30.0497525131
195	240	16	1	15	7.04226418788
195	241	8	3	5	18.4699809752
195	242	23	5	18	17.8059470015
195	243	18	1	17	18.0938259523
195	244	96	2	94	12.3048420272
195	245	0	0	0	90.6422773653
195	268	1	0	1	54.0662686735
195	273	1	0	1	62.6615648169
195	277	4	0	4	67.6764305266
195	281	0	0	0	71.615530038
195	282	2	0	2	67.6399866764
195	305	1	0	1	84.6716895888
195	345	0	0	0	41.6883139784
195	346	2	0	2	25.6701938996
195	371	3	0	3	47.1317015967
196	0	3	0	3	110.531054957
196	1	28	0	28	114.636671619
196	7	1	0	1	114.657859347
196	11	1	0	1	127.180787271
196	21	2	0	2	123.4962141
196	27	1	0	1	133.819086087
196	33	1	0	1	118.479574788
196	36	2	0	2	112.680287525
196	39	1	0	1	103.529037872
196	41	1	0	1	119.253308282
196	49	1	0	1	135.937235159
196	65	1	0	1	154.177653701
196	70	6	0	6	100.230975647
196	73	56	1	55	105.951446616
196	74	8	0	8	107.347817123
196	75	5	0	5	108.313772236
196	76	2	0	2	102.500600391
196	78	3	0	3	106.168256155
196	79	2	0	2	102.176757013
196	81	4	0	4	101.947405255
196	82	8	0	8	103.860606776
196	83	1	0	1	105.533496662
196	84	14	0	14	106.697251772
196	85	1	0	1	105.284544282
196	86	2	0	2	109.61263166
196	87	3	0	3	109.909148681
196	88	1	0	1	110.759749397
196	89	6	0	6	94.8452006993
196	90	1	0	1	101.562978905
196	92	2	0	2	96.0118424724
196	95	3	0	3	106.401427505
196	96	2	0	2	97.4154845033
196	103	8	0	8	110.845379252
196	107	1	0	1	117.471861335
196	109	2	0	2	97.1380109335
196	112	2	0	2	110.288864224
196	113	7	0	7	113.747502876
196	119	1	0	1	106.668981028
196	120	1	0	1	101.4415352
196	131	1	0	1	155.278226187
196	134	1	0	1	125.071141929
196	139	1	0	1	151.425887183
196	140	1	0	1	119.553856412
196	142	26	4	22	129.151611258
196	164	1	0	1	113.138284366
196	172	1	0	1	122.396817242
196	177	1	0	1	121.181297039
196	181	2	0	2	46.5813334497
196	182	4	0	4	53.1674749203
196	183	71	1	70	49.3657733649
196	184	1	0	1	54.7489911691
196	185	2	0	2	40.5124372658
196	186	6	0	6	38.9629497409
196	187	17	0	17	28.1583178927
196	188	23	0	23	35.6237573893
196	190	6	0	6	61.4040962316
196	191	80	11	69	21.4918304487
196	192	59	2	57	13.0355732792
196	193	1	0	1	26.9792661306
196	194	6	0	6	21.2028313174
196	195	41	7	34	13.4384441081
196	197	8	0	8	10.7398560284
196	198	610	454	156	12.304795991
196	199	96	3	93	14.2246344368
196	200	198	0	198	9.72501591862
196	201	173	10	163	9.13078857313
196	202	211	6	205	8.14790581371
196	203	35	1	34	10.9731354086
196	204	17	1	16	41.3468294677
196	205	1	0	1	42.1269862342
196	206	17	0	17	35.1162475091
196	207	19	6	13	30.9701607247
196	208	337	160	177	28.6093745669
196	209	54	0	54	28.4503612935
196	210	1	0	1	25.903326457
196	211	127	1	126	21.3698054978
196	212	31	2	29	37.7179382105
196	213	80	6	74	21.7393528817
196	214	14	3	11	36.341810636
196	215	2	0	2	37.5124617088
196	217	1	0	1	33.4424616256
196	218	1	0	1	31.0025494088
196	219	1	0	1	33.1941819265
196	220	35	0	35	39.7055803094
196	222	1	0	1	46.751691986
196	223	49	2	47	21.328283119
196	224	3	1	2	28.6502356665
196	225	40	0	40	24.9290412998
196	226	7	0	7	19.9442869294
196	227	7	1	6	27.5078851568
196	228	27	6	21	15.2074726424
196	229	280	110	170	20.8657479241
196	230	91	1	90	15.3833021635
196	231	2	0	2	39.4536924225
196	232	2	0	2	31.9303235757
196	233	5	3	2	34.1001057355
196	234	5	0	5	32.3876120169
196	235	2	0	2	42.4881485235
196	236	11	3	8	38.7547334836
196	237	7	1	6	35.7011867584
196	238	4	0	4	35.7961230857
196	239	12	0	12	27.5287743495
196	240	9	2	7	18.9086047821
196	241	11	3	8	31.600705625
196	242	29	8	21	31.187099583
196	243	8	0	8	30.702028981
196	244	72	8	64	25.6352450402
196	245	3	0	3	84.9344933152
196	247	1	0	1	73.3855412391
196	253	1	0	1	65.9456401994
196	258	1	0	1	92.608203037
196	262	1	0	1	72.0795835237
196	264	1	0	1	85.2794276267
196	266	1	0	1	61.6467507777
196	271	2	0	2	47.5806711405
196	272	5	0	5	48.0220914316
196	274	1	0	1	69.364054086
196	275	1	0	1	67.1094694407
196	276	2	0	2	58.0638869983
196	277	115	28	87	64.9638973392
196	278	1	0	1	51.3435027
196	280	1	0	1	59.8344979411
196	281	1	0	1	67.0970929686
196	282	3	0	3	62.7470858821
196	284	5	0	5	53.3814401767
196	285	1	0	1	53.2119061225
196	286	1	0	1	65.9640346674
196	287	1	0	1	55.7207039565
196	289	1	0	1	79.2305295358
196	291	2	0	2	43.5172197829
196	293	5	0	5	52.9810424999
196	294	1	0	1	53.3794808174
196	296	1	0	1	62.9509790538
196	297	1	0	1	47.3578804467
196	303	4	0	4	105.377321268
196	305	2	0	2	81.898698843
196	307	6	3	3	93.5249237694
196	309	1	0	1	98.7524711944
196	319	1	0	1	120.659741082
196	345	25	0	25	30.0522711991
196	346	79	2	77	12.2779520346
196	371	8	1	7	34.9967033717
196	372	0	0	0	39.295213796
196	373	1	0	1	60.9982262452
196	375	4	1	3	46.41611683
196	378	1	0	1	46.6881537937
196	408	1	0	1	193.306363444
196	442	1	0	1	213.382732726
196	465	1	0	1	179.111605635
196	469	1	0	1	171.531674465
196	471	4	0	4	169.464868466
196	472	1	0	1	163.180469214
196	475	2	0	2	164.203592121
196	573	1	0	1	148.081347984
197	73	3	0	3	104.615191076
197	74	1	0	1	105.559463044
197	111	1	0	1	89.5461897462
197	112	1	0	1	109.547052862
197	142	0	0	0	127.788857339
197	183	3	0	3	57.8677215414
197	187	1	0	1	36.4048255735
197	196	69	0	69	10.7398560284
197	198	9	0	9	18.3424433292
197	199	11	1	10	12.5036524151
197	200	8	0	8	14.014797016
197	201	25	1	24	5.04550768732
197	202	2	1	1	17.5078176489
197	205	1	0	1	39.1588632377
197	207	1	0	1	31.0370476737
197	208	2	1	1	26.1935632537
197	211	4	0	4	18.4310379656
197	212	1	0	1	37.9329961856
197	213	3	1	2	20.9922745807
197	214	1	0	1	33.5472389815
197	225	1	0	1	28.1135699202
197	228	3	1	2	18.5474933207
197	229	11	6	5	25.7408416329
197	230	1	0	1	23.1969712674
197	242	1	0	1	41.7336379931
197	243	1	0	1	41.4398926024
197	277	2	1	1	67.7879376854
197	345	1	0	1	25.0143668248
197	346	28	14	14	2.48241669888
198	0	1	0	1	122.14291727
198	1	8	0	8	125.723461423
198	6	0	0	0	145.218149354
198	11	1	0	1	137.706782154
198	36	7	0	7	124.652145639
198	70	1	0	1	112.525489274
198	71	1	0	1	122.825172754
198	73	38	0	38	118.209983171
198	74	1	0	1	119.638817307
198	75	3	1	2	120.576369938
198	76	1	0	1	114.801087204
198	78	2	0	2	118.464910165
198	79	0	0	0	114.425054224
198	81	1	0	1	114.223302765
198	82	5	0	5	116.154182356
198	84	7	0	7	118.966814888
198	87	2	0	2	122.189940285
198	88	1	0	1	123.051188064
198	90	1	0	1	113.857850639
198	92	1	0	1	108.290047353
198	96	1	0	1	109.689089938
198	103	2	0	2	123.069148067
198	110	1	0	1	126.995898469
198	111	1	0	1	103.104247251
198	112	2	0	2	122.470871283
198	113	3	0	3	126.007939286
198	131	1	0	1	167.393951277
198	142	12	0	12	141.402214342
198	147	2	1	1	158.156990873
198	181	1	0	1	55.4684107262
198	182	1	0	1	58.0549500313
198	183	23	0	23	55.8710276894
198	184	1	0	1	62.2073600229
198	185	2	0	2	46.1514402911
198	186	3	0	3	47.4194265658
198	187	8	2	6	36.0886569435
198	188	4	0	4	42.8209791481
198	190	1	0	1	67.8187654432
198	191	41	1	40	23.6566986474
198	192	17	1	16	18.7954185201
198	193	0	0	0	31.7270321546
198	194	4	0	4	28.3683206197
198	195	47	5	42	12.5394899311
198	196	1290	0	1290	12.304795991
198	197	4	2	2	18.3424433292
198	199	27	0	27	26.2535005173
198	200	51	0	51	21.918934025
198	201	107	26	81	13.6216041935
198	202	60	0	60	17.7682097557
198	203	50	11	39	6.83108193162
198	204	2	0	2	53.6516014795
198	205	1	0	1	54.3408478124
198	206	2	0	2	47.4174923417
198	207	10	0	10	43.23190542
198	208	134	25	109	40.8198686818
198	209	13	0	13	40.7220705273
198	211	40	0	40	33.4033401805
198	212	10	0	10	49.9262849139
198	213	19	0	19	34.0326868312
198	214	4	0	4	48.5534041492
198	216	0	0	0	46.321623327
198	217	3	0	3	36.7583118574
198	218	1	0	1	36.7434911856
198	219	2	0	2	34.0343063668
198	220	12	0	12	42.0745065018
198	222	3	0	3	50.7773012338
198	223	8	1	7	30.8960829158
198	224	2	0	2	40.4928221972
198	225	16	3	13	36.6809591039
198	226	2	0	2	32.1495865027
198	227	4	1	3	36.8692413757
198	228	17	5	12	27.2846919198
198	229	110	12	98	32.1346914764
198	230	24	6	18	25.1709098136
198	232	3	0	3	43.4984230401
198	233	1	0	1	45.9536560901
198	234	1	0	1	43.1465525044
198	235	1	0	1	52.9939464597
198	236	2	0	2	49.82296049
198	237	2	0	2	47.7281659149
198	239	3	0	3	38.2961000181
198	240	46	2	44	12.7951078862
198	241	16	2	14	25.2448609283
198	242	26	0	26	27.6559655647
198	243	8	3	5	29.6400288535
198	244	103	46	57	20.7261809822
198	245	2	0	2	97.0485313428
198	246	1	0	1	95.9571068195
198	247	1	0	1	85.6798523482
198	254	1	0	1	88.6905667933
198	257	1	0	1	99.773427323
198	258	1	0	1	104.280616707
198	266	1	0	1	71.3116601807
198	271	1	0	1	58.0571573676
198	272	1	0	1	59.5988315321
198	274	1	0	1	80.9293773973
198	276	2	0	2	70.1437994822
198	277	66	0	66	76.2137914002
198	280	1	0	1	70.6535353247
198	281	0	0	0	78.9150381873
198	282	2	0	2	74.6441329146
198	283	1	0	1	94.6985052945
198	284	1	0	1	65.2887120518
198	291	1	0	1	55.4480416353
198	292	1	0	1	59.0285852817
198	293	1	0	1	65.2646565631
198	294	1	0	1	65.5674581938
198	303	1	0	1	116.305359484
198	305	2	0	2	93.2308471673
198	307	1	0	1	104.749691846
198	309	1	0	1	110.231535543
198	310	2	0	2	79.9927804866
198	345	6	1	5	41.7055298174
198	346	16	0	16	20.7354912727
198	371	2	0	2	46.2022938408
198	375	1	0	1	57.3112313975
198	465	1	0	1	191.340905098
198	469	0	0	0	183.738152336
198	471	5	0	5	181.408636133
198	483	1	0	1	217.187332306
198	507	1	0	1	256.963584203
199	1	7	0	7	104.79509787
199	13	1	0	1	103.300494201
199	36	3	0	3	100.704094657
199	48	0	0	0	140.699499636
199	55	2	0	2	140.425403688
199	70	1	0	1	86.9110977766
199	73	38	1	37	92.8981261635
199	74	6	0	6	94.0542900979
199	75	4	1	3	95.2314805954
199	78	1	0	1	92.8146224868
199	81	1	0	1	88.7878842061
199	82	3	0	3	90.5456143029
199	83	1	0	1	92.3618819602
199	84	1	0	1	93.5732232589
199	87	1	0	1	96.6998944429
199	95	1	0	1	93.8401065518
199	96	1	0	1	83.5695658247
199	102	1	0	1	88.4119330301
199	103	2	0	2	97.9670096026
199	111	1	0	1	77.7887034431
199	112	2	0	2	97.5971674253
199	113	4	0	4	100.669258071
199	119	1	0	1	92.9401437037
199	123	1	0	1	75.0954664476
199	129	1	0	1	107.215124026
199	142	12	0	12	116.107443774
199	151	1	0	1	135.731879036
199	164	1	0	1	99.4012935412
199	177	1	0	1	107.255694903
199	181	2	0	2	42.6566990168
199	182	2	0	2	54.8315740943
199	183	25	0	25	49.0794989296
199	184	1	0	1	52.6943374941
199	185	3	0	3	42.18402154
199	186	3	0	3	36.4836342858
199	187	6	2	4	28.1825691892
199	188	2	0	2	35.6197559353
199	190	2	0	2	60.5629805445
199	191	7	2	5	29.9553926833
199	192	10	0	10	21.0289850979
199	193	1	0	1	31.6889167459
199	194	2	0	2	24.1788601222
199	196	449	17	432	14.2246344368
199	197	5	1	4	12.5036524151
199	198	43	0	43	26.2535005173
199	200	95	21	74	7.28090630745
199	201	6	0	6	16.367920622
199	202	12	0	12	14.7644884051
199	203	2	0	2	24.9279585454
199	204	13	0	13	28.0233949683
199	205	1	0	1	28.1463890951
199	206	11	0	11	22.053521111
199	207	46	8	38	18.6018310407
199	208	442	42	400	14.6642464081
199	209	93	22	71	16.1024049973
199	210	10	0	10	14.9400359696
199	211	916	57	859	7.15915407909
199	212	37	0	37	25.5203542446
199	213	236	102	134	8.57528944888
199	214	29	6	23	22.3678962859
199	215	3	0	3	23.2930423034
199	217	1	0	1	38.7405773427
199	218	2	0	2	33.7578874268
199	220	11	4	7	45.3223238238
199	223	13	2	11	20.0241453399
199	224	7	0	7	18.9400407299
199	225	38	0	38	16.1869356286
199	226	28	10	18	9.4606922981
199	228	80	0	80	8.02473165072
199	229	179	43	136	15.0934069741
199	230	17	4	13	16.1881525623
199	232	6	0	6	22.9319881338
199	233	6	0	6	23.8275584559
199	234	2	1	1	25.7974373003
199	236	8	0	8	30.6825891691
199	237	9	0	9	24.5715313978
199	238	1	0	1	31.191202119
199	239	8	4	4	21.6738787608
199	241	2	0	2	44.293800387
199	242	3	0	3	42.3880333868
199	243	1	0	1	40.2823589741
199	244	4	1	3	38.0240996084
199	245	1	0	1	72.6001598155
199	248	1	0	1	66.3060481505
199	250	1	0	1	64.7501883635
199	251	1	0	1	66.6629562271
199	257	1	0	1	76.4280197637
199	261	1	0	1	79.1596519939
199	262	1	0	1	60.6473623795
199	268	1	0	1	51.2090512999
199	271	1	0	1	40.3891818397
199	272	8	0	8	37.9862158337
199	273	2	1	1	47.2105997855
199	274	1	0	1	58.8500530647
199	275	3	0	3	58.7811410556
199	276	2	0	2	46.089331776
199	277	61	2	59	55.3360772629
199	278	1	0	1	45.3038384494
199	280	1	0	1	51.355531174
199	281	2	0	2	55.9002341316
199	282	5	2	3	51.363103259
199	284	1	0	1	42.1302083219
199	285	1	0	1	44.4320121975
199	287	2	1	1	45.4542078003
199	290	2	0	2	49.5966498898
199	291	1	0	1	32.4533227266
199	292	2	0	2	34.9409943257
199	293	7	0	7	39.9479526662
199	294	0	0	0	39.3349084147
199	298	1	0	1	33.3700429706
199	305	1	0	1	71.7990217607
199	307	2	0	2	83.548729653
199	309	1	0	1	88.1439468447
199	338	1	0	1	75.8562109216
199	345	91	15	76	15.9561701465
199	346	180	52	128	11.0064760915
199	371	5	0	5	21.2635193721
199	373	1	0	1	47.4806391623
199	375	7	3	4	32.8343006777
199	408	1	0	1	179.526256368
199	471	1	0	1	157.441190632
199	495	0	0	0	174.113384152
199	528	1	0	1	193.084941676
199	563	1	0	1	143.621422913
200	0	2	0	2	100.930543036
200	1	11	0	11	105.293958026
200	3	1	0	1	99.1538353911
200	23	1	0	1	113.258123067
200	30	1	0	1	118.760478726
200	32	1	0	1	90.4378510506
200	36	2	0	2	102.96525188
200	49	1	0	1	126.317427815
200	70	2	0	2	90.6414020407
200	73	17	0	17	96.2917249449
200	75	2	0	2	98.6589658598
200	76	2	1	1	92.937924047
200	78	0	0	0	96.5862739105
200	81	0	0	0	92.3124682728
200	82	2	0	2	94.2674196183
200	84	1	0	1	97.052003621
200	87	1	0	1	100.282982292
200	95	1	0	1	96.6831665155
200	96	0	0	0	88.1034433257
200	113	1	0	1	104.089964752
200	142	6	0	6	119.483283854
200	164	1	0	1	103.732715639
200	169	1	0	1	85.7488370602
200	183	30	8	22	44.1080750661
200	185	2	0	2	36.4117358862
200	186	1	0	1	32.2964918428
200	187	8	0	8	22.7172975291
200	188	5	0	5	30.3485520048
200	190	1	0	1	55.9119048306
200	191	14	0	14	22.6833720493
200	192	13	1	12	13.7523538502
200	193	0	0	0	24.9095266673
200	194	7	1	6	17.6104707078
200	195	5	3	2	19.1291832118
200	196	755	129	626	9.72501591862
200	198	67	3	64	21.918934025
200	199	101	2	99	7.28090630745
200	201	14	0	14	15.8383430894
200	202	46	3	43	7.575570248
200	203	4	2	2	19.1220719284
200	204	4	1	3	31.8740033588
200	205	2	0	2	33.1194536895
200	206	7	0	7	25.5940260659
200	207	10	0	10	21.320498729
200	208	139	49	90	19.7585876403
200	209	31	1	30	18.8216102492
200	210	19	2	17	16.178324138
200	211	130	1	129	13.4131417444
200	212	11	0	11	28.0148675184
200	213	89	50	39	12.5754057267
200	214	6	0	6	27.3862619093
200	215	1	0	1	29.4286053611
200	217	2	0	2	31.9378065694
200	218	6	2	4	27.5097708587
200	220	6	0	6	38.515404579
200	222	1	0	1	43.7611145174
200	223	47	15	32	14.7484260822
200	224	6	1	5	19.0417810806
200	225	29	2	27	15.4188486861
200	226	20	2	18	10.2347316292
200	227	2	0	2	20.537958396
200	228	132	108	24	5.52568905519
200	229	391	330	61	12.0138455684
200	230	80	2	78	9.76741005456
200	232	4	0	4	22.4998318146
200	233	1	0	1	24.4637612825
200	234	2	0	2	23.6842339717
200	236	12	0	12	29.6619250501
200	237	6	1	5	25.9894231862
200	239	23	0	23	18.9675775349
200	240	2	0	2	25.8823514536
200	241	2	0	2	37.3813166721
200	242	2	0	2	35.1808259595
200	243	3	0	3	33.0018784884
200	244	6	1	5	31.0669507791
200	245	3	1	2	75.2104850845
200	251	1	0	1	70.4544016599
200	271	1	0	1	38.8768171977
200	272	3	0	3	38.5038469293
200	274	3	0	3	59.8123851639
200	277	30	4	26	55.5983662645
200	281	1	0	1	57.4342095443
200	282	1	0	1	53.058830804
200	287	2	0	2	46.1853941513
200	291	3	0	3	33.8298105889
200	292	1	0	1	37.1818307258
200	293	1	0	1	43.367490464
200	294	2	0	2	44.3900503623
200	297	1	0	1	38.2193321431
200	298	2	0	2	36.8455397323
200	303	1	0	1	96.1347047578
200	305	1	0	1	72.4549010315
200	307	3	0	3	84.1264381671
200	345	17	1	16	22.6235047948
200	346	39	4	35	13.7773480899
200	347	1	0	1	84.851963839
200	359	1	0	1	101.679690161
200	371	1	0	1	28.2282787447
200	375	4	1	3	39.8085451586
200	469	2	0	2	161.832773771
200	480	1	0	1	161.100700725
200	488	1	0	1	174.49888306
200	573	0	0	0	139.288220488
201	1	5	0	5	120.669943587
201	12	1	0	1	128.770742826
201	23	1	0	1	128.401672213
201	36	2	0	2	117.070034704
201	56	1	0	1	150.047356607
201	58	1	0	1	157.169464192
201	71	2	0	2	113.119867817
201	73	7	0	7	109.105205652
201	74	2	0	2	110.142938607
201	78	0	0	0	108.867833682
201	79	0	0	0	105.425647697
201	82	2	1	1	106.625820394
201	83	1	0	1	108.517457729
201	84	1	0	1	109.749715834
201	89	1	0	1	98.3833257674
201	103	2	0	2	114.231059596
201	112	1	0	1	113.908624161
201	122	1	0	1	93.8435867497
201	136	1	0	1	139.497776351
201	142	2	0	2	132.300694203
201	177	0	0	0	122.650065332
201	181	1	0	1	54.7744398183
201	183	7	0	7	58.28712796
201	185	1	0	1	49.5857629638
201	186	4	0	4	47.4232345997
201	187	2	0	2	36.9326540406
201	188	5	0	5	44.4907010395
201	190	1	0	1	70.2989707196
201	191	8	2	6	30.2903916046
201	192	4	0	4	22.1269531135
201	195	4	0	4	20.9483495988
201	196	803	0	803	9.13078857313
201	197	5	2	3	5.04550768732
201	198	228	73	155	13.6216041935
201	199	31	0	31	16.367920622
201	200	40	16	24	15.8383430894
201	202	33	0	33	17.0988786045
201	203	8	2	6	16.5868886372
201	204	3	2	1	44.2720478746
201	206	2	0	2	38.3983355634
201	207	1	0	1	34.932961563
201	208	34	2	32	30.6570966923
201	209	7	0	7	32.4133636516
201	210	1	0	1	30.7891788468
201	211	20	4	16	22.8755215409
201	212	5	1	4	41.8564164061
201	213	13	0	13	24.9381065916
201	214	2	0	2	38.1588176568
201	216	2	0	2	52.321087623
201	220	1	0	1	48.7195177007
201	223	5	1	4	29.6514511677
201	224	1	0	1	34.3116753504
201	225	6	0	6	30.9407102969
201	226	2	0	2	24.8421745371
201	228	11	2	9	21.0433063471
201	229	41	14	27	27.8510185707
201	230	27	4	23	23.8447562519
201	232	1	0	1	38.0278716148
201	233	1	0	1	39.559339191
201	234	1	0	1	39.5223768535
201	236	1	0	1	45.4038838855
201	237	1	0	1	40.6422513115
201	238	1	0	1	43.6628552761
201	239	4	1	3	34.7945905872
201	240	2	1	1	24.712033446
201	241	2	0	2	37.7091850978
201	242	4	0	4	38.5835215768
201	243	1	0	1	38.9265571757
201	244	9	4	5	32.3121477422
201	245	6	0	6	88.9648812685
201	247	1	0	1	75.5235969056
201	254	1	0	1	80.4321021132
201	257	0	0	0	92.7382743447
201	273	1	0	1	63.3489956119
201	276	1	0	1	62.4365828883
201	277	20	3	17	71.0271412799
201	281	0	0	0	72.1270271801
201	282	1	0	1	67.6233821608
201	285	1	0	1	59.6708971759
201	288	1	0	1	68.8179093594
201	290	1	0	1	64.0953061847
201	291	2	1	1	48.5644560857
201	293	0	0	0	56.2435422312
201	295	1	0	1	57.5529998693
201	305	1	0	1	87.7226853942
201	338	0	0	0	88.2235903871
201	345	7	1	6	29.926884495
201	346	75	14	61	7.5275239875
201	371	1	0	1	33.7051903021
201	375	3	0	3	44.3902062062
201	408	0	0	0	195.083539017
201	469	1	0	1	174.888402551
201	573	0	0	0	148.325294959
201	581	1	0	1	134.723865926
202	1	6	0	6	107.957662782
202	41	1	0	1	113.67972597
202	46	1	0	1	139.46670639
202	70	1	0	1	96.1981536004
202	73	7	4	3	101.561175322
202	78	0	0	0	102.156181808
202	79	0	0	0	97.7262651593
202	84	1	0	1	102.387589085
202	112	1	0	1	105.495246661
202	120	1	0	1	96.7802245251
202	142	1	0	1	124.674032825
202	151	1	0	1	143.159633882
202	181	3	1	2	38.6486036255
202	183	26	2	24	41.2330473013
202	185	1	0	1	32.5028006117
202	186	2	0	2	30.9132212739
202	187	12	1	11	20.0166202085
202	188	14	3	11	27.4778366628
202	190	2	0	2	53.2657947814
202	191	48	1	47	15.5429531768
202	192	58	4	54	6.44451585241
202	193	2	0	2	19.4049506625
202	194	17	7	10	13.1330809604
202	195	7	0	7	11.8845440189
202	196	567	147	420	8.14790581371
202	197	1	0	1	17.5078176489
202	198	51	23	28	17.7682097557
202	199	12	4	8	14.7644884051
202	200	57	17	40	7.575570248
202	201	7	2	5	17.0988786045
202	203	1	0	1	13.1697662779
202	204	1	0	1	38.0212744939
202	206	5	1	4	31.721861962
202	207	5	0	5	27.1443956463
202	208	43	13	30	26.8283323031
202	209	7	1	6	24.7956594988
202	211	27	1	26	20.9318306511
202	212	3	2	1	33.3902919039
202	213	8	2	6	19.5689673945
202	214	3	0	3	34.2671075707
202	217	1	0	1	26.176780753
202	218	1	0	1	23.0601437462
202	219	1	0	1	27.0200176281
202	220	11	0	11	32.6361086386
202	222	1	0	1	39.0389406017
202	223	37	26	11	13.4815096794
202	224	1	0	1	23.239315847
202	225	22	1	21	19.376979775
202	226	1	0	1	16.1818594165
202	227	8	0	8	19.6357221508
202	228	18	7	11	11.1944263975
202	229	204	116	88	14.5050549924
202	230	127	79	48	7.55824509431
202	231	0	0	0	33.7115307135
202	232	4	0	4	25.9308661172
202	234	1	0	1	25.3848294268
202	236	3	1	2	32.0587042732
202	237	4	1	3	30.6839196732
202	239	10	1	9	20.5293131224
202	240	4	2	2	18.8480721879
202	241	2	0	2	29.881032286
202	242	7	0	7	27.6264692932
202	243	2	1	1	25.6943982613
202	244	13	1	12	23.5512265965
202	245	1	0	1	79.9371261893
202	254	1	0	1	71.7099181909
202	257	1	0	1	82.267627952
202	268	1	0	1	48.0880543573
202	272	2	1	1	41.9642349363
202	276	2	0	2	53.0405385478
202	277	23	1	22	58.4550755795
202	279	1	0	1	68.177419749
202	281	1	0	1	61.4108817025
202	286	1	0	1	60.8922816885
202	291	1	0	1	38.1638461828
202	292	1	0	1	42.0941211745
202	303	2	0	2	98.5547287173
202	345	3	1	2	30.1579580224
202	346	6	0	6	18.2764209419
202	469	1	0	1	166.786521081
202	475	1	0	1	160.038528975
203	1	1	0	1	120.415606931
203	56	1	0	1	151.072163636
203	70	1	0	1	109.299458872
203	73	7	0	7	114.713624698
203	74	1	0	1	116.36475832
203	76	0	0	0	111.654932235
203	79	1	0	1	110.883318979
203	84	2	0	2	115.531796466
203	96	1	0	1	107.129524416
203	103	2	0	2	119.408477411
203	112	1	0	1	118.664638819
203	142	5	0	5	137.836353415
203	143	1	0	1	146.444978269
203	183	4	2	2	49.1564381374
203	187	2	0	2	29.7900718601
203	188	2	0	2	36.2762612388
203	191	14	1	13	16.8325437505
203	192	9	0	9	12.52650088
203	194	3	1	2	22.0224762852
203	195	56	13	43	5.72889762414
203	196	248	97	151	10.9731354086
203	197	1	0	1	20.3248975178
203	198	149	15	134	6.83108193162
203	199	9	1	8	24.9279585454
203	200	13	0	13	19.1220719284
203	201	4	0	4	16.5868886372
203	202	17	1	16	13.1697662779
203	207	1	0	1	40.0803324334
203	208	23	6	17	38.8307228623
203	209	4	0	4	37.6588969976
203	211	5	0	5	31.9702656559
203	214	1	0	1	46.4962705265
203	219	1	0	1	27.4261855946
203	220	1	1	0	35.3235646246
203	223	5	1	4	25.3160207422
203	225	1	0	1	32.5458736187
203	228	4	0	4	23.9478752176
203	229	16	8	8	27.6019041923
203	230	10	0	10	19.9430536227
203	234	1	0	1	37.9728461795
203	236	0	0	0	44.7942951222
203	237	1	0	1	43.8501871264
203	239	1	0	1	33.2118061762
203	240	9	6	3	8.22383903621
203	241	9	1	8	21.2107013283
203	242	9	5	4	22.1815519544
203	243	5	0	5	23.3717090173
203	244	45	8	37	15.7307525835
203	245	0	0	0	93.1016297213
203	262	1	0	1	79.5872899539
203	272	1	0	1	54.9619757909
203	275	1	0	1	72.2717118689
203	277	10	0	10	71.1608582737
203	298	1	0	1	55.6385424866
203	301	0	0	0	64.517815207
203	345	1	0	1	40.8686369011
203	346	2	0	2	22.3828545657
203	475	0	0	0	173.173822748
203	483	0	0	0	212.795080811
204	0	1	0	1	73.1417488431
204	1	13	1	12	79.973685449
204	10	1	0	1	80.1401440873
204	19	1	0	1	70.2106276851
204	23	1	0	1	86.5821951417
204	24	1	0	1	85.4502877116
204	29	1	0	1	101.968895478
204	31	1	0	1	81.0996311581
204	33	0	0	0	79.9069738344
204	34	2	0	2	93.7454202048
204	36	2	0	2	73.2301856338
204	46	1	0	1	109.780444625
204	48	0	0	0	113.473258412
204	55	1	0	1	113.743354938
204	65	1	0	1	117.706010809
204	70	3	0	3	58.9434658541
204	71	1	0	1	69.199647525
204	72	1	0	1	59.1056607688
204	73	69	13	56	64.8747316261
204	74	1	0	1	66.077586488
204	75	5	0	5	67.2088851477
204	78	5	0	5	64.8657308998
204	81	2	0	2	60.7722119023
204	82	8	0	8	62.5769985928
204	83	1	0	1	64.3490558517
204	84	5	1	4	65.5536991772
204	85	2	0	2	63.9377889574
204	86	1	0	1	68.2677785064
204	87	2	0	2	68.696301143
204	90	1	0	1	60.2860069899
204	92	1	0	1	54.8305680523
204	94	2	0	2	45.4516881581
204	96	3	0	3	56.2856721085
204	113	5	1	4	72.6468320971
204	124	1	0	1	100.480466022
204	131	1	0	1	114.83885629
204	140	0	0	0	78.5486403831
204	141	1	0	1	113.348541298
204	142	9	0	9	88.0843705646
204	143	1	0	1	96.6861065228
204	147	1	0	1	104.565157867
204	177	1	0	1	80.1389986742
204	181	2	0	2	36.5260145543
204	182	1	0	1	56.6482431893
204	183	12	0	12	48.4421640828
204	184	1	0	1	47.7075440645
204	187	1	0	1	35.9818203467
204	188	2	0	2	39.8044212354
204	191	0	0	0	48.4541889264
204	192	1	1	0	42.0686065482
204	196	9	1	8	41.3468294677
204	198	8	2	6	53.6516014795
204	199	1	0	1	28.0233949683
204	200	8	0	8	31.8740033588
204	202	1	0	1	38.0212744939
204	205	120	9	111	5.91040392333
204	206	239	59	180	6.3068893706
204	207	92	12	80	10.9374179369
204	208	434	37	397	13.7452872051
204	209	67	23	44	13.2257101369
204	210	5	1	4	16.7509134861
204	211	36	0	36	21.4770329904
204	212	925	0	925	6.67535934025
204	213	46	0	46	19.6798856492
204	214	197	42	155	7.51384903312
204	215	9	3	6	12.8635358595
204	220	2	0	2	56.0042280292
204	221	1	0	1	50.2281052929
204	222	2	0	2	55.4638612004
204	223	4	0	4	31.483996078
204	224	8	4	4	16.9112002508
204	225	10	0	10	20.1296262709
204	226	2	0	2	21.8862014096
204	227	2	0	2	30.7592271907
204	229	32	1	31	25.3940732646
204	230	2	0	2	33.4518242159
204	231	9	2	7	14.0284938365
204	232	8	1	7	17.4211533893
204	233	18	0	18	13.805362364
204	234	3	1	2	23.0906187329
204	235	2	0	2	25.4615463396
204	236	16	1	15	20.5508413961
204	237	127	24	103	10.9374697903
204	238	3	0	3	28.8510606437
204	239	4	1	3	24.3241688213
204	241	1	0	1	66.532314962
204	242	1	0	1	62.3218527677
204	243	1	0	1	58.0584454141
204	244	1	0	1	60.3027780067
204	245	5	0	5	44.9607880844
204	247	1	0	1	32.1425017766
204	249	1	0	1	31.1065062424
204	251	1	0	1	38.7032660273
204	253	1	1	0	25.028161663
204	254	2	0	2	36.3836513087
204	257	2	0	2	49.7031161796
204	259	1	0	1	38.2555323603
204	261	0	0	0	54.0041127776
204	262	5	0	5	34.4062268254
204	264	2	0	2	48.5303630314
204	266	1	0	1	41.1463152572
204	270	1	0	1	47.8960711753
204	271	4	0	4	27.5376425411
204	272	29	0	29	18.2916188672
204	273	1	0	1	22.9208826281
204	274	3	0	3	34.4126968407
204	276	4	0	4	19.5803575083
204	277	139	3	136	33.1136771898
204	280	2	1	1	32.3870837886
204	281	5	0	5	30.3036148965
204	282	14	1	13	25.6871995506
204	284	10	3	7	17.8051607074
204	285	2	0	2	26.216815145
204	287	4	0	4	23.1282403232
204	288	1	0	1	37.3735239736
204	291	52	3	49	11.929320456
204	292	39	13	26	10.0894022333
204	293	148	53	95	12.0006858839
204	294	30	8	22	14.0651277664
204	295	2	0	2	14.6291742733
204	296	3	0	3	21.6746273835
204	297	44	18	26	7.79359358556
204	298	65	4	61	5.53131175446
204	300	1	0	1	27.0302953318
204	301	3	0	3	13.7287798539
204	303	2	0	2	71.922819581
204	305	1	0	1	47.4416763428
204	307	3	0	3	58.98494275
204	309	1	0	1	62.4692873442
204	310	2	0	2	30.9367342806
204	317	1	0	1	19.4621366879
204	345	13	2	11	17.7121475832
204	346	5	0	5	37.8539951853
204	371	2	0	2	19.7172979166
204	375	3	0	3	24.0784592917
204	377	5	0	5	28.7370004959
204	378	1	0	1	10.9001741773
204	465	1	0	1	138.10306073
204	471	2	0	2	129.795910542
204	493	1	0	1	159.9298804
204	501	1	0	1	153.951799699
204	503	2	0	2	141.467785023
204	528	1	0	1	167.2845857
204	566	1	0	1	119.386385707
205	0	1	0	1	76.0907875547
205	1	7	0	7	83.6528063256
205	3	0	0	0	73.4037511303
205	33	1	0	1	82.3394213451
205	36	2	0	2	75.2865080469
205	71	1	0	1	69.3290940844
205	73	35	3	32	65.6382395177
205	74	3	2	1	66.4343708829
205	76	1	0	1	61.3518381485
205	78	5	0	5	65.119306665
205	81	1	0	1	61.3891884555
205	82	3	0	3	62.9111226198
205	83	2	0	2	64.9238990617
205	84	3	1	2	66.1999202775
205	88	1	0	1	69.8124015223
205	89	2	0	2	55.4208986804
205	96	1	0	1	55.434009913
205	103	2	0	2	70.9529788295
205	109	1	0	1	55.6616159926
205	111	1	0	1	50.6608351737
205	112	0	0	0	70.9004195681
205	113	2	0	2	73.3264104346
205	123	2	0	2	48.5889595973
205	131	1	0	1	116.058719411
205	142	1	0	1	88.7477565223
205	152	1	0	1	102.625384326
205	182	1	0	1	62.132461312
205	183	7	1	6	54.0243935522
205	186	1	0	1	41.1059309106
205	187	1	0	1	40.4127088674
205	190	1	0	1	62.3292177418
205	191	2	0	2	51.6411104738
205	193	0	0	0	48.7674295529
205	196	3	0	3	42.1269862342
205	198	4	0	4	54.3408478124
205	199	1	0	1	28.1463890951
205	201	1	0	1	43.8355425789
205	203	1	0	1	52.2390960115
205	204	141	7	134	5.91040392333
205	206	84	9	75	9.48165140836
205	207	78	1	77	14.0535388303
205	208	298	13	285	13.5219434212
205	209	72	2	70	15.7486496719
205	210	2	1	1	19.6840403769
205	211	15	1	14	21.0959111135
205	212	197	8	189	12.0580710258
205	213	26	4	22	20.5462664909
205	214	299	39	260	5.78751781621
205	215	29	13	16	8.26039381225
205	220	4	0	4	60.5660571566
205	223	1	0	1	35.1268487855
205	224	5	0	5	20.9654212868
205	225	11	1	10	23.6273623469
205	226	3	0	3	23.8144062721
205	227	2	0	2	35.2032484289
205	228	1	0	1	28.711870377
205	229	24	0	24	28.6074443337
205	231	3	1	2	19.8148767509
205	232	1	0	1	22.272029802
205	233	5	1	4	18.878071366
205	236	8	3	5	26.2301726638
205	237	56	10	46	16.167651424
205	238	1	0	1	34.1679020491
205	239	2	1	1	28.7100031416
205	242	1	0	1	65.4622661704
205	244	1	0	1	62.8884650134
205	245	3	0	3	47.024471033
205	247	2	0	2	31.6888227753
205	253	1	0	1	26.6885664602
205	259	1	0	1	42.1876168626
205	262	2	0	2	37.9068696265
205	264	2	0	2	52.0178612099
205	266	1	0	1	46.974091102
205	268	1	0	1	46.7776492187
205	271	2	0	2	33.4461562441
205	272	7	0	7	24.0780016841
205	275	1	0	1	44.4158590493
205	276	5	0	5	23.4263818321
205	277	70	45	25	38.1248591516
205	281	3	0	3	34.2640962088
205	282	3	0	3	29.7557082478
205	284	13	7	6	22.7788986424
205	286	1	0	1	30.0637193082
205	287	2	0	2	28.3893988232
205	291	7	2	5	17.818242868
205	292	14	2	12	15.4471096608
205	293	130	40	90	14.4850562419
205	294	54	22	32	11.2740331759
205	295	5	1	4	18.7607238549
205	296	1	0	1	21.5302865545
205	297	118	2	116	5.38178283618
205	298	32	23	9	9.43668518093
205	301	1	0	1	13.33271026
205	302	1	0	1	21.995682437
205	303	3	0	3	75.9487954202
205	309	2	0	2	65.8906956949
205	312	1	0	1	37.0119524009
205	317	4	1	3	14.8155879478
205	319	1	0	1	79.81509538
205	332	1	0	1	46.0030781583
205	338	0	0	0	51.4442699169
205	345	23	16	7	14.9633319275
205	346	1	0	1	36.9171227729
205	349	1	0	1	60.0416119268
205	350	2	0	2	27.6787193141
205	370	4	2	2	8.22057283495
205	371	3	0	3	15.3294879052
205	372	2	1	1	12.3302351842
205	375	25	0	25	18.2336241848
205	377	1	0	1	23.5545517232
205	378	14	4	10	5.67598535798
205	475	1	0	1	123.051259908
205	505	1	0	1	157.556378315
205	512	1	0	1	184.278931305
205	573	0	0	0	106.175388201
206	0	1	0	1	78.0980944355
206	1	11	0	11	84.2760568372
206	7	1	0	1	82.4166017497
206	10	1	0	1	85.1641188329
206	19	1	0	1	75.1533818518
206	28	1	0	1	79.2985159377
206	36	1	0	1	78.7570784329
206	39	1	0	1	70.3516115199
206	41	1	0	1	85.5570082157
206	49	1	0	1	103.140129176
206	55	1	0	1	118.875283957
206	60	1	0	1	112.183690022
206	70	1	0	1	65.1211382932
206	71	1	0	1	75.4084482374
206	73	35	4	31	70.9416859217
206	74	4	1	3	72.2442872213
206	75	3	0	3	73.2894075248
206	76	1	0	1	67.3843530996
206	78	0	0	0	71.0549071468
206	81	4	1	3	66.8845128245
206	82	5	0	5	68.7522498964
206	83	1	0	1	70.4670331577
206	84	3	2	1	71.6517616042
206	87	4	0	4	74.8300582607
206	89	3	1	2	60.0360201748
206	90	3	2	1	66.5797292557
206	96	1	0	1	62.5923595756
206	101	1	0	1	51.1091448659
206	103	3	0	3	75.9513811258
206	104	1	0	1	67.8920893541
206	110	1	0	1	79.9835567967
206	112	4	1	3	75.549139762
206	113	3	0	3	78.7271985885
206	142	4	0	4	94.1545244425
206	147	1	0	1	110.75228861
206	181	5	0	5	34.336117077
206	182	2	0	2	53.3069664398
206	183	12	0	12	45.4102981197
206	184	1	0	1	45.6437730513
206	186	4	0	4	32.2239635683
206	187	2	0	2	30.9389834548
206	188	1	0	1	35.5232321348
206	190	2	0	2	54.4351374196
206	192	2	1	1	35.8684527551
206	194	2	0	2	32.6046763036
206	196	13	0	13	35.1162475091
206	198	3	0	3	47.4174923417
206	199	5	0	5	22.053521111
206	200	2	0	2	25.5940260659
206	202	1	0	1	31.721861962
206	204	165	8	157	6.3068893706
206	205	26	10	16	9.48165140836
206	207	223	4	219	4.76096164455
206	208	556	0	556	8.5666280933
206	209	107	33	74	6.92915060156
206	210	7	1	6	10.5831326568
206	211	22	4	18	15.8865420328
206	212	652	533	119	4.96705401856
206	213	57	23	34	13.5669969638
206	214	195	5	190	6.20126587311
206	215	3	1	2	12.4676463434
206	220	2	1	1	51.0994432983
206	222	0	0	0	51.391829019
206	223	8	3	5	25.7535584438
206	224	15	1	14	11.4838278423
206	225	24	0	24	14.2653833673
206	228	5	1	4	20.6086922566
206	229	44	0	44	19.3992437547
206	230	1	0	1	27.3208241856
206	231	5	0	5	12.6356511019
206	232	5	1	4	13.0591410925
206	233	28	1	27	10.0025101936
206	234	6	0	6	18.9800371136
206	236	17	6	11	18.2373516959
206	237	90	48	42	7.75243011947
206	238	2	0	2	25.2526153887
206	239	7	0	7	19.2436056066
206	242	1	0	1	56.3597678671
206	243	1	0	1	52.2762266496
206	244	1	0	1	54.1416955049
206	245	3	0	3	50.5834902377
206	247	1	0	1	38.4459267332
206	254	1	0	1	42.0388699195
206	257	2	0	2	54.7820937863
206	260	1	0	1	55.3578731008
206	262	6	0	6	39.174882052
206	264	1	0	1	53.1666504047
206	270	1	0	1	50.3018890974
206	271	1	0	1	26.7930215635
206	272	12	0	12	19.5303930816
206	273	0	0	0	26.5585124097
206	275	1	0	1	41.1326795014
206	277	83	4	79	36.0372823363
206	279	3	0	3	44.9605678241
206	280	1	0	1	34.0174113126
206	281	3	0	3	34.7097289156
206	282	3	0	3	30.0841962778
206	284	5	2	3	21.3174643202
206	285	1	0	1	27.3205831618
206	291	28	2	26	12.919873318
206	292	18	0	18	13.5715520274
206	293	26	11	15	17.936782097
206	294	8	0	8	19.8667742358
206	297	7	0	7	13.4685188185
206	298	6	2	4	11.3574046185
206	303	4	0	4	75.8863629941
206	305	1	0	1	51.4215109021
206	307	3	0	3	63.1145364
206	309	1	0	1	67.0810764802
206	312	1	0	1	46.2739451677
206	317	1	0	1	24.282193678
206	338	0	0	0	60.8925900729
206	345	26	12	14	14.3164636047
206	346	1	0	1	32.2663099171
206	370	1	0	1	16.505888483
206	371	1	0	1	18.0742630443
206	372	1	0	1	17.5224884471
206	375	3	1	2	25.3474556172
206	466	1	0	1	149.949748902
206	470	2	0	2	127.540125108
206	471	1	0	1	135.445786013
206	515	2	0	2	187.03095313
207	0	5	0	5	80.9536126224
207	1	26	1	25	86.5282376517
207	5	1	0	1	96.9941396623
207	9	1	0	1	78.7037218706
207	13	1	0	1	84.7060195063
207	15	1	0	1	87.8100356871
207	17	1	0	1	96.9459817804
207	27	1	0	1	104.835796135
207	28	2	0	2	81.6009820263
207	33	1	0	1	88.3636067803
207	35	2	0	2	93.0842570424
207	36	5	0	5	82.1666587661
207	46	1	0	1	117.16592648
207	70	4	0	4	69.3299796643
207	71	1	0	1	79.6627574188
207	73	104	37	67	74.9824411567
207	74	4	0	4	76.42967013
207	75	3	0	3	77.3464703661
207	76	2	1	1	71.6418096499
207	78	6	0	6	75.2779629006
207	79	4	0	4	71.206742835
207	81	5	0	5	70.9926645987
207	82	19	1	18	72.9541014023
207	83	8	0	8	74.5798720196
207	84	22	1	21	75.7349360458
207	85	1	0	1	74.5126793378
207	86	1	0	1	78.8128708342
207	87	5	0	5	78.9624929057
207	88	1	0	1	79.842824233
207	89	2	0	2	63.9018479538
207	92	4	0	4	65.0609803372
207	96	3	0	3	67.1311166514
207	102	1	0	1	69.8600632826
207	103	6	4	2	79.8857301624
207	104	1	0	1	71.5341406065
207	109	1	0	1	66.4149133956
207	111	2	0	2	59.8736512032
207	112	3	0	3	79.37281745
207	113	9	0	9	82.7792579626
207	114	1	0	1	81.6911810094
207	123	1	0	1	56.8988206974
207	131	1	0	1	124.442511563
207	136	1	0	1	105.098859993
207	142	20	2	18	98.1814590277
207	181	9	0	9	31.9753829654
207	183	52	3	49	42.3013946966
207	184	1	0	1	43.221977205
207	185	3	0	3	39.0186541656
207	186	5	2	3	28.9300267899
207	187	8	0	8	26.602942845
207	188	5	0	5	31.6416004275
207	190	2	0	2	51.9326086912
207	191	5	0	5	37.7452018731
207	192	0	0	0	31.1410849622
207	194	2	0	2	27.9089456724
207	195	1	0	1	38.8288117444
207	196	39	7	32	30.9701607247
207	198	5	2	3	43.23190542
207	199	12	0	12	18.6018310407
207	200	10	0	10	21.320498729
207	202	3	0	3	27.1443956463
207	204	120	3	117	10.9374179369
207	205	38	0	38	14.0535388303
207	206	304	14	290	4.76096164455
207	208	1960	565	1395	7.70425579532
207	209	629	128	501	2.54131158829
207	210	58	2	56	5.83086780724
207	211	86	37	49	13.3524524393
207	212	639	246	393	6.9234590301
207	213	190	0	190	10.0458891901
207	214	274	129	145	9.70040274574
207	215	8	0	8	15.3329764844
207	216	2	1	1	47.4470498414
207	219	1	0	1	45.7942970322
207	220	7	0	7	46.7660315229
207	221	2	0	2	41.4199762656
207	222	1	0	1	47.551580093
207	223	11	1	10	21.0756934014
207	224	62	4	58	7.20090849811
207	225	106	22	84	9.5749702323
207	226	10	2	8	11.1359721781
207	227	3	0	3	21.452695986
207	228	8	1	7	16.1397079495
207	229	154	31	123	14.6470026962
207	230	4	1	3	22.5665002286
207	231	15	0	15	12.1439805228
207	232	28	0	28	9.74210249808
207	233	66	5	61	7.71981171285
207	234	14	0	14	15.5343621235
207	235	1	0	1	21.9191636223
207	236	45	1	44	16.3578342521
207	237	250	0	250	6.81807554231
207	238	7	0	7	22.0189149904
207	239	15	0	15	15.0107439279
207	242	5	0	5	51.6028757517
207	243	5	2	3	47.5553491378
207	244	1	0	1	49.3986386598
207	245	2	0	2	54.1599238564
207	246	1	0	1	52.7545773885
207	247	1	0	1	42.9626607433
207	251	1	0	1	49.1651224142
207	253	3	0	3	34.9774517785
207	255	0	0	0	50.8422886909
207	257	0	0	0	57.8261927982
207	260	1	0	1	58.6719531152
207	262	2	1	1	42.0520192233
207	264	3	0	3	55.8282434074
207	266	0	0	0	40.8608732382
207	268	1	0	1	38.5092510599
207	270	2	0	2	51.1821924449
207	271	6	0	6	25.7316171125
207	272	36	11	25	20.3272189031
207	273	5	1	4	28.7695431443
207	274	2	0	2	40.4948938592
207	275	1	0	1	41.8704571812
207	276	5	1	4	27.5049233185
207	277	210	0	210	37.5037229269
207	278	1	0	1	31.564182714
207	280	1	0	1	34.5455461918
207	281	4	0	4	37.344351761
207	282	8	4	4	32.7843624356
207	283	1	0	1	56.9645581394
207	284	15	0	15	23.6183455854
207	285	3	0	3	27.6410243278
207	287	5	0	5	27.3860988826
207	288	1	0	1	38.419201709
207	290	1	0	1	33.9769366452
207	291	19	4	15	14.1899342717
207	292	20	3	17	16.3406557003
207	293	27	2	25	22.0533109911
207	294	10	0	10	24.6265445962
207	295	3	0	3	22.6441231338
207	296	1	0	1	32.4980336352
207	297	9	2	7	18.2284067116
207	298	9	5	4	15.5644068331
207	301	1	0	1	24.6575119937
207	303	6	0	6	77.8720490157
207	305	3	0	3	53.5438405389
207	307	6	1	5	65.2924881969
207	319	2	1	1	93.5288684362
207	334	1	0	1	66.6845859733
207	338	1	0	1	65.4946636535
207	345	63	11	52	14.7148004837
207	346	10	2	8	29.2888586337
207	371	2	1	1	19.6372607366
207	375	9	0	9	28.4371079044
207	415	1	0	1	152.116798432
207	469	2	0	2	140.580916923
207	475	0	0	0	133.283096754
207	526	1	0	1	171.925691686
207	573	0	0	0	119.12959067
208	0	11	1	10	86.5751957109
208	1	88	2	86	92.8426775226
208	5	1	0	1	103.341253238
208	7	2	0	2	90.9076421133
208	13	2	0	2	90.1726364469
208	15	3	0	3	93.5598871317
208	17	1	0	1	102.598163433
208	21	1	0	1	101.165146655
208	23	1	0	1	99.8116342825
208	26	0	0	0	109.071695579
208	28	7	0	7	87.864583495
208	30	1	0	1	103.31969202
208	31	1	0	1	94.8421461035
208	32	5	1	4	76.0255123395
208	34	1	0	1	107.476324376
208	35	1	0	1	98.3294666192
208	36	23	0	23	86.9528537758
208	37	1	0	1	105.466545605
208	39	5	1	4	78.7391883213
208	42	2	0	2	82.3886478736
208	44	1	0	1	133.436149732
208	46	1	0	1	123.076355256
208	48	1	0	1	127.161821658
208	50	2	0	2	116.697817465
208	56	1	0	1	120.938147795
208	59	1	0	1	140.646864405
208	62	1	0	1	140.74003379
208	64	0	0	0	121.823013625
208	65	3	0	3	131.066006214
208	68	1	0	1	118.343140811
208	70	13	0	13	72.3492009774
208	71	5	0	5	82.5097066555
208	73	380	73	307	78.454900551
208	74	25	2	23	79.4976120851
208	75	32	1	31	80.7705492933
208	76	6	0	6	74.5025471246
208	77	2	0	2	73.865060214
208	78	34	0	34	78.2352729054
208	79	9	0	9	74.7882667929
208	80	2	0	2	74.7663649781
208	81	24	5	19	74.2961188299
208	82	39	11	28	75.9828411801
208	83	13	0	13	77.8604037722
208	84	46	1	45	79.0933792404
208	85	11	0	11	77.1257542854
208	86	4	0	4	81.4844581478
208	87	7	0	7	82.1770973231
208	88	10	0	10	82.8947291193
208	89	9	0	9	67.8252268306
208	90	3	0	3	73.175026042
208	92	10	1	9	68.3596753085
208	95	1	0	1	79.690752955
208	96	6	0	6	68.9125103129
208	98	1	0	1	83.5489764104
208	102	1	0	1	74.7387855172
208	103	18	1	17	83.6124930658
208	104	1	1	0	75.9082218978
208	105	1	0	1	70.9822939144
208	106	1	0	1	66.7866814051
208	107	1	0	1	89.2449840198
208	109	3	0	3	68.9390520191
208	110	2	0	2	87.7181978416
208	111	10	0	10	63.3705914136
208	112	15	0	15	83.3552164985
208	113	39	0	39	86.2044896536
208	116	2	0	2	73.434932412
208	120	2	0	2	74.3714233776
208	121	2	0	2	86.4196663885
208	128	2	0	2	105.663092405
208	131	1	0	1	128.551919841
208	133	2	0	2	98.3114247122
208	134	1	0	1	97.8168219397
208	136	1	0	1	108.879429661
208	140	3	0	3	92.1477605469
208	142	64	1	63	101.645725299
208	143	1	0	1	110.234344498
208	146	1	0	1	88.5793355648
208	151	1	0	1	121.549384328
208	155	1	0	1	78.0318717515
208	164	1	0	1	84.7370851944
208	166	1	0	1	78.5364751001
208	169	3	0	3	66.312109419
208	172	1	0	1	93.9570891371
208	177	1	0	1	92.6219580883
208	181	6	0	6	39.3282678178
208	182	5	0	5	56.3173439807
208	183	209	11	198	49.0292539022
208	184	1	0	1	50.4844747613
208	185	5	1	4	44.7883650866
208	186	11	1	10	35.5969746639
208	187	35	0	35	31.4874059205
208	188	17	3	14	37.4523796122
208	190	13	3	10	59.1129462841
208	191	12	1	11	39.8036649092
208	192	7	0	7	32.0078708186
208	193	1	0	1	38.433877646
208	194	9	1	8	31.0517675182
208	195	3	0	3	38.6949341964
208	196	189	5	184	28.6093745669
208	198	30	5	25	40.8198686818
208	199	70	0	70	14.6642464081
208	200	20	13	7	19.7585876403
208	201	4	0	4	30.6570966923
208	202	11	2	9	26.8283323031
208	203	2	0	2	38.8307228623
208	204	127	110	17	13.7452872051
208	205	92	0	92	13.5219434212
208	206	223	57	166	8.5666280933
208	207	856	220	636	7.70425579532
208	209	1404	0	1404	6.7160232788
208	210	101	0	101	9.83028343952
208	211	561	0	561	7.7838617921
208	212	528	10	518	13.2112808653
208	213	994	768	226	7.25940359284
208	214	541	163	378	7.73458232335
208	215	45	0	45	10.3736584849
208	217	4	1	3	45.0639009165
208	218	2	0	2	38.4994301936
208	219	5	1	4	49.1630811411
208	220	45	1	44	51.3090905899
208	221	0	0	0	46.4892149237
208	222	7	0	7	53.2493042
208	223	31	6	25	24.6424486667
208	224	94	13	81	13.509445774
208	225	234	54	180	14.0950628225
208	226	41	10	31	11.376825719
208	227	11	4	7	26.6573270106
208	228	26	2	24	15.833000801
208	229	468	223	245	17.7762537928
208	230	13	2	11	24.2777225695
208	231	7	0	7	19.745620155
208	232	44	4	40	16.9331816024
208	233	54	10	44	15.3932591611
208	234	19	0	19	22.3492010937
208	235	4	0	4	29.5506980899
208	236	73	9	64	23.9972449869
208	237	194	46	148	14.4022266513
208	238	8	1	7	28.8630529387
208	239	36	0	36	20.6586277443
208	240	2	0	2	45.5737804836
208	241	3	0	3	56.5397665505
208	242	6	5	1	53.3837954315
208	243	4	0	4	50.0510772589
208	244	9	1	8	50.2020270005
208	245	17	0	17	58.6974431062
208	246	2	0	2	56.5594553619
208	247	5	0	5	45.0263493518
208	249	0	0	0	44.8002539536
208	251	1	0	1	52.1089302088
208	253	5	2	3	38.7434750294
208	254	2	0	2	50.1227801287
208	256	1	0	1	69.6532215366
208	257	3	0	3	63.2094708547
208	258	2	0	2	68.7065069149
208	260	2	0	2	63.6494359293
208	262	8	0	8	47.6778031058
208	264	4	0	4	61.7034718928
208	265	1	0	1	57.009098644
208	266	3	0	3	48.5574181756
208	267	1	0	1	52.0013412736
208	268	3	0	3	46.1512077626
208	271	9	2	7	33.4349696887
208	272	48	0	48	27.5802272961
208	273	3	1	2	35.1128727471
208	274	6	0	6	46.8699626939
208	275	7	0	7	49.2223148659
208	276	8	1	7	32.8501363804
208	277	526	120	406	44.4430820158
208	278	1	0	1	39.2501504828
208	279	2	0	2	53.4757932622
208	280	2	0	2	41.9713453906
208	281	5	1	4	43.262436395
208	282	34	1	33	38.6332661651
208	284	25	0	25	29.8739401799
208	285	2	1	1	35.1236880133
208	286	2	0	2	40.4500605168
208	287	17	2	15	34.243757583
208	289	2	0	2	60.0466075238
208	290	1	0	1	41.6236378527
208	291	29	0	29	21.1333799939
208	292	41	1	40	22.1373647892
208	293	76	2	74	25.7418466105
208	294	24	1	23	24.7708256343
208	295	8	0	8	27.8564508642
208	296	1	0	1	34.6929621367
208	297	17	3	14	18.8011258766
208	298	11	3	8	19.2515303766
208	302	1	0	1	33.3924579587
208	303	5	0	5	84.4368585248
208	305	13	2	11	59.9804930507
208	306	1	0	1	76.5224677882
208	307	12	1	11	71.6788505564
208	309	3	0	3	75.625945895
208	310	0	0	0	40.0141410141
208	312	1	0	1	46.4515004981
208	313	2	0	2	47.8309415352
208	329	1	0	1	75.7625986326
208	332	1	0	1	56.093346993
208	338	4	0	4	63.1367490867
208	345	498	404	94	7.14328294663
208	346	51	3	48	24.1123668508
208	347	1	0	1	65.1321654572
208	349	1	0	1	72.6584152045
208	351	1	0	1	67.7018923861
208	359	1	0	1	82.8290566147
208	369	1	0	1	30.6064970396
208	370	2	0	2	16.8361818473
208	371	20	15	5	12.6128748054
208	372	7	0	7	14.3398104077
208	373	3	0	3	36.7630479002
208	374	1	0	1	28.6925616858
208	375	86	1	85	22.8081244673
208	376	1	0	1	31.7214341725
208	377	2	0	2	34.1665199452
208	378	3	1	2	18.2405493905
208	408	1	0	1	164.864645375
208	415	1	0	1	154.201735036
208	466	2	0	2	157.609221345
208	468	1	0	1	129.500965554
208	469	3	0	3	144.244326931
208	471	4	0	4	143.540481341
208	475	0	0	0	136.255768735
208	477	1	0	1	149.696579401
208	488	3	0	3	158.175278634
208	491	3	0	3	152.778954423
208	503	2	0	2	154.71634002
208	507	1	0	1	219.147695135
208	526	1	0	1	171.989276403
208	545	1	1	0	219.880958253
208	551	0	0	0	121.619379034
208	566	1	0	1	131.202789001
208	573	0	0	0	119.576628417
209	0	3	0	3	83.4308011711
209	1	7	0	7	88.894717713
209	13	1	0	1	87.198100394
209	17	0	0	0	99.4164085658
209	34	4	0	4	105.242633949
209	35	1	0	1	95.5932803111
209	36	2	0	2	84.7006944832
209	55	2	0	2	124.323591443
209	70	5	0	5	71.8198622429
209	71	1	0	1	82.142900996
209	73	40	0	40	77.5013735377
209	74	5	0	5	78.9250788156
209	75	2	0	2	79.8634135274
209	77	1	0	1	72.87503261
209	78	2	0	2	77.7651988847
209	80	1	0	1	73.8949067589
209	81	1	0	1	73.5016125388
209	82	3	0	3	75.4458101162
209	84	5	0	5	78.2480848729
209	85	2	1	1	76.9717007395
209	86	2	0	2	81.2784594375
209	87	3	0	3	81.467997011
209	89	1	0	1	66.436457978
209	95	1	0	1	78.071563653
209	96	2	0	2	69.4980757941
209	103	1	0	1	82.4161503107
209	109	1	0	1	68.8623394351
209	110	1	0	1	86.3928383107
209	112	3	0	3	81.91039701
209	113	2	0	2	85.2971918121
209	114	1	0	1	84.2323878077
209	120	1	0	1	73.0302215074
209	128	1	0	1	105.099985853
209	142	8	1	7	100.703249936
209	171	0	0	0	81.3426409144
209	177	0	0	0	93.3576200487
209	181	5	0	5	32.6242780382
209	182	2	1	1	49.7981010007
209	183	31	1	30	42.3917992341
209	185	2	0	2	38.5179641414
209	187	3	0	3	25.6375021298
209	188	2	0	2	31.1463106458
209	190	1	0	1	52.3983761741
209	191	2	0	2	35.892465555
209	192	3	1	2	29.0016077551
209	193	1	0	1	33.3462612794
209	194	2	0	2	26.3102184946
209	196	27	0	27	28.4503612935
209	198	5	0	5	40.7220705273
209	199	5	0	5	16.1024049973
209	200	5	2	3	18.8216102492
209	201	2	1	1	32.4133636516
209	202	4	0	4	24.7956594988
209	204	30	6	24	13.2257101369
209	205	11	2	9	15.7486496719
209	206	53	5	48	6.92915060156
209	207	355	50	305	2.54131158829
209	208	1198	633	565	6.7160232788
209	210	36	19	17	3.98669245369
209	211	57	0	57	11.1589821478
209	212	175	12	163	9.45030645208
209	213	136	12	124	7.57974177733
209	214	103	70	33	10.8092518453
209	215	3	0	3	15.79380232
209	217	1	0	1	39.6786536302
209	220	10	1	9	45.7228555044
209	222	1	0	1	47.026986752
209	223	6	1	5	19.5597041676
209	224	38	1	37	6.85185826221
209	225	76	0	76	8.20712413446
209	226	6	0	6	8.68661032411
209	227	3	0	3	20.6029737793
209	228	3	0	3	13.7116128974
209	229	93	18	75	12.8943730816
209	230	1	0	1	20.5466394262
209	231	5	1	4	14.0258899289
209	232	9	0	9	10.2327216831
209	233	20	5	15	9.0796344089
209	234	1	0	1	15.6570097756
209	235	0	0	0	23.0223821236
209	236	26	0	26	17.5043136058
209	237	77	0	77	8.84115344867
209	238	4	0	4	22.1783304949
209	239	9	3	6	14.3345729958
209	242	1	1	0	49.7178561015
209	243	2	0	2	45.8428002183
209	244	2	0	2	47.2998626054
209	245	2	0	2	56.7009180747
209	252	1	0	1	43.1174468487
209	262	0	0	0	44.5451851117
209	271	2	0	2	27.1254935517
209	272	3	1	2	22.4567495219
209	274	1	0	1	42.8776535896
209	275	1	0	1	43.8702351989
209	277	90	0	90	39.7274886455
209	279	4	0	4	49.0926170298
209	281	2	0	2	39.8086165965
209	282	2	1	1	35.2627578988
209	284	4	0	4	26.0566137543
209	285	2	0	2	29.564321035
209	286	1	0	1	37.89143499
209	287	1	0	1	29.6636888262
209	291	2	1	1	16.5063996114
209	292	14	1	13	18.8570942604
209	293	9	1	8	24.5464247142
209	294	3	0	3	26.6276902861
209	297	2	0	2	20.2479919477
209	298	4	0	4	18.0290962874
209	303	1	0	1	80.1813704908
209	305	5	0	5	55.8995986752
209	307	2	1	1	67.6519874939
209	309	1	0	1	72.0934679082
209	310	1	1	0	42.9938129456
209	312	1	0	1	51.4757531931
209	338	1	0	1	67.0551652923
209	345	37	0	37	13.8532580411
209	346	4	2	2	26.8571265815
209	372	1	0	1	20.3826239517
209	375	3	0	3	28.7933935363
209	377	1	0	1	38.577828571
209	408	1	0	1	165.163232628
209	415	2	0	2	154.540814042
209	477	0	0	0	148.30201082
209	490	1	0	1	148.491184261
209	491	1	0	1	151.139382059
209	493	1	0	1	172.135773058
209	503	1	0	1	154.402863239
210	1	2	0	2	89.9430221355
210	13	1	0	1	88.8914012413
210	36	1	0	1	86.8104489734
210	37	1	0	1	104.40432791
210	67	1	0	1	124.526022964
210	70	0	0	0	74.7587358781
210	73	14	0	14	80.2520269299
210	75	2	0	2	82.6288325414
210	78	2	0	2	80.7144257402
210	81	1	0	1	76.3287613255
210	82	1	0	1	78.3733671497
210	83	1	0	1	79.9166243894
210	84	1	0	1	81.0431729942
210	88	1	0	1	85.2438257136
210	95	1	0	1	80.5181297709
210	110	1	0	1	88.9596464909
210	112	1	0	1	84.4308888178
210	142	5	0	5	103.418424385
210	181	1	0	1	30.3357800748
210	183	23	0	23	39.366114776
210	184	1	0	1	41.2717125218
210	186	2	0	2	25.9540969102
210	187	5	0	5	21.8188134167
210	191	2	0	2	31.9786662038
210	192	2	0	2	25.3178510582
210	193	1	0	1	29.3700173945
210	194	2	0	2	22.3257887739
210	196	8	0	8	25.903326457
210	200	3	0	3	16.178324138
210	201	1	0	1	30.7891788468
210	204	1	0	1	16.7509134861
210	205	1	0	1	19.6840403769
210	206	7	1	6	10.5831326568
210	207	63	4	59	5.83086780724
210	208	299	12	287	9.83028343952
210	209	102	22	80	3.98669245369
210	211	14	0	14	11.7440360862
210	212	25	0	25	11.9461759091
210	213	58	3	55	7.3287465325
210	214	30	3	27	14.7920093905
210	215	1	0	1	19.5863090309
210	216	1	0	1	42.8649213001
210	217	1	0	1	35.7438846442
210	220	6	2	4	41.836197298
210	222	1	0	1	43.4364712515
210	223	4	0	4	15.5744975993
210	224	50	23	27	4.42505443372
210	225	238	78	160	4.33045749136
210	226	10	9	1	6.02480120526
210	227	1	0	1	16.8793146191
210	228	4	0	4	10.7577243756
210	229	106	12	94	8.92589760279
210	230	1	0	1	16.7377767072
210	231	2	1	1	14.3439661683
210	232	19	1	18	8.47610710527
210	233	9	1	8	8.88763004956
210	234	3	0	3	13.0003766309
210	235	1	0	1	21.5543241243
210	236	15	4	11	16.2731350905
210	237	27	2	25	9.89660687314
210	238	1	1	0	19.3981037783
210	239	11	0	11	10.8337196558
210	242	1	0	1	45.8230108497
210	243	1	0	1	41.8809808482
210	245	1	0	1	59.0339517309
210	251	1	0	1	54.6660236261
210	253	1	0	1	40.2999719212
210	272	1	0	1	23.0682378684
210	277	21	0	21	40.4099830738
210	282	0	0	0	36.9891263941
210	287	1	0	1	30.5996657277
210	291	1	0	1	17.8116689521
210	292	4	0	4	21.0045413633
210	293	4	0	4	27.5395598319
210	294	2	0	2	30.4331081884
210	297	2	0	2	24.0373150059
210	305	2	0	2	56.9655747728
210	345	4	1	3	16.69632093
210	375	2	0	2	32.4628931231
210	392	0	0	0	143.375166684
210	471	1	0	1	143.600668433
210	503	1	0	1	157.335034904
211	0	3	0	3	93.9475192798
211	1	22	1	21	99.8220404933
211	5	1	0	1	110.298676063
211	7	1	0	1	98.2518924959
211	23	1	0	1	107.023003705
211	24	1	0	1	106.044413088
211	28	1	0	1	94.8788257368
211	36	5	0	5	94.5977112463
211	37	1	0	1	112.96536828
211	39	1	0	1	86.23743169
211	42	1	0	1	89.950957027
211	46	1	0	1	130.318491074
211	55	2	0	2	134.751501903
211	56	3	0	3	128.312856641
211	65	1	0	1	138.352986447
211	70	6	0	6	80.1221183648
211	71	1	0	1	90.2674319524
211	73	82	0	82	86.23870889
211	74	9	0	9	87.2713078829
211	75	6	0	6	88.554346114
211	76	2	1	1	82.2643698328
211	78	3	0	3	86.0027042028
211	79	0	0	0	82.5704767238
211	81	4	0	4	82.0789029572
211	82	11	0	11	83.7552791897
211	83	1	0	1	85.6424086624
211	84	9	1	8	86.8766746678
211	85	2	0	2	84.8632419354
211	87	2	0	2	89.9567106803
211	88	3	0	3	90.6667713514
211	89	1	0	1	75.5889762863
211	90	1	0	1	80.8504333197
211	95	2	0	2	87.436640731
211	96	2	0	2	76.5277298736
211	103	5	0	5	91.3913012776
211	109	2	2	0	76.6718240638
211	110	1	0	1	95.4911524584
211	111	1	0	1	71.1533214534
211	112	4	0	4	91.1189211999
211	113	10	1	9	93.9881831147
211	120	2	0	2	82.1406643489
211	122	1	0	1	70.9828434939
211	131	2	0	2	136.312225536
211	134	1	0	1	105.597812904
211	135	1	0	1	121.08494947
211	140	1	0	1	99.9312505797
211	142	12	0	12	109.429383938
211	145	0	0	0	112.280932125
211	147	1	0	1	125.660652273
211	155	1	0	1	85.5365601611
211	169	1	0	1	73.8116148756
211	177	0	0	0	100.173593935
211	181	6	0	6	41.8356289088
211	183	55	2	53	49.9405622513
211	184	2	0	2	52.5446371372
211	185	1	0	1	44.2414471486
211	186	3	1	2	36.7421639494
211	187	7	0	7	30.2960656762
211	188	7	1	6	37.1907166724
211	190	3	0	3	60.8514579209
211	191	5	0	5	35.310601747
211	192	6	0	6	26.7883476155
211	193	1	0	1	35.5836209127
211	194	5	0	5	27.9657457636
211	195	1	0	1	32.5180141623
211	196	160	9	151	21.3698054978
211	198	23	2	21	33.4033401805
211	199	290	45	245	7.15915407909
211	200	42	12	30	13.4131417444
211	201	4	0	4	22.8755215409
211	202	8	2	6	20.9318306511
211	203	1	0	1	31.9702656559
211	204	18	0	18	21.4770329904
211	205	14	2	12	21.0959111135
211	206	38	5	33	15.8865420328
211	207	172	42	130	13.3524524393
211	208	1552	50	1502	7.7838617921
211	209	337	0	337	11.1589821478
211	210	20	1	19	11.7440360862
211	212	113	0	113	19.9906291951
211	213	837	247	590	4.52885333944
211	214	87	0	87	15.3488140723
211	215	8	0	8	16.1973767055
211	217	1	0	1	42.5386267593
211	219	5	0	5	45.6631435846
211	220	16	2	14	49.034108176
211	222	1	0	1	52.4160636379
211	223	26	1	25	22.4833479362
211	224	17	2	15	16.1688176828
211	225	76	10	66	14.7565086978
211	226	41	3	38	8.83553845974
211	227	2	0	2	26.17844238
211	228	57	1	56	11.1695352174
211	229	245	32	213	16.1212793524
211	230	11	0	11	20.3020666974
211	231	2	0	2	25.1599833935
211	232	12	3	9	20.2099518164
211	233	10	0	10	20.015987789
211	234	4	0	4	24.4636724703
211	235	1	0	1	33.2958460596
211	236	20	2	18	27.9690174641
211	237	39	5	34	19.9983274318
211	238	2	0	2	30.6094328993
211	239	17	0	17	21.317999731
211	240	1	0	1	39.1704462171
211	241	3	0	3	50.7907836608
211	242	8	1	7	48.3600804872
211	243	2	0	2	45.7005796021
211	244	6	2	4	44.4710608685
211	245	3	0	3	66.3751975552
211	250	1	0	1	58.7843078023
211	251	2	0	2	59.8854424079
211	262	3	0	3	55.0128587242
211	272	12	1	11	33.6101435819
211	276	7	1	6	40.2570820214
211	277	148	4	144	50.8473700597
211	280	2	0	2	47.6292602227
211	281	7	0	7	50.4502879738
211	282	5	0	5	45.8462139919
211	284	8	0	8	36.8348603427
211	285	0	0	0	40.6832271289
211	287	3	0	3	40.738549461
211	291	5	1	4	27.5410282833
211	292	12	0	12	29.2971960885
211	293	11	0	11	33.476677
211	294	3	2	1	32.2277858242
211	295	1	0	1	35.285449187
211	297	1	0	1	26.4443648841
211	298	4	2	2	26.9484581381
211	299	1	0	1	38.2123048617
211	303	2	0	2	91.2145596743
211	305	1	0	1	66.8569408221
211	307	2	0	2	78.5986409236
211	310	0	0	0	46.7677508153
211	312	1	0	1	51.1998564124
211	319	1	0	1	99.3622021924
211	338	5	2	3	68.9801907976
211	345	476	13	463	9.22820985745
211	346	73	2	71	16.405506154
211	350	1	0	1	48.5781912098
211	353	1	0	1	67.1948574494
211	369	1	0	1	34.2373381327
211	370	1	0	1	22.966392407
211	371	16	0	16	14.9994733448
211	372	2	0	2	18.5919780785
211	373	1	0	1	41.1060389088
211	375	21	3	18	26.5225730939
211	377	0	0	0	39.8567104888
211	415	1	0	1	161.822946794
211	469	0	0	0	152.027729148
211	472	1	0	1	144.10877281
211	475	1	0	1	144.012622101
211	484	0	0	0	157.823846445
211	489	2	0	2	172.612801751
211	523	2	0	2	186.950416752
212	0	2	0	2	74.07090465
212	1	37	1	36	79.8451752535
212	7	2	0	2	78.3488380735
212	9	1	0	1	71.8471754766
212	11	1	0	1	94.1058458058
212	13	3	0	3	77.803918634
212	15	1	0	1	80.9516874248
212	17	1	0	1	90.0717727843
212	23	1	0	1	87.048214736
212	28	1	0	1	74.8945559555
212	32	4	0	4	63.5131430451
212	33	1	0	1	81.4422664285
212	34	1	0	1	95.7931386247
212	36	7	0	7	75.2518817978
212	42	1	0	1	70.3707628176
212	48	0	0	0	115.184019128
212	51	1	0	1	99.268157715
212	55	1	0	1	114.938930916
212	65	1	0	1	118.402573895
212	70	8	0	8	62.8200141119
212	71	4	1	3	73.1926059474
212	73	189	13	176	68.314505122
212	74	7	0	7	69.8874676538
212	75	21	5	16	70.6891949269
212	76	4	1	3	65.1841066081
212	78	14	1	13	68.7767430575
212	79	4	0	4	64.5134961148
212	80	0	0	0	64.7453541821
212	81	8	0	8	64.3830178187
212	82	18	1	17	66.4324904467
212	83	7	1	6	67.970927742
212	84	24	0	24	69.0998133269
212	85	5	1	4	68.143445859
212	86	2	0	2	72.4104999112
212	87	10	1	9	72.3672496073
212	88	4	0	4	73.299937859
212	89	3	1	2	57.1311877661
212	90	3	0	3	64.8801308997
212	92	10	1	9	58.4655397559
212	96	1	0	1	61.1606753637
212	103	10	0	10	73.1428639263
212	104	2	0	2	64.6675810022
212	111	1	0	1	53.2277696005
212	112	8	0	8	72.5715860021
212	113	14	3	11	76.1143382566
212	114	1	0	1	74.8181556182
212	115	1	0	1	49.0529537243
212	120	2	0	2	63.7279284398
212	131	1	0	1	117.596379462
212	140	1	0	1	81.8754054585
212	142	16	0	16	91.4899961681
212	143	1	0	1	100.104343425
212	155	1	0	1	70.8748633107
212	164	1	0	1	76.4103817269
212	171	1	0	1	72.9368017206
212	172	1	0	1	85.7262197134
212	177	1	1	0	85.0266796831
212	181	7	0	7	30.343488886
212	182	3	0	3	50.0966549698
212	183	47	1	46	41.9666999022
212	184	2	0	2	41.6137109904
212	185	1	0	1	40.3400973222
212	186	8	0	8	29.1095229143
212	187	9	1	8	29.4593609919
212	188	4	1	3	33.1304326885
212	190	4	1	3	50.4249845352
212	191	3	0	3	42.6085264919
212	192	2	0	2	36.8109534349
212	194	8	1	7	32.2853167275
212	196	33	16	17	37.7179382105
212	198	6	0	6	49.9262849139
212	199	7	1	6	25.5203542446
212	200	6	0	6	28.0148675184
212	202	3	0	3	33.3902919039
212	204	301	23	278	6.67535934025
212	205	53	14	39	12.0580710258
212	206	420	6	414	4.96705401856
212	207	376	9	367	6.9234590301
212	208	893	0	893	13.2112808653
212	209	221	130	91	9.45030645208
212	210	8	1	7	11.9461759091
212	211	57	2	55	19.9906291951
212	213	85	19	66	16.9540695227
212	214	174	2	172	10.6673660113
212	215	7	0	7	16.9707328701
212	216	1	0	1	49.4510253244
212	218	0	0	0	36.6580232559
212	219	3	0	3	49.5472843983
212	220	17	1	16	49.4026188571
212	221	1	0	1	43.5792713037
212	222	0	0	0	48.7950005175
212	223	10	1	9	25.4569016168
212	224	57	1	56	10.8953391336
212	225	55	0	55	14.4928032573
212	226	5	4	1	17.780140649
212	227	3	0	3	24.2511926928
212	228	4	0	4	22.6770735488
212	229	138	0	138	19.8317293632
212	230	5	1	4	28.0630370562
212	231	104	6	98	8.04090299911
212	232	29	0	29	10.8193735598
212	233	110	5	105	7.1517332855
212	234	22	7	15	16.4198473424
212	235	4	0	4	19.4161661972
212	236	104	33	71	14.2148067227
212	237	607	35	572	4.2642988876
212	238	3	0	3	22.2088580287
212	239	11	6	5	17.890486637
212	240	1	0	1	51.8645770141
212	241	1	0	1	60.9825892573
212	242	1	0	1	56.444653071
212	243	2	2	0	51.959944462
212	244	1	0	1	54.8384695918
212	245	10	4	6	47.2832143924
212	246	1	0	1	46.0367663676
212	247	3	0	3	37.0217074281
212	248	1	0	1	41.4847738368
212	250	1	1	0	39.2620295541
212	251	3	0	3	42.7589562889
212	252	1	0	1	33.6889719649
212	253	5	0	5	28.3538118008
212	254	4	0	4	38.8346255041
212	255	2	0	2	43.9678875672
212	256	1	0	1	57.7124170454
212	257	4	0	4	50.9106934144
212	259	4	0	4	38.2427870564
212	260	3	0	3	51.7517308738
212	262	13	0	13	35.1524470585
212	263	1	0	1	40.7995301994
212	264	7	1	6	48.9839960135
212	266	5	0	5	36.604513329
212	267	1	0	1	39.6364635396
212	268	1	0	1	35.4334473879
212	270	2	0	2	45.3792332427
212	271	8	0	8	22.1429160339
212	272	136	16	120	14.5677301571
212	273	5	0	5	22.0511677017
212	274	1	1	0	33.8120835085
212	275	9	0	9	36.1865174774
212	276	9	1	8	20.582108915
212	277	416	164	252	31.2325381206
212	278	2	1	1	28.2060990818
212	279	2	0	2	40.3017747937
212	280	2	0	2	29.0528410517
212	281	12	3	9	30.4928241476
212	282	19	0	19	25.9106923047
212	283	1	0	1	50.643004377
212	284	29	0	29	16.8451004186
212	285	3	0	3	22.356642969
212	286	2	0	2	28.4419540077
212	287	7	0	7	21.0324767766
212	288	3	0	3	33.468775888
212	291	325	121	204	7.98066628872
212	292	255	228	27	9.42116620046
212	293	156	2	154	15.6671813888
212	294	30	0	30	20.5375073883
212	295	9	0	9	15.7374308853
212	296	3	0	3	26.6506455694
212	297	15	0	15	14.4115470735
212	298	86	2	84	9.53205657696
212	301	3	0	3	19.3088551515
212	302	4	0	4	22.5890878029
212	303	4	0	4	71.3158851034
212	305	4	0	4	46.9044840998
212	307	9	1	8	58.6346163531
212	308	0	0	0	57.2484304889
212	309	1	0	1	62.8449743144
212	310	0	0	0	37.4575136441
212	319	1	0	1	88.9902323351
212	338	0	0	0	62.3372403987
212	345	51	29	22	19.2747573054
212	346	6	2	4	36.1433135003
212	347	1	0	1	59.851123167
212	350	1	1	0	35.6269648987
212	371	1	0	1	22.9429171921
212	372	1	0	1	22.0195857359
212	375	8	3	5	29.4570881739
212	377	1	0	1	35.36472178
212	378	1	0	1	17.452840353
212	442	1	0	1	176.602822247
212	465	0	0	0	141.414705981
212	469	1	0	1	133.818013138
212	471	1	0	1	132.024975081
212	488	2	0	2	146.739657254
212	512	1	0	1	192.833244099
212	551	0	0	0	117.432743896
213	0	3	0	3	90.99813896
213	1	35	1	34	96.4484053653
213	3	0	0	0	88.9159260791
213	5	1	0	1	106.896706391
213	7	1	0	1	95.2606541992
213	13	2	0	2	94.7513594901
213	19	1	0	1	88.0480827924
213	28	2	0	2	91.541045499
213	29	1	0	1	119.255104597
213	35	1	0	1	103.119084134
213	36	3	0	3	92.1319288314
213	37	1	0	1	110.186042931
213	39	1	0	1	83.4861437622
213	42	2	0	2	87.3096783792
213	45	1	0	1	145.282076729
213	48	0	0	0	132.125976081
213	70	7	0	7	78.6229123759
213	71	2	0	2	88.876111351
213	73	82	0	82	84.5011836489
213	74	5	0	5	85.7556607478
213	75	4	0	4	86.8455577548
213	76	2	0	2	80.85395912
213	78	5	1	4	84.5455521437
213	79	2	0	2	80.7698264648
213	80	1	0	1	80.8562504524
213	81	3	0	3	80.4288144217
213	82	14	0	14	82.2562632141
213	83	6	0	6	84.0090015116
213	84	18	0	18	85.2021140088
213	85	4	0	4	83.5908346344
213	86	1	0	1	87.9287452176
213	87	2	0	2	88.3641068867
213	88	2	0	2	89.1640019377
213	89	3	0	3	73.5962309248
213	90	1	0	1	79.8254509737
213	92	1	0	1	74.487441696
213	96	4	0	4	75.6826355663
213	101	2	0	2	64.6698703489
213	103	4	0	4	89.518258093
213	104	1	0	1	81.3893967229
213	109	1	0	1	75.431607922
213	110	3	0	3	93.5465511983
213	111	3	1	2	69.384702951
213	112	7	0	7	89.1040791812
213	113	3	0	3	92.283685224
213	115	0	0	0	64.8787331096
213	120	1	0	1	80.1792637535
213	129	1	0	1	98.6788816283
213	140	1	0	1	98.154965984
213	142	25	4	21	107.714267218
213	145	1	0	1	110.251478722
213	155	1	0	1	84.9403976093
213	163	0	0	0	119.156248406
213	181	3	0	3	37.3067974117
213	182	2	1	1	52.2163436879
213	183	81	0	81	45.5309609427
213	184	1	0	1	48.0295378717
213	186	8	1	7	32.2801530597
213	187	18	0	18	26.274390357
213	188	10	1	9	32.9619433415
213	190	5	1	4	56.3616937306
213	191	4	0	4	32.8536612246
213	192	5	0	5	24.8321644207
213	193	0	0	0	32.2184167297
213	194	6	2	4	24.6667985219
213	195	2	0	2	31.4368946114
213	196	136	7	129	21.7393528817
213	198	18	0	18	34.0326868312
213	199	103	24	79	8.57528944888
213	200	19	0	19	12.5754057267
213	201	1	0	1	24.9381065916
213	202	10	2	8	19.5689673945
213	204	28	13	15	19.6798856492
213	205	16	4	12	20.5462664909
213	206	70	31	39	13.5669969638
213	207	233	182	51	10.0458891901
213	208	2791	634	2157	7.25940359284
213	209	587	11	576	7.57974177733
213	210	69	42	27	7.3287465325
213	211	848	344	504	4.52885333944
213	212	156	0	156	16.9540695227
213	214	146	1	145	14.8123869239
213	215	7	0	7	17.3859550026
213	217	4	0	4	39.0584734452
213	218	1	0	1	32.9225009275
213	219	2	0	2	42.6533319005
213	220	16	0	16	45.4706058801
213	223	20	1	19	18.7231627729
213	224	34	24	10	11.7333700775
213	225	161	8	153	10.2395706912
213	226	96	9	87	4.83019816777
213	227	10	2	8	21.9394172145
213	228	58	15	43	8.64685834343
213	229	314	198	116	12.0716386027
213	230	14	2	12	17.4239312436
213	231	1	0	1	21.2283927683
213	232	12	0	12	15.8009902768
213	233	14	0	14	15.918100659
213	234	13	2	11	19.9356946813
213	235	4	1	3	28.8642509337
213	236	38	4	34	23.601621156
213	237	73	31	42	16.2659416873
213	238	3	0	3	26.0908690624
213	239	24	2	22	16.8497045889
213	240	1	0	1	38.3266798118
213	241	3	0	3	49.3100274904
213	242	13	1	12	46.2989994391
213	243	1	0	1	43.179243417
213	244	4	1	3	42.9707531525
213	245	5	1	4	64.0450728605
213	249	0	0	0	50.6492501934
213	250	1	0	1	56.1749142098
213	251	1	0	1	58.3830369646
213	253	2	0	2	44.5438885514
213	255	2	1	1	60.8856854021
213	257	1	0	1	67.864762936
213	262	2	0	2	52.097470035
213	264	1	0	1	65.8610681555
213	266	2	1	1	48.6742794775
213	268	1	0	1	45.1562995146
213	270	3	0	3	60.376861989
213	271	4	2	2	33.403438882
213	272	18	5	13	29.8392854892
213	273	1	0	1	38.7557518713
213	274	1	0	1	50.4445335399
213	276	7	0	7	37.5153765688
213	277	148	52	96	47.1696900815
213	278	1	0	1	38.7509985394
213	281	1	0	1	47.3826064064
213	282	2	0	2	42.8286728115
213	284	9	1	8	33.6360740004
213	286	1	0	1	45.3430789013
213	287	1	0	1	37.1674163627
213	288	1	0	1	46.9471776942
213	291	4	0	4	24.0550047178
213	292	7	0	7	26.3751069248
213	293	14	0	14	31.5020131862
213	294	10	0	10	31.818911187
213	295	1	0	1	32.6175453231
213	296	2	0	2	41.2196830823
213	297	6	0	6	25.6812162021
213	298	4	1	3	24.9209760701
213	302	1	0	1	38.9613204245
213	303	2	0	2	87.6908986364
213	305	6	1	5	63.4495945095
213	307	0	0	0	75.2028552234
213	309	1	0	1	79.6731797803
213	338	1	0	1	70.3193027642
213	341	1	0	1	58.4791258325
213	345	150	50	100	11.8739500539
213	346	40	1	39	19.2811549837
213	353	1	0	1	67.672726979
213	369	1	0	1	36.8695421822
213	370	1	0	1	24.0060523381
213	371	10	3	7	17.8990723923
213	372	1	0	1	20.7425365642
213	373	2	0	2	43.3968162673
213	375	17	4	13	29.056176212
213	431	1	0	1	196.096451472
213	469	3	0	3	150.216318614
213	471	2	0	2	148.875239928
213	488	1	0	1	163.569524246
213	503	1	0	1	161.14117597
213	581	1	0	1	112.475085743
214	0	5	0	5	80.4877913139
214	1	29	1	28	87.4722680698
214	5	1	0	1	97.9798809071
214	6	1	0	1	106.926423839
214	7	1	0	1	84.8673256983
214	9	3	0	3	78.5365895039
214	13	1	0	1	83.9376923984
214	15	1	0	1	87.5696001751
214	27	1	0	1	104.777174278
214	28	3	0	3	82.4492028709
214	29	0	0	0	109.385389014
214	32	2	1	1	69.9852991518
214	35	1	0	1	91.8944165263
214	36	3	0	3	80.2248594618
214	50	3	0	3	110.192779579
214	59	1	0	1	134.120417674
214	60	1	0	1	113.945800591
214	70	9	3	6	64.8627205732
214	71	3	0	3	74.9628113497
214	72	1	0	1	65.308333609
214	73	73	3	70	71.1021942351
214	74	5	1	4	72.0131465045
214	75	5	0	5	73.3964328538
214	76	3	0	3	66.969853089
214	78	6	1	5	70.7221708723
214	79	2	1	1	67.4838371084
214	81	3	1	2	66.8933498125
214	82	11	0	11	68.4927830457
214	83	1	0	1	70.4433113595
214	84	4	0	4	71.6998151414
214	85	1	1	0	69.5320900619
214	87	4	1	3	74.7320357081
214	88	1	0	1	75.4009117611
214	89	2	0	2	60.6845073409
214	92	4	2	2	60.968601249
214	94	1	0	1	50.8648602272
214	95	1	0	1	72.6275918166
214	96	3	0	3	61.2031122786
214	103	4	0	4	76.3465096653
214	105	2	0	2	64.0496157716
214	107	1	0	1	81.620502161
214	109	1	0	1	61.3374839242
214	110	2	0	2	80.4997998094
214	112	4	0	4	76.1992365704
214	113	8	1	7	78.8217784515
214	122	1	0	1	55.6937273253
214	140	2	0	2	84.8049061272
214	142	20	3	17	94.2564646535
214	164	1	0	1	77.0567838876
214	181	6	0	6	40.5369801756
214	183	38	1	37	51.5423154122
214	185	1	0	1	48.6752302796
214	186	2	1	1	38.2923404782
214	187	3	0	3	36.2694344772
214	188	6	2	4	41.3042294917
214	190	2	0	2	60.6363977813
214	191	2	0	2	46.4774085931
214	192	2	1	1	39.1297592493
214	194	3	0	3	37.093072702
214	196	27	2	25	36.341810636
214	198	6	1	5	48.5534041492
214	199	11	0	11	22.3678962859
214	200	4	1	3	27.3862619093
214	201	1	0	1	38.1588176568
214	202	2	1	1	34.2671075707
214	204	236	30	206	7.51384903312
214	205	286	43	243	5.78751781621
214	206	268	180	88	6.20126587311
214	207	298	23	275	9.70040274574
214	208	1768	757	1011	7.73458232335
214	209	296	0	296	10.8092518453
214	210	12	2	10	14.7920093905
214	211	76	0	76	15.3488140723
214	212	417	55	362	10.6673660113
214	213	145	0	145	14.8123869239
214	215	33	7	26	6.31810629022
214	216	1	0	1	57.1468068749
214	217	1	0	1	50.4443419668
214	219	1	0	1	55.1389476416
214	220	12	0	12	56.4166951249
214	223	11	2	9	30.3663003483
214	224	32	9	23	16.9004085274
214	225	51	15	36	18.9840226955
214	226	4	0	4	18.3150366565
214	228	4	1	3	23.1189613461
214	229	98	3	95	23.6528024281
214	230	2	1	1	30.9904777554
214	231	4	0	4	18.6518753372
214	232	8	0	8	19.046917022
214	233	14	1	13	16.1704629114
214	234	3	2	1	24.9608079925
214	235	2	0	2	29.8375894454
214	236	13	0	13	24.4293829866
214	237	101	9	92	13.943023006
214	238	2	0	2	31.3272544721
214	239	5	1	4	24.7104523259
214	241	0	0	0	63.7451432004
214	242	1	0	1	60.2317836397
214	243	1	0	1	56.5419059402
214	244	4	0	4	57.4228767244
214	245	3	0	3	51.9272322139
214	247	6	0	6	37.3864721895
214	251	2	0	2	44.6544640258
214	253	1	0	1	31.7183027251
214	254	1	0	1	43.3538463206
214	255	1	0	1	50.788695521
214	256	1	0	1	63.145122987
214	257	1	0	1	57.0234618263
214	258	1	0	1	62.7826899241
214	262	4	0	4	41.8564790139
214	264	1	0	1	55.991630383
214	270	1	0	1	55.0701913394
214	271	5	0	5	32.7974618852
214	272	22	3	19	24.7784861408
214	273	1	0	1	30.3717394098
214	274	1	0	1	41.9156006691
214	275	2	1	1	46.0806602209
214	276	2	0	2	27.0606874737
214	277	145	6	139	40.4270299653
214	281	1	0	1	37.8111247322
214	282	10	0	10	33.1982136805
214	284	10	2	8	25.2071931515
214	285	1	0	1	32.7044010352
214	287	2	0	2	30.3300314814
214	288	1	0	1	43.8815071318
214	291	20	5	15	18.1421255836
214	292	24	5	19	17.3912097285
214	293	61	0	61	18.9615875406
214	294	30	0	30	17.0439231656
214	295	3	0	3	22.1302227659
214	296	2	0	2	27.1281507951
214	297	72	0	72	11.0984673436
214	298	14	2	12	12.8593405845
214	301	1	0	1	18.9010457336
214	302	1	0	1	26.6487225057
214	305	4	1	3	54.9537716399
214	307	2	1	1	66.4976433674
214	309	1	0	1	69.9258980933
214	316	1	0	1	25.5285908228
214	317	3	0	3	19.8294057469
214	326	1	0	1	69.2431421418
214	338	2	1	1	56.332238375
214	345	106	8	98	10.2317612556
214	346	5	1	4	31.3532415841
214	370	2	0	2	10.7092990794
214	371	8	2	6	12.5287928827
214	372	2	0	2	11.3789090596
214	375	35	8	27	19.1542218106
214	377	0	0	0	27.768707822
214	378	1	0	1	10.7626769909
214	466	1	0	1	150.292297842
214	471	1	0	1	136.619292293
214	480	1	0	1	136.93065247
214	555	1	0	1	126.139653303
214	573	1	1	0	111.903281658
215	9	1	0	1	82.4931061359
215	21	0	0	0	99.7724915755
215	36	1	0	1	83.2147157812
215	73	3	0	3	72.9310227
215	74	2	0	2	73.4542014455
215	75	2	0	2	75.1576520934
215	76	1	0	1	68.2688759884
215	82	1	0	1	69.9326279321
215	83	1	0	1	72.098776609
215	84	1	0	1	73.4157860085
215	103	1	0	1	78.3650742968
215	113	1	0	1	80.5365594945
215	142	0	0	0	95.9017312091
215	177	0	0	0	84.9037371633
215	183	4	0	4	57.5700508917
215	187	0	0	0	41.3983596178
215	191	0	0	0	50.1540461403
215	196	1	0	1	37.5124617088
215	199	1	0	1	23.2930423034
215	200	1	0	1	29.4286053611
215	204	8	6	2	12.8635358595
215	205	25	10	15	8.26039381225
215	206	6	0	6	12.4676463434
215	207	8	0	8	15.3329764844
215	208	74	24	50	10.3736584849
215	209	21	0	21	15.79380232
215	210	1	0	1	19.5863090309
215	211	4	0	4	16.1973767055
215	212	15	4	11	16.9707328701
215	213	11	0	11	17.3859550026
215	214	30	24	6	6.31810629022
215	220	0	0	0	61.408716547
215	225	5	0	5	23.913075395
215	226	1	0	1	21.7401106899
215	228	3	0	3	26.0326325188
215	229	3	0	3	28.0352759968
215	232	1	0	1	24.9901642842
215	233	1	0	1	22.3313868681
215	237	3	0	3	20.2196680882
215	239	1	0	1	30.1058817018
215	245	1	0	1	55.0188356447
215	272	1	0	1	30.8568551393
215	277	1	0	1	45.9418923642
215	280	1	0	1	45.1558186813
215	281	1	0	1	42.4854217589
215	287	1	0	1	35.9912591922
215	291	1	0	1	24.2670714248
215	293	8	0	8	22.7350059967
215	294	5	3	2	17.365645923
215	297	2	0	2	12.9764479578
215	298	2	0	2	17.4990434156
215	305	1	0	1	59.788170757
215	310	1	0	1	30.6308225789
215	329	1	0	1	66.6724569688
215	334	1	0	1	52.9457141414
215	338	2	1	1	52.9787622489
215	341	0	0	0	41.0942364814
215	345	79	19	60	7.88934229427
215	350	1	0	1	33.1808467657
215	370	1	1	0	6.76943898556
215	371	12	3	9	7.0739687804
215	372	8	1	7	5.06187232846
215	375	43	17	26	13.1045177175
215	377	2	0	2	23.904385893
215	378	2	0	2	10.0222612165
215	408	1	0	1	157.382581433
215	573	0	0	0	110.753697246
216	0	1	1	0	98.6372057163
216	1	27	0	27	97.4623637114
216	5	1	0	1	106.280257662
216	13	1	0	1	103.058021955
216	19	3	0	3	96.0383201335
216	23	1	0	1	107.206376027
216	28	3	0	3	93.7414512478
216	36	2	0	2	105.358068361
216	39	1	0	1	94.5792760354
216	65	1	0	1	136.91570947
216	70	7	1	6	102.573509662
216	71	1	0	1	112.662957087
216	72	1	0	1	100.907460283
216	73	68	7	61	105.765426357
216	74	6	0	6	108.804984777
216	75	10	0	10	108.113693215
216	76	1	0	1	105.28043506
216	78	10	2	8	108.205938361
216	79	2	0	2	101.900989399
216	81	3	0	3	102.911159551
216	82	12	3	9	105.807660341
216	83	2	0	2	106.236284194
216	84	6	0	6	106.944623832
216	85	1	0	1	108.841293238
216	86	1	0	1	112.571388904
216	88	2	0	2	111.989282206
216	89	2	0	2	93.9449085417
216	90	2	0	2	107.330857682
216	92	2	0	2	97.6486488952
216	94	0	0	0	93.2365799811
216	103	1	0	1	109.016653175
216	106	1	0	1	89.3994473823
216	112	5	0	5	107.304397699
216	113	8	0	8	113.04897889
216	114	1	0	1	107.284882548
216	118	1	0	1	109.018810496
216	120	1	0	1	99.927660738
216	122	2	0	2	95.4100799549
216	131	0	0	0	148.343526026
216	134	1	0	1	122.139727905
216	142	5	0	5	127.085066858
216	145	1	0	1	126.371050208
216	181	9	0	9	26.7919601716
216	182	48	0	48	13.3503814115
216	183	531	128	403	16.6295029635
216	184	12	3	9	24.4228789636
216	185	34	6	28	9.85812405744
216	186	20	1	19	21.926073888
216	187	14	0	14	21.0617571712
216	188	53	8	45	16.4058151177
216	189	4	0	4	10.8814103411
216	190	40	13	27	25.4209806576
216	191	13	5	8	22.7435706247
216	192	3	0	3	30.1976416541
216	193	2	0	2	16.4499895473
216	194	5	0	5	23.6250571627
216	195	0	0	0	33.7978534949
216	196	6	1	5	43.2300264098
216	200	2	0	2	41.2146422862
216	201	0	0	0	52.321087623
216	202	2	0	2	35.8354244543
216	206	1	0	1	51.5744134754
216	207	1	0	1	47.4470498414
216	208	15	0	15	52.5479765531
216	209	2	1	1	46.6385728126
216	211	2	0	2	50.9274672264
216	212	1	0	1	49.4510253244
216	213	1	0	1	47.1262176472
216	217	42	4	38	9.81465425382
216	218	12	1	11	14.2155571795
216	219	50	8	42	13.3930775826
216	220	2052	212	1840	4.69444716707
216	221	39	3	36	6.05992063997
216	222	224	6	218	5.46598299039
216	223	1	0	1	28.4503703911
216	225	4	0	4	38.5351695844
216	227	4	0	4	26.0395739669
216	229	25	1	24	35.0820185638
216	230	1	0	1	31.5978273594
216	232	2	0	2	38.7402627298
216	233	1	0	1	42.3092166374
216	234	1	0	1	33.0358534764
216	236	4	0	4	37.1762246557
216	238	5	0	5	27.8660917575
216	239	4	1	3	32.4363852798
216	241	8	0	8	32.2465052167
216	242	19	0	19	24.9795199222
216	243	31	5	26	19.3448587202
216	244	11	1	10	30.3888888339
216	245	7	0	7	82.8546531704
216	248	1	0	1	81.0770025541
216	251	0	0	0	85.135180126
216	256	1	0	1	88.8571631359
216	260	1	0	1	84.1918715603
216	262	1	0	1	67.8976128186
216	266	1	0	1	41.0132317245
216	268	2	0	2	33.2179203031
216	271	3	0	3	37.0763998438
216	272	1	0	1	46.5421263686
216	275	1	0	1	51.9693349059
216	276	2	0	2	60.1558594646
216	277	89	3	86	55.2089201725
216	278	1	0	1	35.0044730796
216	281	1	1	0	63.0805931959
216	282	1	0	1	60.7606257689
216	284	1	0	1	54.0203849963
216	287	2	0	2	51.6040414823
216	291	1	0	1	48.0077925525
216	294	0	0	0	69.8459686654
216	295	1	0	1	57.9909305151
216	297	1	0	1	63.8565605063
216	307	3	0	3	79.2212501641
216	309	1	0	1	86.3957208595
216	319	1	0	1	136.772265089
216	338	1	0	1	111.732987778
216	345	0	0	0	58.8446620306
216	375	1	0	1	75.3172624237
216	416	1	0	1	201.306587591
216	469	1	0	1	166.236991735
216	471	1	0	1	159.04002479
216	475	1	0	1	162.740293173
216	503	1	0	1	181.555543314
216	507	1	0	1	264.426100453
217	1	13	0	13	100.594474562
217	5	1	0	1	109.886271224
217	13	2	0	2	104.82760812
217	28	3	1	2	96.5617505086
217	36	0	0	0	106.160142235
217	70	2	0	2	101.061725269
217	72	1	0	1	99.7497726945
217	73	33	0	33	104.885897094
217	74	4	0	4	107.590893817
217	75	6	0	6	107.271935575
217	78	1	0	1	106.850166098
217	79	3	0	3	100.981959592
217	80	1	0	1	101.814734712
217	81	3	0	3	101.721464052
217	82	6	0	6	104.437087349
217	83	1	0	1	105.158228675
217	84	2	0	2	105.982276883
217	85	1	0	1	107.148570015
217	87	1	0	1	109.505894599
217	88	1	0	1	110.871634003
217	89	1	0	1	93.0315793775
217	90	1	0	1	105.117716095
217	95	1	0	1	102.816619628
217	96	1	0	1	102.251131117
217	103	1	0	1	108.566709076
217	111	1	0	1	90.8070839915
217	112	1	0	1	107.101259147
217	113	4	0	4	112.390440443
217	118	1	0	1	107.086799643
217	133	1	0	1	120.508901841
217	139	0	0	0	148.311952369
217	142	6	0	6	126.906455573
217	181	5	0	5	27.4497531208
217	182	11	0	11	21.536511154
217	183	317	214	103	21.4430341495
217	184	6	0	6	29.0457637276
217	185	57	0	57	11.4725410125
217	186	32	0	32	20.3462172072
217	187	63	26	37	14.5104301338
217	188	75	8	67	13.6104395628
217	190	10	2	8	32.4609091125
217	191	41	4	37	13.1020445102
217	192	4	1	3	20.4068932834
217	193	34	4	30	7.05167538775
217	194	20	4	16	14.63146008
217	195	2	1	1	24.2199154467
217	196	13	0	13	33.4424616256
217	198	3	2	1	36.7583118574
217	202	2	0	2	26.176780753
217	204	0	0	0	50.4810702265
217	207	6	1	5	40.8683118503
217	208	12	3	9	45.0639009165
217	209	1	0	1	39.6786536302
217	211	3	0	3	42.5386267593
217	213	4	0	4	39.0584734452
217	214	1	0	1	50.4443419668
217	216	29	12	17	9.81465425382
217	218	55	3	52	7.40451604875
217	219	65	12	53	7.17031160917
217	220	1134	96	1038	6.58371450655
217	221	108	1	107	6.24654246931
217	222	23	0	23	14.0282615391
217	223	13	0	13	20.4365454988
217	225	4	0	4	31.4729373428
217	226	1	0	1	34.2376198394
217	227	4	0	4	19.7245456334
217	229	43	1	42	27.2946877432
217	230	2	0	2	22.5769251603
217	232	4	0	4	33.1678887515
217	234	4	0	4	28.0388128389
217	235	1	0	1	32.4705543857
217	236	5	1	4	33.4985619666
217	237	1	0	1	39.7969468317
217	238	3	1	2	24.3573559318
217	239	3	0	3	26.1697765827
217	241	9	1	8	25.9486609619
217	242	30	7	23	18.792736243
217	243	42	18	24	12.6627039575
217	244	36	0	36	22.6582507842
217	245	3	0	3	81.9798851876
217	248	1	0	1	79.2202301295
217	260	1	0	1	84.0402092036
217	262	1	0	1	67.086405732
217	266	1	0	1	43.4437479412
217	268	1	0	1	35.7532808244
217	270	1	0	1	60.5766175448
217	271	6	1	5	35.9766619972
217	272	1	0	1	43.8713622011
217	273	1	0	1	53.9640016226
217	276	2	0	2	57.4986051302
217	277	54	3	51	55.2862247964
217	280	2	0	2	47.9641090587
217	281	1	0	1	62.0397074252
217	282	1	0	1	59.1139636677
217	284	1	0	1	51.3674211685
217	287	1	0	1	49.9869392761
217	288	1	0	1	46.4954117242
217	293	1	0	1	57.8464878752
217	307	1	0	1	81.3013000392
217	345	1	0	1	50.9206536514
217	465	1	0	1	175.098942191
217	471	2	0	2	161.074924565
217	475	3	0	3	162.706432476
217	491	1	0	1	172.59099505
217	495	1	0	1	183.900865619
217	505	1	0	1	192.224266236
217	573	0	0	0	155.853634112
218	1	11	1	10	95.2018548639
218	5	1	0	1	104.730553167
218	7	1	0	1	97.9942376737
218	23	1	0	1	104.464075496
218	27	1	0	1	115.415911743
218	28	2	0	2	91.0159879063
218	35	1	0	1	107.766081427
218	50	1	0	1	125.54589233
218	70	1	0	1	93.9075464756
218	72	0	0	0	92.6751860869
218	73	32	0	32	97.8720283409
218	74	0	0	0	100.493638552
218	75	6	0	6	100.26444713
218	77	1	0	1	93.3941456571
218	78	4	0	4	99.7224875342
218	80	1	0	1	94.7513309737
218	81	0	0	0	94.6368244406
218	82	4	0	4	97.3088600645
218	83	3	0	3	98.095357791
218	84	6	0	6	98.9463154683
218	85	1	1	0	99.9525727752
218	87	2	0	2	102.458812846
218	89	2	0	2	86.0274816633
218	95	2	0	2	96.0061394246
218	96	1	0	1	94.9169619854
218	103	2	0	2	101.662666753
218	110	1	0	1	104.958490919
218	112	3	0	3	100.271666478
218	113	4	0	4	105.423964024
218	127	1	1	0	114.286115576
218	142	7	0	7	120.057045226
218	181	9	0	9	21.7733981845
218	182	7	1	6	22.1704149618
218	183	385	111	274	19.1367589468
218	184	4	1	3	25.8407699049
218	185	86	26	60	9.5635384757
218	186	63	0	63	13.9704055291
218	187	277	8	269	7.25789784481
218	188	310	139	171	7.40128365252
218	189	3	0	3	17.1572027367
218	190	5	0	5	31.0816724934
218	191	57	1	56	14.3284350451
218	192	5	0	5	18.4863309963
218	193	86	14	72	5.38080852685
218	194	104	44	60	10.0371432432
218	195	1	0	1	24.628621582
218	196	18	0	18	31.0025494088
218	198	4	0	4	36.7434911856
218	200	1	0	1	27.5097708587
218	202	4	0	4	23.0601437462
218	204	1	0	1	43.2100975611
218	207	3	0	3	33.8411739489
218	208	28	2	26	38.4994301936
218	209	5	0	5	32.8107470038
218	210	1	0	1	28.9433088869
218	211	3	0	3	36.7144804948
218	212	9	1	8	36.6580232559
218	213	1	0	1	32.9225009275
218	214	1	0	1	43.4913239253
218	216	14	0	14	14.2155571795
218	217	122	12	110	7.40451604875
218	219	36	31	5	13.9566124843
218	220	660	321	339	12.9259282667
218	221	85	49	36	8.2727012081
218	222	24	1	23	16.2514566191
218	223	48	0	48	14.2348831479
218	224	1	0	1	26.7250800722
218	225	7	0	7	24.6234556531
218	226	1	0	1	28.101623411
218	227	43	24	19	12.4759535037
218	228	1	0	1	26.0627128961
218	229	119	13	106	20.9014240074
218	230	5	2	3	17.7554100829
218	231	1	0	1	31.7614037412
218	232	7	0	7	25.8418139079
218	233	1	0	1	29.5480122547
218	234	1	0	1	20.6392112503
218	235	2	0	2	25.4174387458
218	236	11	2	9	26.147907792
218	237	3	1	2	32.4617351074
218	238	10	0	10	17.1149138889
218	239	18	4	14	18.9650919034
218	241	1	0	1	31.0136654802
218	242	20	6	14	24.3213325511
218	243	16	0	16	18.4078046394
218	244	20	1	19	26.6087454369
218	245	3	0	3	75.0086694374
218	256	1	0	1	82.4590972485
218	260	1	0	1	77.2769143323
218	262	3	0	3	60.1786903855
218	266	4	0	4	38.1874880633
218	268	5	1	4	30.7803239175
218	271	3	0	3	29.2317962268
218	272	2	0	2	36.6245191795
218	274	1	0	1	54.9644543185
218	275	1	0	1	47.4164720934
218	277	51	6	45	48.7429238695
218	279	1	0	1	57.7331996393
218	281	2	0	2	55.0873734932
218	282	0	0	0	52.0169635115
218	285	1	0	1	37.075390469
218	287	2	0	2	42.9405753328
218	293	2	0	2	50.4419720863
218	303	2	0	2	85.3627706634
218	307	1	0	1	75.4489071341
218	338	0	0	0	98.9169215757
218	375	3	0	3	61.3042194784
218	471	1	0	1	155.005935037
218	475	1	0	1	155.867858507
218	491	1	0	1	166.335689789
219	1	32	3	29	107.6947868
219	5	4	0	4	116.933570821
219	11	1	0	1	116.555710156
219	15	4	0	4	113.057516804
219	18	1	0	1	110.533560812
219	21	1	0	1	116.878969111
219	29	1	0	1	131.408195451
219	32	1	0	1	98.1065814897
219	34	1	0	1	132.66524402
219	36	5	0	5	113.297755201
219	39	1	0	1	102.762945978
219	40	1	0	1	97.7674073789
219	48	3	0	3	149.580055205
219	55	2	0	2	146.82202047
219	68	1	0	1	142.587556721
219	70	11	1	10	107.86245353
219	71	2	0	2	118.17883073
219	73	85	4	81	111.812951542
219	74	12	0	12	114.449381996
219	75	9	0	9	114.203739459
219	76	2	0	2	110.495652611
219	77	1	0	1	107.341841168
219	78	5	0	5	113.679032892
219	79	2	0	2	107.905530364
219	80	2	0	2	108.702924928
219	81	9	0	9	108.591316568
219	82	9	0	9	111.265403891
219	84	12	0	12	112.89275349
219	85	2	0	2	113.898870464
219	87	1	0	1	116.407736789
219	88	0	0	0	117.746834819
219	89	1	0	1	99.9648943199
219	90	1	0	1	111.733313805
219	92	3	0	3	103.039574972
219	95	2	0	2	109.858832084
219	96	3	0	3	108.747064329
219	99	2	0	2	122.553335117
219	100	1	0	1	107.092340047
219	103	6	0	6	115.563682041
219	104	1	0	1	105.29715888
219	105	1	0	1	100.85696681
219	111	1	0	1	97.6260123359
219	112	5	0	5	114.135397204
219	113	10	1	9	119.350478561
219	114	1	0	1	114.695739022
219	121	1	0	1	120.650084375
219	122	1	0	1	100.035891501
219	124	2	0	2	142.621309056
219	131	1	0	1	156.635357155
219	140	1	0	1	124.398177126
219	142	6	0	6	133.932865108
219	146	1	1	0	123.504211394
219	147	1	0	1	151.933113517
219	167	1	0	1	148.399276686
219	168	1	0	1	127.492245533
219	172	1	0	1	132.101182342
219	177	0	0	0	132.235544917
219	181	2	0	2	34.6188324297
219	182	12	4	8	26.58909624
219	183	212	69	143	27.9483277025
219	184	5	1	4	35.7129658271
219	185	13	1	12	18.3036277834
219	186	12	6	6	27.4548061689
219	187	21	0	21	20.4302798404
219	188	28	9	19	20.7045835829
219	190	10	0	10	38.2825643167
219	191	55	13	42	11.7090479221
219	192	6	2	4	20.6521685265
219	193	13	2	11	11.1212878081
219	194	10	0	10	18.1178091838
219	196	17	0	17	33.1941819265
219	198	2	0	2	34.0343063668
219	199	2	0	2	40.9523899082
219	202	3	0	3	27.0200176281
219	204	5	0	5	55.894903643
219	206	1	0	1	50.4098862094
219	207	3	0	3	45.7942970322
219	208	15	0	15	49.1630811411
219	209	4	0	4	44.3333097592
219	211	5	0	5	45.6631435846
219	212	5	0	5	49.5472843983
219	213	1	0	1	42.6533319005
219	216	23	0	23	13.3930775826
219	217	66	21	45	7.17031160917
219	218	16	0	16	13.9566124843
219	220	958	34	924	8.71670495889
219	221	28	5	23	12.5893002426
219	222	24	7	17	18.6802665246
219	223	5	0	5	24.7736315899
219	224	1	0	1	39.0238512936
219	225	6	0	6	36.2341028169
219	226	1	0	1	37.9430524427
219	227	1	0	1	25.454027586
219	228	1	0	1	34.4939080187
219	229	19	6	13	31.5345258996
219	231	1	0	1	45.3548668433
219	232	0	0	0	38.8748806445
219	233	3	0	3	42.6013990889
219	234	1	0	1	34.1436718704
219	236	2	0	2	40.0010882786
219	237	3	0	3	45.4825610738
219	238	4	3	1	31.0663127093
219	239	2	0	2	31.6618635758
219	240	2	0	2	22.6971803832
219	241	33	9	24	19.3131468091
219	242	131	2	129	12.0232575081
219	243	373	68	305	6.04560491504
219	244	99	27	72	16.9965711324
219	245	5	0	5	88.9343129145
219	246	0	0	0	90.1819889525
219	247	2	0	2	85.256187636
219	251	0	0	0	89.2285595035
219	252	2	0	2	76.4773586797
219	254	3	0	3	81.8693174952
219	256	1	0	1	96.2032220989
219	257	3	0	3	88.4233139972
219	260	1	0	1	91.0992265027
219	262	1	0	1	74.0758778776
219	264	1	0	1	84.0078189868
219	269	1	0	1	52.9229216225
219	271	2	0	2	43.0227590584
219	272	1	0	1	50.5623622759
219	275	2	0	2	60.5443093203
219	276	1	0	1	64.1136462266
219	277	72	0	72	62.4030306144
219	281	1	0	1	69.0026084394
219	282	3	1	2	65.9710662238
219	284	2	0	2	58.0152724936
219	286	1	0	1	70.988988896
219	291	2	1	1	50.2608658794
219	292	1	0	1	55.3326465318
219	293	2	0	2	63.9474181664
219	294	1	0	1	69.9599307389
219	295	2	0	2	61.0457472857
219	303	1	0	1	97.7957748058
219	305	3	1	2	78.3549849411
219	307	7	0	7	88.4645607541
219	310	2	0	2	86.7981300303
219	319	1	0	1	138.492663529
219	338	1	0	1	111.287446808
219	341	0	0	0	100.133739408
219	345	2	0	2	54.4796446996
219	346	1	0	1	45.0140986644
219	367	1	0	1	125.995771629
219	371	1	0	1	60.478155682
219	375	3	1	2	71.70267816
219	377	1	0	1	82.8998939667
219	415	1	0	1	191.078733829
219	469	2	0	2	174.240765863
219	471	1	0	1	168.244737457
219	475	1	0	1	169.73981362
219	477	1	0	1	178.133691145
219	480	1	0	1	171.734040208
219	487	1	0	1	178.089577415
219	491	1	0	1	179.75785909
219	505	1	0	1	199.378909429
219	506	1	0	1	213.808910167
219	507	1	0	1	266.074139166
219	579	1	0	1	149.575569513
219	581	1	0	1	147.102665229
220	0	2	0	2	101.920194257
220	1	112	7	105	101.173399168
220	2	1	0	1	110.989095778
220	5	9	0	9	110.141106299
220	12	2	0	2	106.499885724
220	13	5	0	5	106.327490354
220	17	1	0	1	116.012362192
220	18	2	0	2	105.07684725
220	21	3	0	3	110.337319101
220	23	3	0	3	110.834568394
220	24	2	0	2	110.982521901
220	28	11	0	11	97.3510249595
220	30	1	0	1	121.206660683
220	31	1	0	1	116.721305098
220	32	3	0	3	92.7262067326
220	33	1	0	1	111.501376904
220	35	1	0	1	115.365810687
220	36	13	0	13	108.28194543
220	41	1	0	1	113.549304601
220	42	1	0	1	102.136303802
220	45	1	0	1	157.435507383
220	48	1	0	1	143.578004472
220	50	1	0	1	132.650561502
220	55	2	0	2	140.458006635
220	57	1	0	1	150.055982077
220	59	7	0	7	155.120328822
220	65	2	0	2	140.773506702
220	70	29	0	29	104.56498693
220	71	3	0	3	114.748279085
220	72	1	0	1	103.048160528
220	73	405	0	405	108.027897172
220	74	24	2	22	110.930271455
220	75	33	3	30	110.394224845
220	76	18	1	17	107.250147902
220	78	46	0	46	110.270347721
220	79	11	0	11	104.142845758
220	80	1	0	1	105.081135594
220	81	14	0	14	105.040598404
220	82	71	0	71	107.863286111
220	83	15	0	15	108.416352506
220	84	35	0	35	109.173859415
220	85	8	0	8	110.760856807
220	86	6	0	6	114.575878682
220	87	7	0	7	112.717168602
220	88	6	0	6	114.158366674
220	89	9	0	9	96.1793900244
220	90	2	0	2	109.018275469
220	92	12	0	12	99.6679539525
220	94	1	0	1	94.7268023871
220	95	4	0	4	105.530988999
220	96	4	0	4	106.374863436
220	99	1	0	1	118.042327916
220	103	11	0	11	111.458321046
220	105	1	0	1	96.6516704731
220	106	1	0	1	91.8479829693
220	109	3	0	3	103.539636622
220	110	8	0	8	114.516011303
220	111	3	0	3	94.2877919069
220	112	17	0	17	109.843293776
220	113	47	21	26	115.409647738
220	114	1	0	1	110.026413352
220	116	1	0	1	107.259087389
220	117	2	0	2	115.413112048
220	120	1	0	1	102.273079599
220	123	1	0	1	89.815805248
220	124	3	0	3	137.580779795
220	129	1	0	1	116.992142885
220	133	1	0	1	122.87650591
220	141	3	0	3	157.839334108
220	142	35	1	34	129.650471025
220	146	2	0	2	119.850944295
220	147	1	0	1	147.810139113
220	150	1	0	1	154.218049945
220	154	1	0	1	137.422273416
220	155	2	0	2	116.523379174
220	166	2	1	1	119.84671054
220	169	1	0	1	105.749417258
220	170	1	0	1	133.379329562
220	177	2	0	2	129.505634924
220	179	1	0	1	103.439406039
220	181	36	21	15	29.3484142956
220	182	96	1	95	18.008736208
220	183	1483	25	1458	20.4895746713
220	184	21	0	21	28.3487103683
220	185	135	0	135	12.0848922791
220	186	95	0	95	23.4499685784
220	187	71	0	71	20.1688053664
220	188	148	1	147	17.1793737696
220	189	1	0	1	15.1258632061
220	190	87	0	87	29.9629950068
220	191	50	7	43	18.6987618884
220	192	8	1	7	26.7008261103
220	193	18	3	15	13.6343600823
220	194	14	4	10	21.1908403427
220	195	1	0	1	29.6041774216
220	196	42	18	24	39.7055803094
220	198	3	0	3	42.0745065018
220	199	1	0	1	45.3223238238
220	202	7	1	6	32.6361086386
220	203	2	0	2	35.3235646246
220	204	1	0	1	56.0042280292
220	205	1	0	1	60.5660571566
220	206	2	0	2	51.0994432983
220	207	10	0	10	46.7660315229
220	208	82	28	54	51.3090905899
220	209	5	2	3	45.7228555044
220	211	1	0	1	49.034108176
220	212	6	0	6	49.4026188571
220	213	12	0	12	45.4706058801
220	214	6	0	6	56.4166951249
220	216	299	275	24	4.69444716707
220	217	218	80	138	6.58371450655
220	218	68	2	66	12.9259282667
220	219	422	7	415	8.71670495889
220	221	108	5	103	6.51003098581
220	222	231	74	157	10.0918450137
220	223	17	1	16	26.7725228732
220	224	2	1	1	39.6393320062
220	225	14	3	11	37.5257634289
220	226	1	0	1	40.6418131116
220	227	16	0	16	25.3639326102
220	228	1	0	1	38.0575025731
220	229	100	45	55	33.5906609995
220	230	5	1	4	29.1524896692
220	231	1	0	1	44.0196983533
220	232	3	0	3	38.5896450205
220	233	1	0	1	42.259837342
220	234	2	0	2	33.1434606449
220	235	8	1	7	36.1567164554
220	236	24	3	21	37.9774051549
220	237	4	0	4	45.1704742244
220	238	13	0	13	28.6405439459
220	239	47	15	32	31.8568202949
220	240	2	0	2	31.2481625544
220	241	33	18	15	27.5991894616
220	242	119	54	65	20.3169034882
220	243	162	33	129	14.6504843239
220	244	89	19	70	25.7053858071
220	245	20	2	18	85.0884303924
220	246	1	0	1	86.911246143
220	247	1	0	1	83.4827714511
220	250	1	0	1	76.1796461168
220	251	2	0	2	86.6707540216
220	252	1	0	1	73.2314586646
220	253	1	0	1	72.2885360867
220	254	3	0	3	78.5175968072
220	257	6	0	6	83.7607358245
220	258	3	0	3	85.9412378156
220	259	1	0	1	69.3959181816
220	260	1	0	1	86.7216259
220	262	8	0	8	70.1264592125
220	264	1	0	1	79.0297071224
220	265	0	0	0	54.9748768557
220	266	5	0	5	44.3632670436
220	268	12	0	12	36.5491615226
220	270	3	0	3	61.4958425271
220	271	14	0	14	39.0384723878
220	272	12	0	12	47.8794121751
220	273	1	0	1	57.536730178
220	274	8	1	7	64.3217096891
220	275	5	0	5	55.0086352822
220	276	3	0	3	61.556419588
220	277	429	4	425	57.7572175764
220	279	4	0	4	65.9995470221
220	280	1	0	1	50.2571361064
220	281	4	0	4	65.2004056769
220	282	14	0	14	62.6146074509
220	284	6	3	3	55.4008545425
220	285	2	0	2	46.923978331
220	286	0	0	0	67.8932730926
220	287	6	0	6	53.436074955
220	288	1	0	1	48.0713853758
220	290	0	0	0	44.9012110754
220	292	2	0	2	53.8699048325
220	293	4	3	1	62.6739323621
220	294	1	0	1	69.9253022433
220	298	2	0	2	58.1534242947
220	303	6	0	6	91.2565583188
220	305	7	1	6	72.9879982115
220	307	12	0	12	82.5675990063
220	308	1	0	1	76.816490787
220	309	2	0	2	89.631771399
220	319	1	0	1	137.557506
220	328	1	0	1	128.131962369
220	329	1	0	1	119.213863555
220	338	1	0	1	111.726020795
220	345	5	0	5	57.3095199774
220	346	4	0	4	50.9124850583
220	348	1	0	1	97.3705589819
220	350	2	0	2	84.1967537552
220	371	1	0	1	63.3295704735
220	375	7	3	4	74.1148406906
220	408	1	0	1	197.526529484
220	447	1	1	0	218.44800502
220	464	1	0	1	161.985074512
220	465	2	0	2	177.258541768
220	466	5	1	4	181.456380311
220	469	3	0	3	169.22591662
220	471	6	0	6	162.43524141
220	475	2	0	2	165.382659111
220	488	2	0	2	177.037452519
220	491	1	0	1	174.221753653
220	492	0	0	0	183.741417335
220	507	1	0	1	265.256286099
220	555	1	0	1	177.64726159
220	573	2	1	1	160.08932229
221	0	1	0	1	95.7642800256
221	1	8	0	8	95.3708201798
221	5	1	0	1	104.499932624
221	9	1	0	1	92.7268337106
221	55	1	0	1	134.585343803
221	70	2	0	2	98.0554342626
221	71	1	0	1	108.238493811
221	72	1	0	1	96.5400674126
221	73	26	0	26	101.527139324
221	74	3	0	3	104.421425297
221	75	7	0	7	103.894917243
221	78	5	0	5	103.760379795
221	82	4	0	4	101.353279227
221	83	2	0	2	101.909857425
221	84	5	0	5	102.670397032
221	85	1	0	1	104.253853817
221	87	1	0	1	106.212953024
221	112	3	0	3	103.382386596
221	113	8	1	7	108.918657209
221	133	1	0	1	116.481527658
221	142	4	0	4	123.192315564
221	171	1	0	1	110.981677853
221	172	1	0	1	122.522125346
221	181	5	0	5	22.964751871
221	182	7	2	5	15.4526484158
221	183	368	67	301	15.3854266297
221	184	4	1	3	23.1245385953
221	185	72	40	32	5.86208829115
221	186	46	0	46	16.9483590456
221	187	35	0	35	15.0022773143
221	188	79	13	66	10.8158779004
221	189	2	0	2	11.1596892478
221	190	5	2	3	26.2163481022
221	191	9	6	3	19.0321280259
221	192	3	0	3	25.4348317051
221	193	10	2	8	11.3870637344
221	194	10	0	10	18.0269608771
221	195	1	0	1	30.1182927012
221	196	7	1	6	38.3577251456
221	202	2	0	2	30.6788014856
221	204	0	0	0	50.2281052929
221	206	1	0	1	45.58677228
221	207	2	0	2	41.4199762656
221	208	9	1	8	46.4892149237
221	209	4	0	4	40.5860440749
221	212	0	0	0	43.5792713037
221	213	1	0	1	41.1125576834
221	216	67	2	65	6.05992063997
221	217	137	7	130	6.24654246931
221	218	29	14	15	8.2727012081
221	219	46	1	45	12.5893002426
221	220	908	275	633	6.51003098581
221	222	36	22	14	8.39613394228
221	223	7	1	6	22.4787906961
221	224	1	0	1	34.2290126101
221	225	1	0	1	32.4761011373
221	227	4	0	4	19.9927884608
221	229	18	6	12	29.0554120809
221	230	2	0	2	25.9171618538
221	232	2	0	2	32.8222071316
221	233	1	0	1	36.42869603
221	235	2	0	2	29.6828890048
221	236	3	0	3	31.6871489344
221	237	1	0	1	39.3220523385
221	238	3	0	3	22.3382641266
221	241	1	0	1	31.8425742161
221	242	19	0	19	24.5848624319
221	243	32	0	32	18.5029844841
221	244	11	0	11	28.8486529342
221	245	3	0	3	78.587234486
221	247	1	0	1	77.1238814465
221	262	2	1	1	63.6269472326
221	268	2	0	2	30.5565616649
221	272	2	0	2	41.4369251726
221	277	46	4	42	51.3169554271
221	278	1	0	1	31.2117886831
221	279	1	0	1	59.6661031269
221	287	1	0	1	46.929064662
221	293	1	0	1	56.4526930493
221	465	1	0	1	170.917918098
221	516	1	0	1	226.57279977
222	1	32	1	31	92.5476835038
222	3	1	0	1	94.2261339116
222	5	4	0	4	101.233891431
222	12	1	0	1	97.4583267969
222	13	1	0	1	98.5420790429
222	28	2	0	2	88.9192742995
222	31	1	0	1	109.546172442
222	33	1	0	1	103.863910903
222	34	1	0	1	119.593567517
222	35	1	0	1	107.545979025
222	36	2	0	2	101.175411156
222	43	1	0	1	141.975183708
222	46	2	0	2	123.678128568
222	70	3	0	3	99.3578905953
222	72	1	0	1	97.5363477276
222	73	58	1	57	102.257798146
222	74	4	0	4	105.436761567
222	75	5	0	5	104.583536846
222	76	1	0	1	102.08311665
222	78	4	0	4	104.903018574
222	79	3	0	3	98.4213969791
222	80	0	0	0	99.5097643779
222	81	4	0	4	99.5483662711
222	82	6	0	6	102.518043981
222	83	2	0	2	102.814434703
222	84	5	0	5	103.46997267
222	85	2	0	2	105.691334015
222	87	2	0	2	107.02440122
222	88	2	0	2	108.570130102
222	89	0	0	0	90.4880753281
222	90	3	0	3	104.432946527
222	92	1	0	1	94.4129110339
222	95	2	0	2	99.1799759749
222	96	1	0	1	102.194098267
222	99	1	0	1	111.431820197
222	102	1	0	1	90.1036819819
222	103	3	0	3	105.31780096
222	104	1	0	1	94.5400815481
222	105	1	0	1	90.4908011115
222	107	1	0	1	117.228810739
222	109	1	0	1	98.8232545135
222	112	6	0	6	103.507840501
222	113	4	1	3	109.428433497
222	119	1	0	1	109.046836579
222	131	1	0	1	143.976820095
222	134	1	0	1	118.242467455
222	142	3	0	3	123.238794256
222	146	1	0	1	114.162278535
222	147	1	0	1	141.50939391
222	154	1	0	1	131.598304941
222	163	1	0	1	139.949812778
222	181	4	0	4	23.4691436039
222	182	195	1	194	7.92092257042
222	183	578	458	120	11.9414778533
222	184	9	2	7	19.4993192012
222	185	26	2	24	8.53448682588
222	186	17	5	12	20.0833661727
222	187	8	1	7	22.1213127311
222	188	30	0	30	15.9100949721
222	189	13	5	8	5.86459735597
222	190	80	17	63	19.961958903
222	191	6	0	6	27.122091214
222	192	2	0	2	33.828185912
222	193	2	0	2	19.7830610962
222	194	0	0	0	26.2379996379
222	195	1	0	1	38.2420348058
222	196	5	0	5	46.751691986
222	199	1	0	1	49.9202991874
222	202	2	1	1	39.0389406017
222	204	1	0	1	55.4638612004
222	206	1	0	1	51.391829019
222	207	2	0	2	47.551580093
222	208	7	0	7	53.2493042
222	209	3	0	3	47.026986752
222	211	3	0	3	52.4160636379
222	212	3	1	2	48.7950005175
222	213	2	0	2	48.3744554256
222	214	3	0	3	57.2097171043
222	216	47	5	42	5.46598299039
222	217	8	0	8	14.0282615391
222	218	5	0	5	16.2514566191
222	219	22	0	22	18.6802665246
222	220	513	128	385	10.0918450137
222	221	15	7	8	8.39613394228
222	223	1	0	1	30.0719239747
222	225	5	0	5	39.155204417
222	227	1	0	1	26.6131966177
222	229	24	0	24	36.3256893379
222	230	1	0	1	34.0036489013
222	232	1	0	1	38.3588253368
222	233	2	0	2	41.749179735
222	234	1	0	1	32.477436992
222	236	2	0	2	35.7120812602
222	238	7	0	7	26.6764751126
222	239	1	0	1	32.6925193034
222	241	8	0	8	37.6881612216
222	242	7	1	6	30.4087006642
222	243	9	0	9	24.6903796151
222	244	12	2	10	35.6528369922
222	245	0	0	0	79.4245067661
222	246	1	0	1	81.8808293506
222	249	2	0	2	73.175656877
222	253	1	0	1	68.5646346716
222	254	1	0	1	73.4887604146
222	257	2	0	2	77.1926510104
222	260	1	0	1	80.4457819578
222	262	4	0	4	64.5219447156
222	266	2	0	2	36.5716999186
222	268	3	1	2	28.8624172127
222	271	3	0	3	34.2512223857
222	272	2	0	2	44.3146578308
222	273	1	0	1	52.9695742532
222	274	3	0	3	58.2680110078
222	276	1	0	1	57.739376025
222	277	74	0	74	51.5463339033
222	278	1	0	1	31.4617581846
222	279	1	0	1	59.0430819014
222	281	1	1	0	59.8454201824
222	282	5	0	5	57.831754276
222	284	1	0	1	51.6715439915
222	285	1	1	0	41.7968323764
222	292	1	0	1	51.555928947
222	294	1	0	1	68.8790148618
222	301	0	0	0	66.2152840181
222	303	2	0	2	82.646063836
222	304	1	0	1	87.4240879415
222	305	1	0	1	65.7340036801
222	307	6	3	3	74.661015729
222	308	1	0	1	68.5231286139
222	309	1	0	1	81.9313437583
222	319	2	0	2	134.817970874
222	357	1	0	1	123.450537055
222	415	1	0	1	181.269707445
222	442	0	0	0	211.391981461
222	466	1	0	1	173.934589935
222	471	2	0	2	154.37523503
222	475	1	0	1	158.790805137
222	488	1	0	1	168.883754814
223	0	1	0	1	92.2617169509
223	1	4	0	4	95.1010909907
223	7	1	0	1	96.1940467019
223	20	1	0	1	108.790233278
223	36	3	0	3	95.8346488591
223	49	1	0	1	117.679978601
223	59	1	0	1	147.102375652
223	73	17	2	15	91.5696497557
223	74	1	0	1	93.6628362058
223	75	1	0	1	93.9736325091
223	76	0	0	0	89.2730794353
223	78	0	0	0	92.7022882954
223	79	2	0	2	87.6790485436
223	81	1	0	1	87.945570423
223	82	1	0	1	90.3086662909
223	84	4	0	4	92.5043410596
223	88	1	0	1	97.0462310977
223	94	1	0	1	74.8040885558
223	112	2	0	2	94.9153865713
223	113	2	0	2	99.3110146099
223	115	1	0	1	73.1637713799
223	116	1	0	1	88.7797186689
223	118	2	0	2	92.0140700173
223	134	1	0	1	109.960515276
223	140	1	0	1	104.777137389
223	142	3	0	3	114.424283418
223	146	1	0	1	102.855749241
223	148	1	0	1	115.123673897
223	181	5	0	5	25.253741784
223	182	1	0	1	34.8115274579
223	183	72	14	58	29.3774892521
223	185	4	0	4	22.1710157282
223	186	16	9	7	17.7740472471
223	187	68	0	68	8.15996473462
223	188	29	0	29	15.6855745212
223	189	1	0	1	29.612950019
223	190	1	0	1	41.1642721433
223	191	24	5	19	17.2093347085
223	192	32	23	9	13.1962827657
223	193	6	1	5	13.8314244124
223	194	111	3	108	6.86647279473
223	195	3	0	3	21.7341090535
223	196	45	9	36	21.328283119
223	198	6	1	5	30.8960829158
223	199	1	0	1	20.0241453399
223	200	8	0	8	14.7484260822
223	201	2	0	2	29.6514511677
223	202	6	1	5	13.4815096794
223	203	1	0	1	25.3160207422
223	204	6	1	5	31.483996078
223	205	1	0	1	35.1268487855
223	206	2	0	2	25.7535584438
223	207	6	1	5	21.0756934014
223	208	51	0	51	24.6424486667
223	209	12	0	12	19.5597041676
223	210	3	0	3	15.5744975993
223	211	14	0	14	22.4833479362
223	212	3	2	1	25.4569016168
223	213	13	0	13	18.7231627729
223	214	1	0	1	30.3663003483
223	215	1	0	1	34.8906371578
223	217	5	0	5	20.4365454988
223	218	5	0	5	14.2348831479
223	219	1	0	1	24.7736315899
223	220	22	5	17	26.7725228732
223	221	2	0	2	22.4787906961
223	222	1	0	1	30.0719239747
223	224	17	4	13	14.6067816281
223	225	78	0	78	11.5008439156
223	226	6	0	6	13.8938944703
223	227	52	29	23	6.18040542794
223	228	17	1	16	12.0765596649
223	229	1012	300	712	6.86628307128
223	230	106	0	106	5.95583636154
223	231	1	0	1	23.0709893932
223	232	8	0	8	15.5023980905
223	233	3	0	3	19.0212433091
223	234	9	3	6	12.894714402
223	235	3	0	3	22.2263770933
223	236	22	8	14	19.7953351376
223	237	8	1	7	21.7113146701
223	238	8	2	6	14.6771007504
223	239	60	52	8	8.50164636518
223	240	1	0	1	28.3698390606
223	242	1	0	1	31.0006825576
223	243	1	0	1	26.5745363597
223	244	7	1	6	29.8981740546
223	245	0	0	0	69.2768665916
223	255	1	0	1	62.9843686219
223	263	1	0	1	60.994641584
223	267	1	0	1	45.1688208839
223	268	1	0	1	34.6421725099
223	275	1	0	1	46.9689561785
223	277	47	4	43	45.9737089138
223	281	2	0	2	49.9990394664
223	282	0	0	0	46.1399296223
223	284	2	1	1	37.1298064321
223	285	1	0	1	33.8524584562
223	291	1	0	1	27.9543910766
223	292	1	0	1	32.62127628
223	293	2	0	2	40.6874231873
223	302	1	0	1	46.678662853
223	303	1	0	1	85.5796446096
223	305	1	0	1	62.9896794378
223	345	4	0	4	30.5394646749
223	346	2	0	2	28.5257703128
223	375	1	0	1	47.4085401736
223	469	1	0	1	156.044409288
223	471	1	0	1	152.256827853
224	1	9	0	9	86.376424956
224	3	0	0	0	80.1573437748
224	7	1	0	1	86.0403403481
224	28	1	0	1	81.5633421645
224	32	1	0	1	71.4108929825
224	36	3	0	3	84.1615754031
224	59	1	0	1	136.698582861
224	65	1	0	1	125.692865792
224	70	1	0	1	73.1803471632
224	73	21	2	19	78.3877591993
224	74	3	0	3	80.1866496249
224	75	1	0	1	80.7799560307
224	78	1	0	1	79.1375539166
224	79	3	0	3	74.5390132413
224	81	2	0	2	74.5814027045
224	82	2	2	0	76.7689178273
224	83	3	0	3	78.162461395
224	84	3	0	3	79.239262817
224	87	1	0	1	82.5744728076
224	88	2	0	2	83.5919612993
224	92	1	0	1	68.7041027675
224	96	2	0	2	71.9558651567
224	112	2	0	2	82.256130064
224	113	5	0	5	86.1775307346
224	142	6	0	6	101.466266874
224	152	0	0	0	114.69938235
224	181	6	0	6	26.0437284754
224	182	1	0	1	42.9672116038
224	183	53	26	27	35.54173336
224	184	1	0	1	37.0801684433
224	186	7	0	7	22.1116942406
224	187	11	0	11	19.4712639508
224	188	5	0	5	24.4704847507
224	190	3	0	3	45.6516524679
224	191	6	0	6	31.7182158138
224	192	5	0	5	26.0914910374
224	194	2	0	2	21.4626959581
224	196	11	2	9	28.6502356665
224	198	2	0	2	40.4928221972
224	199	2	0	2	18.9400407299
224	200	1	1	0	19.0417810806
224	204	4	0	4	16.9112002508
224	205	1	0	1	20.9654212868
224	206	9	1	8	11.4838278423
224	207	66	1	65	7.20090849811
224	208	217	95	122	13.509445774
224	209	76	8	68	6.85185826221
224	210	46	7	39	4.42505443372
224	211	16	0	16	16.1688176828
224	212	63	12	51	10.8953391336
224	213	33	3	30	11.7333700775
224	214	23	0	23	16.9004085274
224	215	2	0	2	22.4214873583
224	220	7	1	6	39.6393320062
224	222	1	0	1	40.37886692
224	223	14	2	12	14.6067816281
224	225	593	0	593	3.86295821266
224	226	10	1	9	9.570605923
224	227	5	0	5	14.2878516402
224	228	3	0	3	13.5205106065
224	229	260	0	260	9.07232410037
224	230	4	3	1	17.3213089497
224	231	8	3	5	10.8241019243
224	232	130	35	95	4.07866225351
224	233	171	13	158	5.46228410269
224	234	39	10	29	8.84900653316
224	235	2	1	1	17.1334488613
224	236	124	1	123	11.9007328432
224	237	110	1	109	7.51785714024
224	238	11	0	11	15.3546712719
224	239	65	14	51	7.81892395751
224	241	1	0	1	50.1053507817
224	242	2	0	2	45.563195354
224	244	2	0	2	43.98581106
224	245	0	0	0	56.7036371629
224	249	1	0	1	44.6844018333
224	257	1	0	1	59.3027360477
224	264	1	0	1	56.6405985588
224	271	3	0	3	21.7007931316
224	272	5	4	1	19.4931786528
224	276	1	0	1	29.8014640955
224	277	37	0	37	36.7157178384
224	278	1	0	1	27.0215986102
224	281	1	0	1	38.4584217796
224	282	3	0	3	34.1529405904
224	284	1	0	1	24.7958921197
224	285	1	0	1	25.5205549039
224	291	3	0	3	14.965576929
224	292	4	0	4	18.9095887438
224	293	2	0	2	26.3906246875
224	294	1	0	1	30.9654067033
224	295	1	0	1	25.3959314917
224	302	1	0	1	32.8690601249
224	305	1	1	0	53.4696804832
224	307	2	1	1	65.1712424632
224	345	8	0	8	20.5981456982
224	346	1	0	1	29.9235246303
224	375	5	0	5	35.5003176493
224	433	1	0	1	203.4302746
224	469	1	0	1	143.547205649
224	471	1	0	1	140.916322148
224	488	1	0	1	155.679589479
225	0	1	0	1	85.6042940057
225	1	18	0	18	89.8808568514
225	3	1	0	1	83.9141015499
225	5	3	0	3	100.206740026
225	12	1	0	1	97.8619793346
225	28	3	0	3	85.0972230358
225	32	1	0	1	75.1381093421
225	36	1	0	1	87.9873155779
225	46	1	0	1	121.117109032
225	48	0	0	0	127.373382767
225	53	1	0	1	123.033651336
225	55	1	0	1	126.509345925
225	58	1	0	1	126.442548121
225	65	1	0	1	129.299021165
225	70	4	0	4	77.0062768727
225	71	1	0	1	87.409681681
225	73	60	0	60	82.2418618688
225	74	7	3	4	84.0215243171
225	75	5	3	2	84.6332291869
225	76	0	0	0	79.4246020752
225	77	1	0	1	77.614466257
225	78	2	0	2	82.9642441282
225	79	0	0	0	78.3952993831
225	82	6	0	6	80.5986604927
225	83	1	0	1	82.008101752
225	84	11	0	11	83.0891504822
225	85	1	0	1	82.4601746231
225	87	1	0	1	86.4191915464
225	88	1	0	1	87.4280641155
225	89	1	0	1	70.8318338531
225	90	1	0	1	79.319538737
225	92	3	1	2	72.5440812148
225	95	4	0	4	82.1216341581
225	96	1	0	1	75.6462230325
225	100	1	0	1	81.0175667654
225	102	0	0	0	75.667465259
225	103	3	1	2	86.8794891103
225	109	1	0	1	74.4738959589
225	111	1	0	1	67.2357509068
225	112	4	0	4	86.118835795
225	113	6	0	6	90.032790209
225	119	1	0	1	84.3902506358
225	142	17	0	17	105.326039007
225	144	1	0	1	104.581859621
225	154	1	0	1	110.667672476
225	171	1	0	1	87.4098138414
225	181	9	0	9	27.1248132444
225	182	1	0	1	42.415017306
225	183	173	0	173	35.4472661761
225	184	2	0	2	37.7901699199
225	185	2	0	2	30.7044429003
225	186	20	10	10	22.1102649522
225	187	37	0	37	17.4885959484
225	188	15	6	9	23.3883706937
225	190	2	0	2	46.1374597663
225	191	11	1	10	28.3245673033
225	192	3	1	2	22.336416506
225	193	1	0	1	25.1954584498
225	194	17	6	11	18.3412170546
225	195	2	0	2	30.4694772505
225	196	50	0	50	24.9290412998
225	198	8	4	4	36.6809591039
225	199	7	0	7	16.1869356286
225	200	11	0	11	15.4188486861
225	201	3	2	1	30.9407102969
225	202	7	3	4	19.376979775
225	204	8	0	8	20.1296262709
225	205	5	1	4	23.6273623469
225	206	26	8	18	14.2653833673
225	207	88	15	73	9.5749702323
225	208	531	132	399	14.0950628225
225	209	176	13	163	8.20712413446
225	210	132	60	72	4.33045749136
225	211	59	2	57	14.7565086978
225	212	75	2	73	14.4928032573
225	213	159	50	109	10.2395706912
225	214	35	0	35	18.9840226955
225	215	2	0	2	23.913075395
225	216	2	0	2	38.5351695844
225	217	2	0	2	31.4729373428
225	218	1	0	1	24.6234556531
225	219	2	0	2	36.2341028169
225	220	39	11	28	37.5257634289
225	223	87	48	39	11.5008439156
225	224	349	163	186	3.86295821266
225	226	68	22	46	6.76231875012
225	227	23	6	17	12.5672053206
225	228	18	12	6	9.9469201049
225	229	1197	697	500	5.33976022753
225	230	31	2	29	13.5760308376
225	231	15	2	13	14.5367733696
225	232	107	2	105	7.09788543941
225	233	120	0	120	9.28883562152
225	234	43	15	28	9.82006622371
225	235	1	0	1	19.367912885
225	236	154	31	123	14.5908152027
225	237	99	26	73	11.3542678429
225	238	15	0	15	15.8529714645
225	239	223	190	33	6.73223141852
225	241	3	0	3	46.523762381
225	242	2	0	2	42.1922427116
225	243	1	1	0	38.0137035094
225	244	4	0	4	40.3562492799
225	245	5	1	4	60.5632557631
225	246	1	0	1	59.9239722845
225	247	1	0	1	51.5141264458
225	253	1	0	1	42.5104043578
225	257	1	0	1	63.0949438205
225	262	1	0	1	47.2737615251
225	264	1	1	0	60.3547856943
225	266	3	0	3	39.3072380106
225	268	2	0	2	35.2403662469
225	271	10	0	10	24.2194538793
225	272	21	11	10	23.1031569721
225	273	3	0	3	33.2675382605
225	274	1	1	0	44.4371635731
225	275	0	0	0	42.9630453655
225	277	111	24	87	40.1871469191
225	278	2	0	2	29.1455763554
225	281	1	0	1	42.2401100039
225	282	4	0	4	37.966910492
225	284	6	3	3	28.6190835773
225	287	1	0	1	30.7967172738
225	291	13	0	13	18.8095065498
225	292	7	0	7	22.7606515548
225	293	10	4	6	30.1063541323
225	294	1	0	1	34.0763219845
225	297	2	0	2	27.6871553675
225	303	3	0	3	80.7522981797
225	305	1	0	1	57.0374725755
225	307	4	0	4	68.7078943485
225	338	1	0	1	75.0633405226
225	345	26	9	17	20.8013030547
225	346	1	0	1	27.0108903586
225	375	5	1	4	36.7883982889
225	466	1	0	1	160.51658648
225	469	1	0	1	147.409646085
225	471	2	0	2	144.730895667
225	475	2	0	2	140.75114888
225	478	1	0	1	166.136530756
225	480	1	0	1	146.370719924
225	488	2	0	2	159.497212035
225	497	0	0	0	149.107782846
225	502	1	0	1	168.037648723
225	503	1	0	1	159.490319564
226	0	1	0	1	91.0392900905
226	1	3	0	3	95.8340274112
226	7	1	0	1	95.2320095998
226	73	16	1	15	86.0675273501
226	74	2	0	2	87.5562169563
226	75	1	0	1	88.4369822733
226	78	0	0	0	86.4102888121
226	81	2	0	2	82.1016224877
226	82	3	0	3	84.0837372848
226	84	1	0	1	86.8349946942
226	92	1	0	1	76.1737570621
226	95	1	0	1	86.4574293437
226	96	1	0	1	78.1710398193
226	111	2	0	2	70.9674011405
226	131	1	0	1	135.338774141
226	142	3	0	3	109.254861618
226	147	1	0	1	126.079913564
226	181	1	0	1	33.6739229528
226	182	1	0	1	47.6582014159
226	183	34	0	34	41.1928472378
226	184	2	0	2	44.1005959356
226	185	1	0	1	35.4196104063
226	186	6	1	5	28.1073200157
226	187	11	2	9	21.5163504165
226	188	5	1	4	28.3552649461
226	190	1	0	1	52.2666599186
226	191	2	0	2	28.4282664804
226	192	6	0	6	20.8155756741
226	193	1	0	1	27.4204413429
226	194	5	1	4	19.8980339471
226	196	32	5	27	19.9442869294
226	198	3	0	3	32.1495865027
226	199	15	5	10	9.4606922981
226	200	9	0	9	10.2347316292
226	202	2	0	2	16.1818594165
226	204	1	0	1	21.8862014096
226	205	3	0	3	23.8144062721
226	206	8	0	8	15.5793271723
226	207	59	0	59	11.1359721781
226	208	329	217	112	11.376825719
226	209	66	0	66	8.68661032411
226	210	65	23	42	6.02480120526
226	211	120	99	21	8.83553845974
226	212	33	9	24	17.780140649
226	213	263	38	225	4.83019816777
226	214	23	0	23	18.3150366565
226	215	2	0	2	21.7401106899
226	216	1	1	0	42.3100093705
226	220	2	0	2	40.6418131116
226	221	1	0	1	36.3040663072
226	223	38	1	37	13.8938944703
226	224	28	21	7	9.570605923
226	225	271	220	51	6.76231875012
226	227	4	0	4	17.3454623999
226	228	83	72	11	5.02948537035
226	229	440	113	327	7.30937582103
226	230	16	1	15	12.901042852
226	231	1	0	1	20.1957587975
226	232	8	0	8	13.4987181478
226	233	6	1	5	14.7185207786
226	234	4	1	3	16.515253385
226	236	15	0	15	21.2241854278
226	237	17	5	12	15.9189111416
226	238	2	0	2	22.2701449362
226	239	31	14	17	12.7858945733
226	240	1	0	1	35.0159894875
226	241	0	0	0	45.4302945331
226	242	1	0	1	42.046914239
226	243	3	0	3	38.6789282919
226	244	2	0	2	39.1096485501
226	254	1	0	1	56.5894243466
226	257	2	0	2	68.1940373344
226	262	1	0	1	52.3493269159
226	268	1	0	1	41.9621516616
226	272	1	0	1	28.9251527586
226	276	2	0	2	38.1559456685
226	277	32	15	17	46.2232361714
226	280	1	0	1	41.9880571867
226	281	2	0	2	47.4496275217
226	282	0	0	0	43.0137385424
226	284	1	0	1	33.6680849461
226	287	1	0	1	36.5191926707
226	288	1	0	1	44.8325005924
226	291	2	0	2	23.8272387211
226	292	1	0	1	26.9798443297
226	293	5	0	5	33.1855943074
226	295	2	0	2	33.435414639
226	297	1	0	1	28.6493978265
226	301	1	0	1	35.589262377
226	302	1	0	1	40.3433560417
226	305	1	0	1	62.8805720637
226	307	1	0	1	74.6070362728
226	345	22	3	19	16.6837260038
226	346	3	0	3	20.3849689908
226	371	2	0	2	22.7095525352
226	375	1	0	1	33.7689304651
226	377	1	0	1	45.5275997951
226	472	1	0	1	143.237816333
226	480	1	0	1	150.886850846
226	488	1	0	1	164.348525275
226	491	1	0	1	159.455680138
227	1	6	0	6	89.5411726549
227	32	1	0	1	77.0320154185
227	36	0	0	0	91.226017877
227	41	0	0	0	97.2851745083
227	70	4	0	4	83.3822450174
227	73	27	0	27	87.8381903249
227	74	3	0	3	90.1574993009
227	75	1	0	1	90.2426190253
227	78	0	0	0	89.2774533469
227	81	1	0	1	84.3680147857
227	82	4	0	4	86.8700032236
227	84	7	0	7	88.8323054886
227	85	1	0	1	89.243263564
227	92	1	0	1	78.66219275
227	103	1	0	1	91.974494848
227	112	4	0	4	90.8234889409
227	113	1	0	1	95.5188834332
227	129	1	0	1	99.1547016025
227	140	1	0	1	100.844439821
227	142	2	0	2	110.470465097
227	181	13	2	11	19.0768358357
227	182	1	0	1	30.3127509867
227	183	170	21	149	24.0833765065
227	184	2	0	2	27.9823487132
227	185	8	1	7	18.216781025
227	186	32	9	23	11.7592900817
227	187	223	36	187	5.22532340143
227	188	47	0	47	11.0231918638
227	190	3	0	3	35.5894373177
227	191	16	0	16	20.535705686
227	192	7	2	5	18.6301939227
227	193	12	3	9	14.4548227186
227	194	61	0	61	10.1035038355
227	196	14	2	12	27.5078851568
227	198	10	0	10	36.8692413757
227	200	3	2	1	20.537958396
227	202	4	0	4	19.6357221508
227	206	1	0	1	25.735657943
227	207	4	0	4	21.452695986
227	208	48	3	45	26.6573270106
227	209	6	1	5	20.6029737793
227	210	3	1	2	16.8793146191
227	211	5	1	4	26.17844238
227	212	4	1	3	24.2511926928
227	213	13	5	8	21.9394172145
227	214	5	0	5	31.1407747024
227	217	3	0	3	19.7245456334
227	218	6	0	6	12.4759535037
227	219	2	0	2	25.454027586
227	220	41	13	28	25.3639326102
227	221	2	0	2	19.9927884608
227	222	2	0	2	26.6131966177
227	223	177	81	96	6.18040542794
227	224	11	0	11	14.2878516402
227	225	61	34	27	12.5672053206
227	226	3	0	3	17.3454623999
227	228	1	0	1	17.0053413371
227	229	489	200	289	10.1559670178
227	230	12	9	3	12.1345942685
227	231	5	0	5	20.0307335822
227	232	6	1	5	13.4721207317
227	233	3	0	3	17.1997822039
227	234	37	12	25	8.87101225444
227	235	7	4	3	16.791276622
227	236	65	10	55	15.4079040021
227	237	3	0	3	20.1025773494
227	238	32	1	31	8.70942228714
227	239	101	7	94	6.4932465582
227	241	4	1	3	39.3049969546
227	242	5	0	5	33.6791577932
227	243	2	0	2	28.5237781542
227	244	10	6	4	33.7367251585
227	245	0	0	0	65.2531089665
227	247	1	0	1	59.8978314316
227	268	1	0	1	28.4642138454
227	271	8	4	4	21.6482550235
227	272	3	0	3	26.246833038
227	276	2	0	2	39.3423493481
227	277	44	1	43	40.8361468018
227	281	2	0	2	45.6293770335
227	282	8	0	8	42.0403215716
227	284	1	0	1	33.4064771867
227	287	1	0	1	33.3685653565
227	291	1	0	1	24.977957872
227	294	1	0	1	44.7750855425
227	303	1	0	1	79.9410145955
227	305	2	0	2	57.7618012956
227	307	1	0	1	68.9221879629
227	375	1	0	1	49.3376965616
227	392	0	0	0	153.721507236
228	1	7	0	7	99.823034506
228	15	1	0	1	102.048346728
228	36	1	0	1	97.4743989208
228	49	1	0	1	120.791783335
228	50	1	0	1	126.325260489
228	55	1	0	1	136.326964542
228	58	1	0	1	136.378427315
228	70	2	0	2	85.4373697536
228	73	17	0	17	90.9913764174
228	74	2	0	2	92.5246380204
228	75	1	0	1	93.3653468986
228	78	1	0	1	91.3893112508
228	84	2	0	2	91.7725198065
228	89	1	0	1	79.7807805344
228	96	1	0	1	83.2005250947
228	112	0	0	0	95.1876148355
228	113	1	0	1	98.7911737509
228	127	0	0	0	107.498509595
228	142	8	2	6	114.165797955
228	164	1	0	1	98.7257830327
228	181	1	0	1	35.0098416438
228	183	34	1	33	41.0593591646
228	186	3	1	2	28.5612052712
228	187	11	0	11	20.2148066354
228	188	6	2	4	27.6053874345
228	190	2	0	2	52.5826799085
228	191	6	0	6	24.3065805169
228	192	10	1	9	16.187968667
228	194	10	1	9	16.8931093802
228	196	118	10	108	15.2074726424
228	198	16	0	16	27.2846919198
228	199	48	0	48	8.02473165072
228	200	109	18	91	5.52568905519
228	201	1	0	1	21.0433063471
228	202	17	6	11	11.1944263975
228	204	2	0	2	26.9155805907
228	206	8	3	5	20.6086922566
228	207	30	5	25	16.1397079495
228	208	177	0	177	15.833000801
228	209	29	0	29	13.7116128974
228	210	22	0	22	10.7577243756
228	211	167	2	165	11.1695352174
228	212	16	0	16	22.6770735488
228	213	107	82	25	8.64685834343
228	214	13	4	9	23.1189613461
228	217	0	0	0	31.5173546513
228	218	1	0	1	26.0627128961
228	219	2	0	2	34.4939080187
228	220	10	3	7	38.0575025731
228	222	1	0	1	42.1056957304
228	223	61	12	49	12.0765596649
228	224	21	0	21	13.5205106065
228	225	113	7	106	9.9469201049
228	226	115	94	21	5.02948537035
228	227	4	0	4	17.0053413371
228	229	758	319	439	7.30641116935
228	230	79	1	78	9.13317555223
228	232	4	1	3	17.0438653085
228	233	1	0	1	18.9381045303
228	234	4	1	3	18.6927665315
228	235	2	0	2	28.7586183758
228	236	12	1	11	24.3636583792
228	237	10	0	10	20.4956835859
228	238	2	0	2	23.571510007
228	239	35	5	30	14.1906934352
228	242	2	0	2	37.662193001
228	243	1	0	1	34.6729259334
228	244	1	0	1	34.375335165
228	245	1	0	1	69.7727359117
228	253	1	0	1	51.0163273287
228	255	1	0	1	65.3986722891
228	257	1	0	1	72.7255244494
228	266	1	0	1	48.5617988598
228	268	1	0	1	43.8168333818
228	270	1	0	1	62.094382117
228	271	2	0	2	33.7585389158
228	272	5	1	4	32.9959804791
228	276	2	0	2	42.8803192791
228	277	29	0	29	50.1315567111
228	281	1	0	1	51.9121405419
228	282	2	1	1	47.545027566
228	287	1	0	1	40.6713273543
228	291	2	1	1	28.3148047349
228	292	1	0	1	31.746644414
228	293	3	0	3	38.1705188869
228	294	1	0	1	39.9102983351
228	295	1	0	1	38.2335578367
228	302	1	0	1	45.2648902167
228	303	2	0	2	90.6984766348
228	316	1	0	1	47.9992280488
228	345	12	4	8	20.115327679
228	346	10	5	5	17.7749374337
228	371	1	0	1	26.0568739278
228	373	1	0	1	51.9136745196
228	375	1	0	1	37.453775345
228	424	1	0	1	225.44253642
228	469	0	0	0	156.460503384
228	471	3	0	3	154.257860415
228	503	1	0	1	168.023087258
229	1	39	0	39	93.7998926812
229	3	1	0	1	88.4534384222
229	5	2	0	2	104.044388405
229	7	1	0	1	94.0760235547
229	12	1	0	1	101.544669152
229	15	1	0	1	96.4978073358
229	18	1	0	1	91.7669560271
229	20	1	0	1	107.199703891
229	21	1	0	1	102.688548879
229	23	1	0	1	101.991448878
229	26	2	0	2	112.251689063
229	28	4	0	4	89.0854715762
229	31	1	0	1	101.076030784
229	32	2	0	2	79.6006392029
229	35	1	0	1	102.761786731
229	36	11	2	9	92.7625028293
229	37	1	0	1	109.611371203
229	39	1	0	1	83.2811910671
229	42	5	0	5	87.4251205953
229	48	3	0	3	131.926155255
229	49	1	0	1	115.447691297
229	55	2	0	2	130.856991955
229	65	1	0	1	133.417965758
229	69	1	0	1	132.01254092
229	70	8	0	8	82.239894225
229	71	2	0	2	92.6498302005
229	72	1	0	1	81.7880145111
229	73	127	0	127	87.3924222264
229	74	9	0	9	89.2361071438
229	75	12	0	12	89.7876569014
229	76	7	0	7	84.6745028024
229	78	19	0	19	88.196187637
229	79	3	0	3	83.5342373219
229	81	9	0	9	83.6145285022
229	82	19	0	19	85.824651465
229	83	3	0	3	87.1930153316
229	84	13	2	11	88.258569455
229	85	2	0	2	87.7339170647
229	87	8	0	8	91.6067775261
229	88	3	0	3	92.6395463595
229	89	3	0	3	75.9227357089
229	90	2	0	2	84.6351356916
229	92	1	0	1	77.7466025795
229	95	3	0	3	87.1169499368
229	96	4	0	4	80.9799648317
229	97	0	0	0	67.763688523
229	103	6	0	6	91.9676305878
229	104	1	0	1	82.8742880633
229	107	1	0	1	99.9611923069
229	110	2	0	2	95.7460254943
229	111	2	1	1	72.4205727763
229	112	5	0	5	91.1485263024
229	113	14	0	14	95.1763553377
229	116	3	0	3	84.0387911381
229	119	1	0	1	89.7020076558
229	127	1	0	1	103.9732071
229	142	45	3	42	110.436043084
229	144	1	0	1	109.781980921
229	164	1	0	1	96.1378087343
229	171	1	0	1	92.7378000398
229	181	18	4	14	27.7040859967
229	182	10	0	10	40.4300499115
229	183	425	141	284	34.1903916966
229	184	5	1	4	37.6009306543
229	185	20	4	16	28.1201725838
229	186	55	26	29	21.3995397012
229	187	126	55	71	14.2103860032
229	188	55	0	55	21.1094853998
229	189	1	0	1	35.2652893472
229	190	16	0	16	45.5189223704
229	191	43	6	37	23.1006738611
229	192	50	24	26	17.0220611996
229	193	9	2	7	20.678826375
229	194	101	54	47	13.4455252639
229	195	1	0	1	25.240435702
229	196	199	5	194	20.8657479241
229	198	31	2	29	32.1346914764
229	199	27	0	27	15.0934069741
229	200	79	0	79	12.0138455684
229	201	7	1	6	27.8510185707
229	202	54	0	54	14.5050549924
229	203	3	0	3	27.6019041923
229	204	9	0	9	25.3940732646
229	205	9	3	6	28.6074443337
229	206	15	0	15	19.3992437547
229	207	77	0	77	14.6470026962
229	208	628	0	628	17.7762537928
229	209	98	0	98	12.8943730816
229	210	48	24	24	8.92589760279
229	211	137	6	131	16.1212793524
229	212	76	3	73	19.8317293632
229	213	164	7	157	12.0716386027
229	214	33	0	33	23.6528024281
229	216	1	0	1	35.0820185638
229	217	13	0	13	27.2946877432
229	218	10	0	10	20.9014240074
229	219	5	0	5	31.5345258996
229	220	105	32	73	33.5906609995
229	221	3	0	3	29.0554120809
229	222	7	0	7	36.3256893379
229	223	720	207	513	6.86628307128
229	224	115	6	109	9.07232410037
229	225	977	287	690	5.33976022753
229	226	102	43	59	7.30937582103
229	227	115	0	115	10.1559670178
229	228	169	1	168	7.30641116935
229	230	233	187	46	8.25281106865
229	231	4	0	4	19.2228654643
229	232	76	0	76	11.4270907483
229	233	36	0	36	14.2920248131
229	234	105	35	70	11.6780065919
229	235	7	1	6	21.8252000108
229	236	184	3	181	17.8890666221
229	237	59	1	58	16.584153565
229	238	39	0	39	16.2664028972
229	239	454	264	190	6.97126275009
229	241	4	0	4	41.1940567193
229	242	29	16	13	36.9630333901
229	243	7	0	7	32.9551047587
229	244	16	1	15	35.0182431574
229	245	13	1	12	65.5487576483
229	246	1	0	1	65.0807056085
229	253	2	0	2	47.7589751639
229	254	3	0	3	57.4007168453
229	257	2	0	2	67.7626696451
229	259	1	0	1	53.8455460653
229	262	4	1	3	51.9982606752
229	264	2	0	2	64.8007708478
229	265	1	0	1	51.8885527681
229	266	2	0	2	41.4540306032
229	268	6	0	6	36.5390795829
229	271	17	2	15	26.8908505258
229	272	25	4	21	27.4769055884
229	274	3	0	3	48.7958087671
229	276	3	0	3	38.7044009634
229	277	207	4	203	44.1633488816
229	279	1	0	1	53.889578088
229	281	2	0	2	46.9066920321
229	282	5	0	5	42.7462732774
229	284	5	0	5	33.4566175248
229	285	1	0	1	32.3491188636
229	287	1	0	1	35.1664753821
229	291	10	3	7	23.7674874872
229	292	8	0	8	27.9432644227
229	293	17	0	17	35.4306128394
229	294	7	0	7	39.2622571103
229	296	0	0	0	46.476729307
229	297	1	0	1	32.8646727085
229	298	1	0	1	29.3478615884
229	303	4	1	3	84.5146410402
229	305	4	0	4	61.147432829
229	307	0	0	0	72.7264466876
229	310	1	0	1	55.8196174839
229	317	1	0	1	43.3465085068
229	323	1	0	1	110.96114162
229	338	2	1	1	79.9482149864
229	345	36	0	36	23.7742780295
229	346	6	3	3	25.0656692262
229	355	1	0	1	99.4279676525
229	369	1	0	1	48.3628285994
229	372	1	0	1	32.0958168563
229	373	1	0	1	54.508988646
229	375	7	2	5	40.550312813
229	377	1	0	1	51.3833059755
229	409	1	0	1	177.801831184
229	441	0	0	0	194.852278027
229	469	0	0	0	152.422880168
229	471	1	0	1	149.444178995
229	475	2	0	2	145.919745048
229	488	3	0	3	164.220435546
229	491	3	0	3	159.723248
229	499	1	0	1	164.408932845
229	501	1	0	1	176.100451114
229	535	1	0	1	202.912298861
229	573	0	0	0	133.480207769
230	1	8	1	7	100.603440237
230	30	1	0	1	115.791429807
230	59	1	0	1	152.272263561
230	70	1	0	1	90.4608789127
230	73	15	0	15	95.551509821
230	74	1	0	1	97.4437531414
230	75	2	0	2	97.9494277635
230	78	2	0	2	96.4155883636
230	81	1	0	1	91.8040405771
230	84	3	2	1	96.4326422128
230	86	1	0	1	100.194610463
230	87	2	0	2	99.7944251387
230	90	1	0	1	92.887648792
230	95	1	0	1	95.1367418701
230	96	1	0	1	89.2213948129
230	102	1	0	1	88.2823835492
230	110	1	0	1	103.812697186
230	112	1	0	1	99.1993249173
230	113	2	0	2	103.328140098
230	142	8	0	8	118.55591808
230	153	1	0	1	135.73260425
230	181	4	0	4	31.2002546721
230	182	1	0	1	39.4659269843
230	183	56	5	51	34.6773126137
230	185	4	0	4	26.6760397027
230	186	7	1	6	23.6212416123
230	187	29	0	29	13.2147170084
230	188	22	1	21	20.8539552268
230	190	2	1	1	46.6089469961
230	191	34	7	27	15.535017756
230	192	67	52	15	8.77018536797
230	193	3	1	2	15.5304848119
230	194	50	42	8	7.99123351626
230	196	102	0	102	15.3833021635
230	198	13	0	13	25.1709098136
230	199	7	0	7	16.1881525623
230	200	30	2	28	9.76741005456
230	202	40	7	33	7.55824509431
230	204	1	0	1	33.4518242159
230	206	1	0	1	27.3208241856
230	207	9	0	9	22.5665002286
230	208	52	0	52	24.2777225695
230	209	7	2	5	20.5466394262
230	210	5	1	4	16.7377767072
230	211	10	1	9	20.3020666974
230	212	2	0	2	28.0630370562
230	213	16	2	14	17.4239312436
230	214	5	0	5	30.9904777554
230	218	4	2	2	17.7554100829
230	219	4	0	4	25.3644418245
230	220	11	1	10	29.1524896692
230	222	1	0	1	34.0036489013
230	223	195	82	113	5.95583636154
230	224	14	0	14	17.3213089497
230	225	102	58	44	13.5760308376
230	226	6	0	6	12.901042852
230	227	25	6	19	12.1345942685
230	228	28	15	13	9.13317555223
230	229	822	45	777	8.25281106865
230	232	8	0	8	19.3517816472
230	233	5	0	5	22.456764154
230	234	5	1	4	18.0553319258
230	235	1	0	1	27.8230370068
230	236	9	2	7	24.8528939116
230	237	8	1	7	24.8247375947
230	238	1	0	1	20.5730238817
230	239	36	7	29	13.2695552262
230	241	0	0	0	33.0832453551
230	242	3	1	2	29.2413591414
230	243	5	2	3	25.7842618433
230	244	6	0	6	26.8543659795
230	245	1	1	0	73.5726086374
230	268	1	0	1	40.5978676776
230	271	1	0	1	32.8884158326
230	272	3	1	2	35.0872637361
230	273	1	0	1	45.6840859929
230	274	1	0	1	56.2369545045
230	275	0	0	0	52.5994489944
230	277	25	0	25	51.2332167736
230	281	1	0	1	54.6614345368
230	282	0	0	0	50.6187079738
230	285	1	0	1	39.1850503893
230	286	1	0	1	54.564382865
230	287	2	0	2	42.700158584
230	291	3	0	3	31.8511288385
230	293	4	0	4	43.6802531315
230	345	6	0	6	29.1606728626
230	346	4	1	3	23.3306767181
230	375	1	0	1	46.4550720658
230	469	0	0	0	160.442836908
230	475	0	0	0	154.086889818
231	1	5	0	5	75.6383653241
231	28	1	0	1	70.8011709949
231	36	1	0	1	73.5456395662
231	39	3	1	2	64.1466781345
231	70	1	0	1	63.7058406829
231	72	2	0	2	63.0036371051
231	73	20	1	19	68.5233881051
231	74	3	0	3	70.5922052036
231	75	2	0	2	70.9262006342
231	78	2	0	2	69.6374363067
231	79	1	0	1	64.6390370171
231	81	1	0	1	64.8764517869
231	82	3	1	2	67.2419470678
231	84	2	0	2	69.445402361
231	87	3	0	3	72.8500752617
231	89	1	0	1	56.9267038905
231	92	2	0	2	59.0787008443
231	107	1	0	1	81.6132556616
231	111	1	0	1	53.6973840119
231	113	1	0	1	76.2776492001
231	142	1	0	1	91.4451015674
231	181	8	0	8	22.4993732102
231	183	15	0	15	34.5324765002
231	184	1	0	1	33.70706131
231	186	1	0	1	22.2120589493
231	187	4	0	4	24.9248846439
231	188	3	1	2	27.1026608212
231	190	1	0	1	42.514959879
231	191	1	0	1	40.0587135621
231	194	2	1	1	29.4362933678
231	196	3	0	3	39.4536924225
231	198	1	0	1	51.1927434868
231	199	1	0	1	29.2751003658
231	200	1	0	1	29.8656497706
231	202	1	0	1	33.7115307135
231	204	13	0	13	14.0284938365
231	205	1	0	1	19.8148767509
231	206	14	3	11	12.6356511019
231	207	30	27	3	12.1439805228
231	208	72	1	71	19.745620155
231	209	22	0	22	14.0258899289
231	210	3	1	2	14.3439661683
231	211	6	0	6	25.1599833935
231	212	307	66	241	8.04090299911
231	213	8	0	8	21.2283927683
231	214	10	4	6	18.6518753372
231	215	1	0	1	24.9691482537
231	216	1	0	1	43.4940296455
231	220	4	1	3	44.0196983533
231	222	0	0	0	42.2465776618
231	223	3	0	3	23.0709893932
231	224	15	3	12	10.8241019243
231	225	21	0	21	14.5367733696
231	226	1	0	1	20.1957587975
231	227	1	0	1	20.0307335822
231	229	44	0	44	19.2228654643
231	230	1	0	1	27.1667323268
231	232	40	3	37	7.82173060149
231	233	58	2	56	5.47800267075
231	234	12	2	10	11.2141088819
231	235	5	3	2	11.4588990098
231	236	242	130	112	6.64057178352
231	237	297	150	147	5.344618437
231	238	10	2	8	15.6510190205
231	239	3	0	3	14.6044983477
231	242	1	0	1	53.5717064732
231	245	1	1	0	46.4069742386
231	247	1	0	1	39.9028501428
231	248	1	0	1	41.8355027607
231	251	1	0	1	44.2900249369
231	253	1	0	1	29.5519528382
231	254	1	0	1	38.3888925129
231	257	1	0	1	48.5863939009
231	262	4	0	4	32.7906009403
231	264	2	0	2	45.8260928317
231	266	1	0	1	28.9367267772
231	268	2	0	2	27.4087573196
231	271	10	0	10	14.1614887015
231	272	133	43	90	8.73218326867
231	273	1	0	1	18.7411017141
231	274	2	0	2	29.9499821751
231	276	5	3	2	19.7368045111
231	277	107	0	107	26.0660339346
231	278	1	0	1	20.2040793059
231	280	2	0	2	22.4758557556
231	281	6	0	6	27.7252743362
231	282	4	1	3	23.5238216979
231	284	16	3	13	14.2497543964
231	285	2	2	0	15.5397599163
231	287	5	0	5	16.3444576535
231	290	1	0	1	21.8836830384
231	291	121	28	93	4.95516447236
231	292	36	0	36	9.97872406315
231	293	22	4	18	18.6887139541
231	294	2	0	2	26.6776109991
231	295	2	0	2	15.9170286476
231	296	0	0	0	30.1109638317
231	297	2	0	2	21.1581748549
231	298	6	0	6	14.4315071697
231	302	1	0	1	23.8047955474
231	303	1	0	1	66.681360229
231	305	2	1	1	42.6906545994
231	307	1	0	1	54.4122153445
231	345	4	0	4	26.4805805212
231	346	1	0	1	40.2692874424
231	372	1	0	1	30.0273744323
231	548	1	0	1	217.56572554
232	0	1	0	1	78.6644018552
232	1	4	0	4	82.7941421911
232	20	1	0	1	96.0468927507
232	35	0	0	0	91.3640516467
232	36	1	0	1	81.3382068277
232	50	1	0	1	109.727561399
232	52	1	0	1	111.666281692
232	70	1	0	1	71.3222628575
232	71	1	0	1	81.7425608447
232	73	18	0	18	76.2614061305
232	74	4	2	2	78.2524092673
232	76	0	0	0	73.8112535139
232	78	0	0	0	77.2661625007
232	82	2	0	2	74.8783455499
232	83	1	0	1	76.1347227947
232	84	9	0	9	77.16481406
232	85	1	0	1	76.9671806531
232	89	1	0	1	64.703000636
232	110	1	0	1	84.4624389995
232	113	3	0	3	84.0270480133
232	120	1	0	1	71.2552653316
232	142	2	0	2	99.2246720477
232	152	1	0	1	112.294600707
232	181	6	0	6	22.3951250327
232	183	32	0	32	32.583575889
232	184	1	0	1	33.5714551194
232	186	8	6	2	19.259034473
232	187	7	0	7	18.6600558201
232	188	5	0	5	22.5325932738
232	190	6	1	5	42.2420484706
232	191	2	1	1	32.6644086241
232	192	0	0	0	28.0078572936
232	194	2	0	2	22.1067762118
232	196	7	3	4	31.9303235757
232	198	1	0	1	43.4984230401
232	199	2	0	2	22.9319881338
232	200	1	0	1	22.4998318146
232	204	2	0	2	17.4211533893
232	205	2	0	2	22.272029802
232	206	6	3	3	13.0591410925
232	207	34	13	21	9.74210249808
232	208	129	6	123	16.9331816024
232	209	38	15	23	10.2327216831
232	210	8	2	6	8.47610710527
232	211	5	2	3	20.2099518164
232	212	75	7	68	10.8193735598
232	213	13	0	13	15.8009902768
232	214	18	2	16	19.046917022
232	216	1	0	1	38.7402627298
232	217	1	0	1	33.1678887515
232	218	0	0	0	25.8418139079
232	220	7	1	6	38.5896450205
232	223	17	2	15	15.5023980905
232	224	179	69	110	4.07866225351
232	225	131	30	101	7.09788543941
232	226	1	0	1	13.4987181478
232	227	6	2	4	13.4721207317
232	228	2	0	2	17.0438653085
232	229	148	36	112	11.4270907483
232	230	5	1	4	19.3517816472
232	231	49	14	35	7.82173060149
232	233	147	21	126	3.7291125327
232	234	105	31	74	5.92363342572
232	235	14	1	13	13.0886345057
232	236	489	15	474	7.82324292431
232	237	141	14	127	6.63143962163
232	238	29	7	22	12.3106539677
232	239	106	30	76	7.28813458833
232	242	3	0	3	46.3525268564
232	245	2	1	1	54.2214814558
232	262	1	0	1	40.5721179333
232	264	1	0	1	53.4324361105
232	266	2	0	2	32.8792403259
232	268	0	0	0	29.548675408
232	271	10	4	6	17.6221795793
232	272	28	3	25	16.1140203462
232	273	1	0	1	26.4870229708
232	274	2	1	1	37.4618805191
232	276	1	0	1	27.4811387494
232	277	57	0	57	33.0985384623
232	281	1	0	1	35.4800275084
232	282	3	0	3	31.330495205
232	284	3	0	3	22.0714848449
232	285	2	0	2	21.6578012665
232	287	4	0	4	23.8164215323
232	291	15	0	15	12.5401745709
232	292	7	0	7	17.118895147
232	293	6	0	6	25.3088003999
232	294	1	0	1	31.3561037873
232	298	1	0	1	19.9187452981
232	303	2	0	2	73.6546850124
232	306	1	0	1	65.3559449252
232	310	0	0	0	48.2766953032
232	338	0	0	0	73.1388476396
232	345	5	2	3	24.0763677275
232	356	0	0	0	105.267289301
232	375	1	0	1	38.0816228361
232	503	1	0	1	153.5899036
233	1	4	0	4	81.1160711757
233	49	1	0	1	101.854396374
233	55	1	0	1	117.391241173
233	70	3	0	3	68.0200634001
233	73	10	0	10	73.1060738212
233	75	1	0	1	75.5024067871
233	78	0	0	0	73.972309118
233	79	0	0	0	69.2450953493
233	81	3	0	3	69.3473253274
233	82	1	0	1	71.5934705608
233	84	1	0	1	73.9795247756
233	87	1	0	1	77.3378948342
233	90	1	0	1	70.6599164152
233	92	3	0	3	63.4918321349
233	95	1	0	1	72.8616447013
233	107	1	0	1	85.8068243387
233	111	1	0	1	58.1526919882
233	113	1	0	1	80.8877998829
233	142	2	0	2	96.1440791483
233	152	0	0	0	109.324257022
233	181	6	1	5	24.4799376097
233	182	1	0	1	43.3597788439
233	183	19	0	19	35.4126315167
233	184	2	0	2	35.7759793184
233	185	1	0	1	33.2651024918
233	186	1	0	1	22.2859395833
233	187	5	0	5	22.3813631762
233	188	1	0	1	26.0155821527
233	191	1	0	1	36.2247773698
233	192	1	0	1	31.198221266
233	194	2	0	2	25.716878027
233	196	3	1	2	34.1001057355
233	200	1	0	1	24.4637612825
233	202	2	0	2	28.6428704603
233	204	12	0	12	13.805362364
233	205	5	1	4	18.878071366
233	206	31	0	31	10.0025101936
233	207	47	9	38	7.71981171285
233	208	124	8	116	15.3932591611
233	209	35	0	35	9.0796344089
233	210	6	3	3	8.88763004956
233	211	10	0	10	20.015987789
233	212	186	9	177	7.1517332855
233	213	11	0	11	15.918100659
233	214	16	3	13	16.1704629114
233	215	1	0	1	22.3313868681
233	219	1	0	1	42.6013990889
233	220	3	1	2	42.259837342
233	223	1	0	1	19.0212433091
233	224	78	4	74	5.46228410269
233	225	59	22	37	9.28883562152
233	226	0	0	0	14.7185207786
233	227	3	0	3	17.1997822039
233	229	77	12	65	14.2920248131
233	231	52	0	52	5.47800267075
233	232	90	13	77	3.7291125327
233	234	19	2	17	9.29755407233
233	235	4	0	4	14.205985227
233	236	158	71	87	8.64503669978
233	237	386	45	341	2.91406817315
233	238	9	0	9	15.3227981399
233	239	13	1	12	10.9821978828
233	242	0	0	0	49.9643393664
233	243	1	0	1	45.2587482535
233	244	1	0	1	48.817452911
233	245	0	0	0	51.2975252252
233	257	1	0	1	53.8414638041
233	262	2	0	2	38.0084187374
233	268	2	0	2	30.790248731
233	270	1	0	1	44.4627462694
233	271	2	0	2	18.0771075435
233	272	28	4	24	14.2097557674
233	273	1	0	1	24.0522725398
233	277	54	7	47	31.5335539483
233	281	1	0	1	33.0002723196
233	282	2	0	2	28.6910704553
233	284	2	0	2	19.3358130438
233	285	1	0	1	20.7417638288
233	287	2	0	2	21.808503957
233	291	15	5	10	9.52320458266
233	292	15	3	12	13.7139709166
233	293	3	0	3	21.6798556511
233	294	2	0	2	27.6670483763
233	297	1	0	1	21.5626756712
233	298	2	0	2	16.1945429415
233	345	3	0	3	22.4345977071
233	346	1	0	1	34.8297871504
233	375	2	0	2	35.3223827985
234	0	1	0	1	79.4156153225
234	1	4	0	4	82.5778877559
234	24	1	0	1	90.4789072065
234	26	0	0	0	101.461827303
234	50	1	0	1	110.63992526
234	70	2	1	1	74.5442478068
234	73	22	1	21	79.0828150176
234	74	3	0	3	81.3437433936
234	76	1	0	1	77.1055693177
234	78	1	0	1	80.4477608606
234	81	1	1	0	75.5689891434
234	82	3	2	1	78.0422273632
234	84	1	0	1	80.0595194618
234	87	2	0	2	83.5080525813
234	88	1	0	1	84.7049813182
234	89	1	0	1	67.361767216
234	92	1	0	1	69.8413805808
234	102	1	0	1	70.755709511
234	110	1	0	1	86.8719443526
234	112	1	0	1	82.2136860182
234	113	1	0	1	86.7856538093
234	120	1	0	1	73.8359986778
234	142	4	0	4	101.802579815
234	181	7	1	6	17.3784229639
234	182	2	0	2	34.4231515096
234	183	61	0	61	26.7856217654
234	185	1	0	1	23.9783190506
234	186	24	0	24	13.3957581234
234	187	10	0	10	13.713550278
234	188	7	2	5	16.7182889204
234	190	8	1	7	36.8102818728
234	191	0	0	0	29.2373876365
234	194	4	0	4	18.6443405188
234	196	7	0	7	32.3876120169
234	198	3	0	3	43.1465525044
234	199	1	0	1	25.7974373003
234	200	1	0	1	23.6842339717
234	201	1	0	1	39.5223768535
234	202	1	0	1	25.3848294268
234	203	1	0	1	37.9728461795
234	204	1	0	1	23.0906187329
234	206	4	0	4	18.9800371136
234	207	9	0	9	15.5343621235
234	208	50	1	49	22.3492010937
234	209	18	13	5	15.6570097756
234	210	2	0	2	13.0003766309
234	211	2	0	2	24.4636724703
234	212	20	1	19	16.4198473424
234	213	10	1	9	19.9356946813
234	214	5	1	4	24.9608079925
234	216	1	0	1	33.0358534764
234	220	8	1	7	33.1434606449
234	223	22	0	22	12.894714402
234	224	29	10	19	8.84900653316
234	225	65	8	57	9.82006622371
234	226	4	0	4	16.515253385
234	227	11	0	11	8.87101225444
234	229	150	40	110	11.6780065919
234	230	4	0	4	18.0553319258
234	231	14	1	13	11.2141088819
234	232	76	69	7	5.92363342572
234	233	18	4	14	9.29755407233
234	235	15	0	15	10.1482711779
234	236	378	0	378	6.90077601812
234	237	31	7	24	12.1555736589
234	238	57	5	52	6.52372583201
234	239	113	58	55	4.87276831961
234	242	3	0	3	42.5350654319
234	243	1	0	1	37.3889759215
234	245	0	0	0	56.599597385
234	262	1	0	1	42.3322519616
234	266	2	0	2	29.8697314505
234	268	1	0	1	25.4478071923
234	270	1	0	1	43.8598237621
234	271	24	0	24	15.2229032482
234	272	18	0	18	17.6041957421
234	277	40	4	36	33.1881072732
234	282	1	0	1	33.4024332771
234	284	1	0	1	24.6050439759
234	287	1	0	1	24.9791888269
234	291	4	0	4	16.140832386
234	292	2	0	2	21.1896034213
234	293	0	0	0	29.8338250299
234	303	1	0	1	73.1728318743
234	345	5	0	5	29.4470413228
234	346	3	0	3	36.3725470561
234	475	0	0	0	137.525807359
235	1	7	3	4	72.8768865899
235	3	1	0	1	69.3566080058
235	36	1	0	1	74.7440757417
235	70	1	0	1	68.6020438669
235	73	18	0	18	72.4573853245
235	74	1	0	1	75.121364163
235	75	1	0	1	74.8488044267
235	78	1	0	1	74.3809989701
235	79	1	0	1	68.5497243318
235	81	1	0	1	69.2542076717
235	82	4	0	4	71.9681176234
235	84	3	0	3	73.5376568135
235	85	1	0	1	74.7208175096
235	86	1	0	1	78.6099539955
235	104	1	0	1	66.1479893076
235	112	1	0	1	74.9149393542
235	116	1	0	1	71.1841763442
235	120	1	0	1	66.9032938188
235	142	1	0	1	94.6803387655
235	154	1	0	1	101.781197575
235	181	45	7	38	11.0972446842
235	182	0	0	0	32.0716020665
235	183	103	8	95	23.5798708957
235	184	3	0	3	22.2502022116
235	185	3	1	2	24.8706955572
235	186	16	0	16	12.7977380785
235	187	3	1	2	20.065056834
235	188	9	1	8	19.062934858
235	190	3	1	2	31.0566564301
235	191	0	0	0	36.9341463633
235	194	2	0	2	26.8224719391
235	195	1	0	1	43.7604725386
235	196	2	0	2	42.4881485235
235	202	1	0	1	35.2949750979
235	207	4	1	3	21.9191636223
235	208	12	1	11	29.5506980899
235	210	1	0	1	21.5543241243
235	211	1	0	1	33.2958460596
235	212	10	0	10	19.4161661972
235	213	3	0	3	28.8642509337
235	214	2	0	2	29.8375894454
235	219	1	1	0	39.355917644
235	220	7	1	6	36.1567164554
235	222	3	1	2	32.5447081605
235	224	6	1	5	17.1334488613
235	225	12	0	12	19.367912885
235	227	2	0	2	16.791276622
235	229	25	4	21	21.8252000108
235	230	1	0	1	27.8230370068
235	231	9	3	6	11.4588990098
235	232	17	6	11	13.0886345057
235	233	1	0	1	14.205985227
235	234	20	3	17	10.1482711779
235	236	204	36	168	5.56151292194
235	237	10	4	6	15.9291673371
235	238	43	1	42	8.56170095343
235	239	6	0	6	14.9672246604
235	242	1	0	1	49.2903823252
235	243	1	0	1	43.6276368174
235	247	1	0	1	47.7227240802
235	262	1	0	1	34.7946918048
235	266	5	1	4	19.9402244957
235	268	9	3	6	16.6006941961
235	271	163	0	163	5.09351200608
235	272	44	7	37	11.8315780536
235	273	1	0	1	21.4981495184
235	274	2	0	2	29.8837622827
235	275	1	0	1	24.7766246946
235	276	3	0	3	25.4537166777
235	277	118	1	117	24.0841331447
235	278	9	4	5	9.88852384121
235	281	1	0	1	29.6821668602
235	282	4	1	3	26.6435130582
235	284	5	0	5	19.3094745433
235	285	11	1	10	11.9904252923
235	286	1	0	1	31.7919416095
235	287	1	0	1	17.5285378466
235	288	1	0	1	19.1953558461
235	290	1	0	1	14.4857645234
235	291	4	0	4	14.5503932414
235	292	2	0	2	19.3468227597
235	293	4	0	4	27.9781415721
235	295	1	0	1	23.4255788638
235	302	1	0	1	31.052959138
235	305	2	0	2	40.9724526684
235	307	0	0	0	52.1540466193
235	338	0	0	0	78.8350998712
235	371	1	0	1	41.3999699379
235	375	1	0	1	48.854004196
236	0	2	0	2	72.554070636
236	1	13	4	9	75.943233955
236	5	1	0	1	86.1653403086
236	13	1	0	1	76.6690428763
236	21	1	0	1	84.8649069291
236	28	2	0	2	71.2577451732
236	32	1	0	1	62.2585217672
236	36	1	0	1	76.0625396485
236	37	1	0	1	92.2375788503
236	38	1	0	1	89.1577790427
236	39	1	0	1	66.2032995171
236	42	1	0	1	70.4794747983
236	55	1	0	1	113.279758539
236	68	1	0	1	106.719282701
236	70	10	1	9	68.0840369921
236	71	2	0	2	78.4602641013
236	73	113	26	87	72.4424751976
236	74	4	0	4	74.8112096032
236	75	9	0	9	74.846409671
236	76	1	0	1	70.6778951219
236	78	7	0	7	73.9584493775
236	81	3	0	3	69.0047049203
236	82	9	0	9	71.5479698176
236	83	4	0	4	72.5173961694
236	84	16	0	16	73.4459357017
236	86	1	0	1	78.0421635218
236	87	2	0	2	76.9153605035
236	88	2	0	2	78.1547892831
236	89	1	1	0	60.6790747034
236	90	2	0	2	71.7368474932
236	96	1	0	1	68.7698246979
236	100	0	0	0	69.3514200258
236	101	1	0	1	53.444147855
236	103	3	0	3	76.5674666225
236	109	1	0	1	66.4375262446
236	110	1	0	1	80.0977112617
236	111	3	0	3	57.915471481
236	112	1	0	1	75.4317859911
236	113	9	0	9	80.1151441315
236	115	0	0	0	54.7630614107
236	142	5	0	5	95.0649305504
236	152	3	0	3	107.769159225
236	164	1	0	1	82.9256508834
236	172	1	0	1	92.1701646725
236	177	1	0	1	92.2363576505
236	181	27	1	26	16.148856445
236	182	2	0	2	36.2086125769
236	183	120	15	105	27.9149009557
236	184	4	0	4	27.4441112036
236	185	1	0	1	27.5447117899
236	186	26	3	23	15.6379947571
236	187	28	2	26	19.7632148133
236	188	15	0	15	20.873663192
236	189	1	0	1	31.9391823156
236	190	2	0	2	36.2500559492
236	191	6	0	6	35.9348613448
236	192	3	0	3	32.9745725941
236	193	2	0	2	29.4357728622
236	194	8	2	6	25.4070409594
236	196	14	0	14	38.7547334836
236	198	1	0	1	49.82296049
236	200	1	0	1	29.6619250501
236	201	1	0	1	45.4038838855
236	202	3	1	2	32.0587042732
236	204	4	2	2	20.5508413961
236	205	3	1	2	26.2301726638
236	206	11	0	11	18.2373516959
236	207	34	9	25	16.3578342521
236	208	122	8	114	23.9972449869
236	209	28	0	28	17.5043136058
236	210	5	5	0	16.2731350905
236	211	10	1	9	27.9690174641
236	212	96	37	59	14.2148067227
236	213	21	7	14	23.601621156
236	214	8	1	7	24.4293829866
236	215	1	0	1	30.7019673204
236	217	2	0	2	33.4985619666
236	218	1	0	1	26.147907792
236	219	2	1	1	40.0010882786
236	220	16	0	16	37.9774051549
236	221	3	1	2	31.6871489344
236	222	1	0	1	35.7120812602
236	223	19	1	18	19.7953351376
236	224	58	1	57	11.9007328432
236	225	96	24	72	14.5908152027
236	226	2	0	2	21.2241854278
236	227	7	1	6	15.4079040021
236	228	1	0	1	24.3636583792
236	229	221	43	178	17.8890666221
236	230	4	0	4	24.8528939116
236	231	100	82	18	6.64057178352
236	232	224	191	33	7.82324292431
236	233	67	6	61	8.64503669978
236	234	172	40	132	6.90077601812
236	235	117	0	117	5.56151292194
236	237	100	29	71	10.4865493677
236	238	100	2	98	9.34899671659
236	239	76	4	72	11.5834744638
236	242	4	1	3	49.006052457
236	243	2	0	2	43.6654200385
236	244	7	0	7	49.1040750449
236	245	3	0	3	49.8481128133
236	247	1	0	1	45.5369397816
236	248	1	0	1	46.1482993977
236	253	2	0	2	34.601887133
236	257	2	0	2	50.9035791285
236	261	1	0	1	51.2485088542
236	262	11	4	7	35.4751970867
236	266	6	0	6	25.0742074683
236	268	4	2	2	22.1560417466
236	269	1	0	1	31.9872481663
236	271	102	0	102	9.80303848914
236	272	157	0	157	10.8392169972
236	273	1	0	1	21.5005638056
236	274	2	1	1	31.4525726668
236	275	7	1	6	28.4680036548
236	276	7	1	6	24.1373135834
236	277	285	136	149	26.4006898846
236	278	4	0	4	15.3160542926
236	279	1	0	1	36.11987963
236	280	4	2	2	21.1176349051
236	281	2	0	2	30.2993217128
236	282	12	1	11	26.6351267952
236	284	14	0	14	18.0943150199
236	285	10	0	10	14.4661812938
236	287	11	0	11	18.089996447
236	288	2	0	2	23.61161072
236	291	34	10	24	10.8346543042
236	292	6	0	6	15.969363073
236	293	17	0	17	24.797298379
236	294	2	0	2	33.2966264844
236	295	2	1	1	21.144094346
236	298	1	0	1	21.0132058714
236	302	1	0	1	29.0518127039
236	303	3	1	2	66.6281425174
236	305	5	0	5	43.4316205699
236	307	2	0	2	54.9270457877
236	308	1	0	1	51.7676690525
236	310	0	0	0	49.9410461359
236	338	1	0	1	75.0404204085
236	345	11	3	8	31.0694682922
236	346	2	1	1	41.5834833653
236	375	1	0	1	43.5236279933
236	377	1	0	1	49.1839858847
236	433	1	0	1	199.107748123
236	469	1	0	1	136.415691648
236	471	1	0	1	132.462703256
236	480	1	0	1	134.763526816
236	491	1	0	1	143.10872899
236	531	1	0	1	164.115653079
237	1	5	0	5	80.2289269705
237	15	0	0	0	81.888836724
237	36	0	0	0	76.9791403257
237	48	0	0	0	116.628842461
237	70	1	0	1	65.6625088224
237	73	19	0	19	70.8932217935
237	74	2	0	2	72.6705813786
237	75	2	0	2	73.2834466079
237	76	1	0	1	68.0914259767
237	78	0	0	0	71.6197584387
237	83	1	0	1	70.6538884927
237	84	2	0	2	71.7363613887
237	86	1	0	1	75.3734148914
237	87	1	0	1	75.064924406
237	90	1	0	1	68.1097486637
237	92	0	0	0	61.1906045074
237	95	1	0	1	70.8721715044
237	96	1	0	1	64.5500124825
237	110	1	0	1	79.402246786
237	111	1	0	1	55.8816279686
237	112	1	0	1	74.8386626314
237	113	1	0	1	78.6858434947
237	142	5	1	4	93.9913516579
237	171	0	0	0	76.2609448922
237	181	6	0	6	26.6056996478
237	183	15	0	15	37.920808933
237	186	2	0	2	24.9384465928
237	187	1	0	1	25.2906741373
237	190	1	1	0	46.7097012353
237	191	1	0	1	38.9188602753
237	192	0	0	0	33.5931315747
237	196	2	0	2	35.7011867584
237	198	3	0	3	47.7281659149
237	199	1	0	1	24.5715313978
237	200	1	0	1	25.9894231862
237	202	2	0	2	30.6839196732
237	204	28	9	19	10.9374697903
237	205	11	2	9	16.167651424
237	206	50	12	38	7.75243011947
237	207	88	79	9	6.81807554231
237	208	193	0	193	14.4022266513
237	209	66	3	63	8.84115344867
237	210	8	4	4	9.89660687314
237	211	12	3	9	19.9983274318
237	212	514	64	450	4.2642988876
237	213	16	1	15	16.2659416873
237	214	31	0	31	13.943023006
237	215	3	0	3	20.2196680882
237	218	1	0	1	32.4617351074
237	220	6	0	6	45.1704742244
237	222	1	0	1	44.5488049899
237	223	5	1	4	21.7113146701
237	224	31	3	28	7.51785714024
237	225	37	31	6	11.3542678429
237	226	2	1	1	15.9189111416
237	227	2	0	2	20.1025773494
237	228	1	0	1	20.4956835859
237	229	30	9	21	16.584153565
237	230	4	0	4	24.8247375947
237	231	77	53	24	5.344618437
237	232	27	5	22	6.63143962163
237	233	145	16	129	2.91406817315
237	234	6	1	5	12.1555736589
237	235	3	0	3	15.9291673371
237	236	82	11	71	10.4865493677
237	238	5	0	5	18.0074824872
237	239	10	4	6	13.8347225305
237	242	0	0	0	52.6997969588
237	245	1	0	1	49.3370706523
237	250	1	0	1	41.0019559089
237	251	1	0	1	45.7941679021
237	256	1	0	1	59.3411188467
237	262	1	0	1	36.4346064562
237	264	2	0	2	49.9125463782
237	271	6	1	5	19.2597618909
237	272	30	0	30	13.6165846193
237	273	3	0	3	22.7073758417
237	274	2	0	2	34.2863190249
237	276	1	0	1	22.4226416474
237	277	49	2	47	30.9123628427
237	278	1	0	1	25.2241986222
237	280	2	0	2	27.7342857428
237	281	1	0	1	31.5331853542
237	282	2	1	1	27.0978056482
237	284	2	0	2	17.749181836
237	285	1	0	1	20.8238033963
237	286	1	0	1	30.3121683229
237	287	1	0	1	20.9084925694
237	291	64	14	50	7.92349443513
237	292	30	3	27	11.4128059266
237	293	17	1	16	18.9936548693
237	294	2	1	1	24.7551394609
237	296	0	0	0	30.2645904371
237	297	1	0	1	18.6708171884
237	298	7	0	7	13.3357253986
237	307	0	0	0	58.9817482963
237	345	8	0	8	21.1860297978
237	350	1	0	1	39.587393995
237	371	1	0	1	25.5809225619
237	471	2	0	2	133.764188956
237	516	1	0	1	191.803726697
238	1	18	3	15	80.9049149352
238	13	1	0	1	83.0625142004
238	15	1	0	1	84.8212381196
238	23	1	0	1	89.7176612321
238	28	1	0	1	76.4395581972
238	36	2	0	2	83.3032391318
238	70	3	0	3	76.7968496183
238	72	1	0	1	75.598721455
238	73	28	1	27	80.8364583101
238	74	1	0	1	83.4032164863
238	75	2	0	2	83.2330306854
238	76	1	0	1	79.4293915261
238	78	3	0	3	82.6191774494
238	79	2	0	2	76.9261188491
238	81	2	0	2	77.5540761281
238	82	1	0	1	80.2055802316
238	83	3	0	3	81.0247755163
238	84	4	0	4	81.8936853298
238	85	2	0	2	82.8378423319
238	86	1	0	1	86.7904916672
238	87	2	0	2	85.3974307257
238	89	2	0	2	69.0055929924
238	95	1	0	1	79.1821517015
238	101	1	0	1	62.1865010318
238	103	2	0	2	84.726703674
238	111	2	0	2	66.5645982256
238	112	2	0	2	83.4199890042
238	113	5	0	5	88.4252236155
238	131	1	0	1	126.70795973
238	140	1	0	1	93.5846308413
238	142	5	0	5	103.167672302
238	171	0	0	0	89.1732601694
238	177	2	0	2	101.26846766
238	181	141	3	138	11.4657978523
238	182	6	0	6	28.0543762969
238	183	357	53	304	20.282482129
238	184	7	0	7	21.9407365043
238	185	9	0	9	18.3428641539
238	186	147	79	68	6.97136671864
238	187	57	22	35	11.505268922
238	188	63	4	59	11.5260868329
238	189	1	0	1	23.4071298369
238	190	10	0	10	30.3689164104
238	191	7	0	7	28.4060074252
238	192	4	0	4	27.3262477641
238	193	1	0	1	20.9626251502
238	194	12	4	8	18.4661396
238	196	10	1	9	35.7961230857
238	198	2	0	2	45.538885055
238	200	2	0	2	27.9954802733
238	201	1	0	1	43.6628552761
238	202	11	4	7	28.1301501644
238	205	2	0	2	34.1679020491
238	206	2	1	1	25.2526153887
238	207	7	0	7	22.0189149904
238	208	51	1	50	28.8630529387
238	209	6	1	5	22.1783304949
238	210	2	1	1	19.3981037783
238	211	7	1	6	30.6094328993
238	212	23	0	23	22.2088580287
238	213	11	5	6	26.0908690624
238	214	2	0	2	31.3272544721
238	216	1	0	1	27.8660917575
238	217	6	1	5	24.3573559318
238	218	4	2	2	17.1149138889
238	219	3	0	3	31.0663127093
238	220	33	3	30	28.6405439459
238	221	1	0	1	22.3382641266
238	222	2	0	2	26.6764751126
238	223	44	8	36	14.6771007504
238	224	37	0	37	15.3546712719
238	225	58	2	56	15.8529714645
238	227	34	27	7	8.70942228714
238	228	2	0	2	23.571510007
238	229	206	97	109	16.2664028972
238	230	4	0	4	20.5730238817
238	231	12	4	8	15.6510190205
238	232	50	3	47	12.3106539677
238	233	18	2	16	15.3227981399
238	234	147	18	129	6.52372583201
238	235	60	2	58	8.56170095343
238	236	433	134	299	9.34899671659
238	237	16	5	11	18.0074824872
238	239	122	72	50	9.53096726211
238	242	1	0	1	40.7540874769
238	243	1	0	1	35.1433247627
238	244	1	0	1	41.6463207716
238	245	4	1	3	58.0261421847
238	246	1	0	1	59.118005266
238	247	1	0	1	54.8475819396
238	262	2	0	2	43.2947523563
238	264	2	0	2	54.2366672776
238	266	3	0	3	25.8864310403
238	268	6	0	6	20.3534006014
238	270	1	0	1	41.3120227174
238	271	45	0	45	13.1095680284
238	272	14	0	14	19.5189500004
238	274	1	0	1	38.4441230779
238	276	1	0	1	33.1433848934
238	277	116	0	116	32.5755442784
238	278	6	2	4	15.6552090795
238	280	0	0	0	25.963904867
238	281	3	1	2	38.1597316911
238	282	1	0	1	34.9451918429
238	284	3	0	3	27.0100652496
238	285	2	0	2	20.5342781235
238	287	2	0	2	25.9333326352
238	289	1	0	1	44.8709902563
238	290	4	0	4	21.9735955355
238	291	1	0	1	20.1554309246
238	292	3	1	2	25.3027722782
238	293	1	0	1	34.1288569217
238	294	1	0	1	42.2100549738
238	297	1	0	1	36.4278937276
238	305	2	0	2	49.3626247088
238	307	1	0	1	60.3892096726
238	310	1	0	1	59.0008740614
238	323	1	0	1	110.273469338
238	345	1	0	1	35.947232174
238	346	3	1	2	41.3268883716
238	357	1	0	1	96.999475763
238	375	1	0	1	50.3917432459
238	465	0	0	0	151.944178739
238	475	0	0	0	138.973987694
238	495	1	0	1	160.612263213
238	554	0	0	0	157.990120738
239	0	1	0	1	84.1298524629
239	1	6	0	6	87.4283527408
239	15	1	0	1	90.4824678203
239	55	1	0	1	124.863059104
239	70	5	3	2	78.3100523846
239	73	18	0	18	83.0728844277
239	74	1	0	1	85.1890104081
239	75	1	0	1	85.4770961032
239	76	2	0	2	80.8291929919
239	78	4	0	4	84.2404909753
239	79	1	0	1	79.181048717
239	82	3	1	2	81.844097859
239	83	1	0	1	83.0145285051
239	84	3	0	3	84.0118886042
239	86	1	0	1	88.1694613022
239	87	1	0	1	87.4288532131
239	89	1	0	1	71.4251243638
239	103	1	0	1	87.4163735973
239	104	1	0	1	77.9554950969
239	112	1	0	1	86.4214311088
239	113	1	0	1	90.8116750693
239	120	1	0	1	77.9413742996
239	136	1	0	1	112.162909022
239	142	6	0	6	105.922890326
239	169	1	0	1	76.5703892891
239	171	0	0	0	89.569068691
239	181	12	0	12	20.989435444
239	182	2	0	2	35.7092620554
239	183	79	0	79	28.7242580391
239	184	1	0	1	31.3165322666
239	185	3	0	3	24.1873735598
239	186	15	5	10	15.4304569615
239	187	14	0	14	11.7083362227
239	188	18	7	11	16.822495711
239	189	1	0	1	30.6869769593
239	190	1	0	1	39.5393040848
239	191	7	0	7	25.4812341412
239	192	3	0	3	21.5174692334
239	193	2	0	2	20.5574638655
239	194	16	3	13	14.8784277216
239	195	1	0	1	30.0497525131
239	196	5	0	5	27.5287743495
239	198	1	0	1	38.2961000181
239	199	2	1	1	21.6738787608
239	200	4	1	3	18.9675775349
239	202	1	0	1	20.5293131224
239	204	1	0	1	24.3241688213
239	205	1	0	1	28.7100031416
239	206	4	1	3	19.2436056066
239	207	17	2	15	15.0107439279
239	208	55	3	52	20.6586277443
239	209	8	1	7	14.3345729958
239	210	9	0	9	10.8337196558
239	211	8	0	8	21.317999731
239	212	11	1	10	17.890486637
239	213	23	0	23	16.8497045889
239	214	6	0	6	24.7104523259
239	217	2	0	2	26.1697765827
239	218	1	0	1	18.9650919034
239	219	4	1	3	31.6618635758
239	220	11	0	11	31.8568202949
239	221	1	0	1	26.4107957804
239	222	0	0	0	32.6925193034
239	223	77	18	59	8.50164636518
239	224	42	0	42	7.81892395751
239	225	203	5	198	6.73223141852
239	226	3	0	3	12.7858945733
239	227	42	11	31	6.4932465582
239	228	7	0	7	14.1906934352
239	229	618	5	613	6.97126275009
239	230	20	1	19	13.2695552262
239	231	7	1	6	14.6044983477
239	232	46	13	33	7.28813458833
239	233	9	3	6	10.9821978828
239	234	125	85	40	4.87276831961
239	235	8	0	8	14.9672246604
239	236	117	3	114	11.5834744638
239	237	14	4	10	13.8347225305
239	238	32	2	30	9.53096726211
239	242	2	0	2	39.1014792462
239	243	2	0	2	34.2930861565
239	244	6	0	6	38.355173148
239	245	4	0	4	60.7813853695
239	257	1	0	1	62.3193435264
239	266	2	0	2	34.4871612855
239	271	4	0	4	20.0565524693
239	272	8	3	5	21.9653211519
239	275	2	0	2	39.6138534583
239	277	42	9	33	37.9729120167
239	278	1	0	1	24.1607491853
239	281	0	0	0	41.5738720563
239	282	1	0	1	37.6629984382
239	284	2	0	2	28.6284402147
239	285	1	0	1	25.9592126481
239	290	1	0	1	29.4529858335
239	291	1	0	1	19.5204460007
239	292	3	0	3	24.3002529071
239	293	2	0	2	32.590935848
239	294	0	0	0	38.3678706773
239	303	2	0	2	78.0379083142
239	307	1	0	1	66.4704195847
239	338	0	0	0	79.9796525015
239	345	5	1	4	27.491511646
239	371	1	0	1	33.2492103444
239	415	1	0	1	161.749250195
239	471	1	0	1	143.951213062
239	475	0	0	0	141.582197123
239	488	1	0	1	158.735490763
239	507	1	0	1	234.412761019
239	573	0	0	0	131.077851839
240	0	0	0	0	120.447478747
240	1	1	0	1	122.655275228
240	4	1	0	1	128.715618505
240	70	1	0	1	114.469146531
240	73	1	0	1	119.572317187
240	74	0	0	0	121.462198696
240	75	2	0	2	121.970895901
240	79	1	0	1	115.702807918
240	83	1	0	1	119.403522468
240	84	1	0	1	120.456505661
240	110	1	0	1	127.775772469
240	127	1	0	1	136.16007146
240	142	2	0	2	142.556844318
240	171	1	1	0	124.766396249
240	181	2	0	2	50.0034719027
240	182	1	0	1	48.4277828897
240	183	30	2	28	47.7242331574
240	185	1	0	1	37.6379996917
240	186	3	0	3	41.8135141952
240	187	1	0	1	30.7795765088
240	191	36	0	36	14.7001231037
240	192	6	0	6	15.3285954887
240	193	2	0	2	23.6462323851
240	194	11	2	9	23.3343629033
240	195	31	2	29	7.04226418788
240	196	75	0	75	18.9086047821
240	197	1	0	1	28.5486707263
240	198	81	0	81	12.7951078862
240	199	1	0	1	32.3314394006
240	200	3	1	2	25.8823514536
240	201	1	0	1	24.712033446
240	202	6	2	4	18.8480721879
240	203	6	2	4	8.22383903621
240	204	1	0	1	56.7871120333
240	207	3	1	2	45.8673230945
240	208	13	3	10	45.5737804836
240	209	2	0	2	43.5758289578
240	210	0	0	0	40.1203973243
240	211	1	0	1	39.1704462171
240	212	1	0	1	51.8645770141
240	213	5	1	4	38.3266798118
240	214	4	1	3	53.0884552073
240	217	3	1	2	26.9230283968
240	218	1	0	1	29.0242848156
240	219	8	1	7	22.6971803832
240	220	17	0	17	31.2481625544
240	222	1	0	1	40.7320955066
240	223	1	0	1	28.3698390606
240	225	2	0	2	37.4829424433
240	228	1	0	1	30.0422527839
240	229	13	2	11	32.2292613022
240	230	3	0	3	24.0243721047
240	232	0	0	0	43.3321727655
240	234	2	0	2	41.253592688
240	236	0	0	0	48.1523891665
240	239	3	1	2	36.7960153196
240	241	47	13	34	13.0048113599
240	242	81	13	68	14.893228392
240	243	27	6	21	17.5584473101
240	244	279	134	145	7.93474307877
240	245	1	0	1	97.5106462812
240	249	0	0	0	85.9686673792
240	257	1	0	1	99.052941465
240	261	0	0	0	98.9804670803
240	262	1	0	1	83.5236194296
240	275	1	0	1	74.4010735131
240	277	15	3	12	74.1184942469
240	279	1	0	1	83.6853394524
240	282	1	0	1	74.4491515781
240	284	1	0	1	65.3310245209
240	293	3	0	3	67.5305601729
240	294	0	0	0	69.9518145813
240	298	0	0	0	61.2646991129
240	305	1	0	1	91.0592089488
240	345	2	0	2	48.2616098585
240	471	1	0	1	180.587623947
241	1	9	0	9	126.180342499
241	5	1	0	1	135.626460707
241	12	1	0	1	132.262104056
241	15	0	0	0	131.044972776
241	24	2	0	2	135.360258156
241	36	0	0	0	130.186761871
241	39	1	0	1	119.913354412
241	70	5	0	5	122.519290071
241	71	2	0	2	132.932498162
241	73	28	0	28	127.120980506
241	74	2	0	2	129.361788209
241	75	4	0	4	129.525927772
241	76	2	0	2	125.051078183
241	77	1	0	1	122.550713935
241	78	1	0	1	128.440242001
241	79	1	0	1	123.216696218
241	81	1	0	1	123.601323221
241	82	6	0	6	126.039346782
241	84	4	0	4	128.099903244
241	85	1	0	1	128.264008404
241	88	1	0	1	132.730345289
241	92	1	0	1	117.852709121
241	98	1	0	1	135.189631525
241	103	1	0	1	131.279089032
241	110	1	0	1	134.782472768
241	111	1	0	1	112.45339516
241	112	3	0	3	130.109224717
241	113	5	0	5	134.814745975
241	119	1	0	1	130.513941685
241	120	1	0	1	121.832857447
241	131	0	0	0	173.593568194
241	142	6	0	6	149.773392283
241	143	1	0	1	158.283469161
241	154	1	0	1	156.131350939
241	166	0	0	0	133.595947755
241	177	0	0	0	145.820400584
241	182	2	0	2	45.5960783282
241	183	45	0	45	47.2273246287
241	185	3	1	2	37.4066764141
241	186	4	0	4	44.9600700419
241	187	2	0	2	35.386270141
241	188	7	0	7	38.3944906166
241	189	1	0	1	42.4968950611
241	190	2	0	2	57.5144307197
241	191	41	12	29	18.804112093
241	192	1	1	0	24.6213635659
241	193	1	0	1	26.1487388321
241	194	4	0	4	29.4220934185
241	195	8	1	7	18.4699809752
241	196	16	0	16	31.600705625
241	198	7	0	7	25.2448609283
241	199	3	0	3	44.293800387
241	200	1	0	1	37.3813166721
241	202	4	0	4	29.881032286
241	203	1	0	1	21.2107013283
241	204	2	0	2	66.532314962
241	206	2	0	2	60.3970037153
241	208	12	1	11	56.5397665505
241	209	1	0	1	53.5759677351
241	210	0	0	0	49.816430059
241	211	1	0	1	50.7907836608
241	213	1	0	1	49.3100274904
241	214	3	0	3	63.7451432004
241	217	1	0	1	25.9486609619
241	219	14	0	14	19.3131468091
241	220	42	11	31	27.5991894616
241	221	2	0	2	31.8425742161
241	222	1	0	1	37.6881612216
241	223	3	0	3	35.8449379127
241	225	1	0	1	46.523762381
241	227	2	0	2	39.3049969546
241	229	7	1	6	41.1940567193
241	230	2	0	2	33.0832453551
241	232	1	0	1	51.3471026655
241	234	1	0	1	48.0404063112
241	235	1	0	1	55.4494521432
241	240	6	4	2	13.0048113599
241	242	300	5	295	7.30464762329
241	243	83	2	81	13.3404963328
241	244	474	176	298	6.33973058387
241	245	2	0	2	104.556139836
241	248	2	0	2	100.612109862
241	254	1	0	1	96.9330465772
241	256	1	0	1	112.769680225
241	257	1	0	1	105.070466853
241	258	2	0	2	108.314547447
241	260	1	0	1	107.374612649
241	266	1	0	1	69.075506508
241	271	1	0	1	59.7700032698
241	272	2	0	2	65.551294607
241	274	2	0	2	85.3310350125
241	276	2	0	2	78.4780691614
241	277	29	10	19	79.359222498
241	282	1	0	1	81.3441758634
241	289	1	0	1	90.2892416448
241	296	1	0	1	87.6284452603
241	302	1	0	1	82.5203920422
241	305	1	0	1	95.8765460756
241	307	1	0	1	106.447078876
241	319	1	0	1	149.0084526
241	321	1	0	1	140.414352514
241	323	1	0	1	152.097400237
241	345	1	0	1	60.0045968729
241	348	0	0	0	110.480269588
241	365	1	0	1	131.808953326
241	375	3	0	3	77.1201684618
241	408	0	0	0	216.455046325
241	460	1	0	1	192.642955497
241	466	0	0	0	203.608598133
241	471	4	0	4	185.883004823
241	472	1	0	1	181.611247912
241	474	0	0	0	208.450158764
241	481	1	0	1	207.908968307
241	491	1	0	1	197.055580565
241	503	1	0	1	204.384199441
241	520	1	0	1	219.155038499
241	540	1	0	1	236.632559486
241	577	2	0	2	159.243125462
241	588	1	0	1	183.497809926
242	0	0	0	0	118.727398478
242	1	68	30	38	119.2708636
242	3	0	0	0	118.092011802
242	6	1	0	1	137.873465479
242	7	1	0	1	122.296565211
242	9	2	0	2	115.791226056
242	10	1	0	1	125.717469043
242	12	1	0	1	125.217678952
242	13	2	0	2	123.062208999
242	15	4	1	3	124.334568738
242	17	1	0	1	133.46864161
242	23	1	0	1	128.643234886
242	26	2	0	2	139.758705271
242	28	5	0	5	115.172565264
242	32	1	0	1	109.010145093
242	33	1	0	1	127.955003603
242	35	0	0	0	132.087389276
242	36	6	1	5	123.898303461
242	39	2	0	2	113.518338171
242	42	1	0	1	117.985524984
242	48	1	1	0	160.807596118
242	49	1	0	1	143.735140408
242	50	1	0	1	149.848497918
242	55	2	0	2	158.273564608
242	59	0	0	0	172.832263453
242	65	2	0	2	159.17427763
242	68	1	0	1	153.61192045
242	70	19	1	18	117.058335887
242	71	1	1	0	127.448775659
242	72	1	0	1	116.083106251
242	73	135	4	131	121.42374313
242	74	6	0	6	123.814664011
242	75	17	1	16	123.826094947
242	76	7	0	7	119.63124345
242	78	16	0	16	122.948318265
242	79	3	0	3	117.513683273
242	80	0	0	0	118.18456619
242	81	4	0	4	118.010747692
242	82	10	0	10	120.539645031
242	83	9	0	9	121.521626805
242	84	19	0	19	122.441410174
242	85	11	1	10	122.919197458
242	86	7	0	7	126.991447632
242	87	7	0	7	125.917315016
242	88	4	0	4	127.160566899
242	89	5	0	5	109.630335885
242	90	1	0	1	120.364773186
242	92	1	0	1	112.327178434
242	93	0	0	0	99.7640203114
242	95	4	0	4	119.933797635
242	96	2	0	2	117.06126922
242	102	2	0	2	111.985028928
242	103	6	0	6	125.433926306
242	104	2	0	2	115.429935992
242	109	1	0	1	115.2099269
242	110	1	0	1	128.848449505
242	112	11	0	11	124.165999247
242	113	21	2	19	129.067203203
242	115	1	0	1	103.62769773
242	116	1	0	1	119.280058414
242	120	3	0	3	116.021671129
242	123	2	0	2	102.891038806
242	128	0	0	0	149.311705853
242	137	1	0	1	139.816408037
242	140	1	0	1	134.298573956
242	142	29	1	28	143.896523208
242	143	1	0	1	152.364957947
242	147	1	0	1	161.71815937
242	154	1	0	1	150.577643903
242	155	2	0	2	126.982603989
242	164	1	0	1	131.699859899
242	168	0	0	0	136.30531036
242	169	1	0	1	115.63307725
242	171	3	0	3	128.649241698
242	172	1	0	1	140.985163595
242	177	2	0	2	140.788374065
242	181	4	0	4	45.9076709389
242	182	3	1	2	38.3232209484
242	183	150	0	150	39.9623480885
242	184	1	0	1	47.7034030008
242	185	10	0	10	30.2079818555
242	186	13	0	13	38.2859740493
242	187	9	0	9	29.3503006025
242	188	17	4	13	31.6209696279
242	190	6	0	6	50.2123317946
242	191	83	46	37	13.8679301313
242	192	8	1	7	21.5745924327
242	193	11	2	9	19.7985256706
242	194	16	1	15	24.2489761399
242	195	8	0	8	17.8059470015
242	196	53	0	53	31.187099583
242	198	27	3	24	27.6559655647
242	199	3	0	3	42.3880333868
242	200	5	0	5	35.1808259595
242	201	1	0	1	38.5835215768
242	202	3	1	2	27.6264692932
242	203	4	0	4	22.1815519544
242	204	1	0	1	62.3218527677
242	206	1	0	1	56.3597678671
242	207	2	0	2	51.6028757517
242	208	46	34	12	53.3837954315
242	209	4	0	4	49.7178561015
242	211	16	8	8	48.3600804872
242	212	8	0	8	56.444653071
242	213	13	2	11	46.2989994391
242	214	2	0	2	60.2317836397
242	215	0	0	0	63.6769562212
242	216	3	1	2	24.9795199222
242	217	10	2	8	18.792736243
242	218	5	0	5	24.3213325511
242	219	65	29	36	12.0232575081
242	220	202	13	189	20.3169034882
242	221	6	0	6	24.5848624319
242	222	13	0	13	30.4087006642
242	223	5	0	5	31.0006825576
242	224	3	0	3	45.563195354
242	225	9	0	9	42.1922427116
242	227	3	0	3	33.6791577932
242	228	2	0	2	37.662193001
242	229	77	11	66	36.9630333901
242	230	4	1	3	29.2413591414
242	232	3	0	3	46.3525268564
242	234	3	0	3	42.5350654319
242	236	4	0	4	49.006052457
242	237	2	0	2	52.6997969588
242	238	2	0	2	40.7540874769
242	239	3	0	3	39.1014792462
242	240	11	2	9	14.893228392
242	241	328	86	242	7.30464762329
242	243	365	179	186	6.13003238212
242	244	774	207	567	7.11292405483
242	245	15	0	15	98.7121705288
242	247	1	0	1	93.1585106225
242	250	1	0	1	89.7885594887
242	251	3	0	3	97.859170331
242	253	1	0	1	83.12266381
242	254	0	0	0	91.2785562437
242	255	1	0	1	91.0112637081
242	256	2	0	2	106.587468898
242	257	1	0	1	98.8495649314
242	259	1	0	1	84.3236344686
242	260	1	0	1	101.294107802
242	262	4	0	4	84.0433740305
242	263	2	0	2	89.7269774569
242	264	3	0	3	94.6845376287
242	266	2	0	2	62.1236493739
242	268	3	0	3	54.4893388672
242	270	1	0	1	79.2033220983
242	271	2	0	2	53.4138235795
242	272	1	0	1	59.8199981967
242	273	1	0	1	70.369292654
242	274	3	0	3	79.0986062066
242	275	5	1	4	71.7078889934
242	276	1	0	1	73.0214200662
242	277	123	0	123	72.9860055904
242	281	1	0	1	78.8989273647
242	282	4	1	3	75.5395535847
242	284	4	1	3	67.0709370031
242	285	3	0	3	61.1656781008
242	287	3	0	3	66.6458327274
242	291	0	0	0	58.5248516541
242	293	4	0	4	71.6435389547
242	294	2	0	2	76.2249641704
242	296	5	0	5	82.9642883602
242	297	1	0	1	69.8270870517
242	303	2	0	2	109.393823243
242	305	3	0	3	89.3210712593
242	307	2	0	2	99.7263409501
242	309	4	0	4	106.394359917
242	310	1	0	1	92.7106914035
242	311	1	0	1	95.5106020787
242	313	1	0	1	100.545322355
242	314	1	0	1	97.8438181508
242	319	2	0	2	145.127678493
242	320	2	0	2	151.80473962
242	323	1	0	1	147.8101285
242	326	2	0	2	129.073761529
242	327	0	0	0	144.168329627
242	329	1	0	1	127.41978269
242	332	1	0	1	109.267635327
242	338	3	0	3	116.483418426
242	340	1	0	1	107.030633299
242	341	2	0	2	104.769192292
242	345	12	2	10	57.56449599
242	346	5	0	5	43.4539091347
242	355	1	0	1	136.300974619
242	365	1	0	1	128.732578858
242	371	1	0	1	63.3322116863
242	375	5	0	5	74.8818219193
242	377	3	0	3	87.5483825489
242	378	1	0	1	70.9345928995
242	407	1	0	1	205.557652685
242	411	1	0	1	207.219046724
242	424	1	0	1	258.15386179
242	426	0	0	0	248.022748485
242	464	1	0	1	178.48152495
242	466	4	0	4	197.342048674
242	469	3	0	3	184.730350793
242	471	2	0	2	179.327115441
242	491	1	0	1	190.637076921
242	501	1	0	1	208.620906355
242	503	1	0	1	198.561713288
242	507	1	0	1	272.250661243
242	523	1	0	1	231.361089728
242	570	1	0	1	161.647836652
242	573	3	0	3	170.103535585
242	579	1	0	1	157.121182074
243	0	2	0	2	112.749623165
243	1	17	0	17	113.174646312
243	5	2	0	2	122.517473707
243	13	2	0	2	117.095053599
243	15	1	0	1	118.308350771
243	28	2	0	2	109.095140616
243	32	1	0	1	103.088091065
243	36	2	0	2	118.076705406
243	49	1	0	1	137.710460985
243	50	1	0	1	143.839710419
243	53	1	0	1	143.297819911
243	55	1	0	1	152.206411066
243	56	1	0	1	144.832402027
243	59	1	0	1	166.776721039
243	66	0	0	0	140.259633758
243	68	1	0	1	147.660744345
243	70	3	0	3	111.745217359
243	73	41	2	39	115.954178443
243	74	4	0	4	118.439617735
243	75	8	0	8	118.353237939
243	76	1	0	1	114.343015889
243	77	1	0	1	111.438720631
243	78	2	0	2	117.609878313
243	79	1	0	1	112.043284182
243	81	4	0	4	112.612087381
243	82	9	0	9	115.198065272
243	83	3	0	3	116.103648999
243	84	3	0	3	116.995761577
243	85	2	0	2	117.677929794
243	86	1	0	1	121.707397337
243	87	1	0	1	120.488042728
243	89	3	0	3	104.134462514
243	90	2	0	2	115.2768301
243	92	1	0	1	106.975882799
243	98	1	0	1	124.680000098
243	103	2	0	2	119.869438575
243	107	1	0	1	129.761829014
243	110	2	0	2	123.228116409
243	111	1	0	1	101.559308453
243	112	5	0	5	118.542567218
243	113	7	0	7	123.561059196
243	116	1	0	1	114.059261905
243	131	1	0	1	161.465503288
243	139	1	0	1	159.924965872
243	142	3	0	3	138.303641587
243	166	0	0	0	124.481855536
243	177	0	0	0	135.743252163
243	181	1	0	1	39.8526255194
243	182	1	0	1	32.6075266473
243	183	73	10	63	33.8883056508
243	184	2	0	2	41.6039804896
243	185	6	1	5	24.0867767894
243	186	3	0	3	32.3280705664
243	187	8	0	8	23.9065924012
243	188	23	15	8	25.6231187779
243	190	2	0	2	44.3274604406
243	191	56	3	53	10.3911627211
243	192	4	0	4	19.2842813563
243	193	3	0	3	14.2383499612
243	194	8	1	7	19.7089442002
243	195	4	0	4	18.0938259523
243	196	19	0	19	30.702028981
243	198	8	0	8	29.6400288535
243	200	1	0	1	33.0018784884
243	202	6	5	1	25.6943982613
243	203	1	0	1	23.3717090173
243	204	1	0	1	58.0584454141
243	207	2	0	2	47.5553491378
243	208	20	6	14	50.0510772589
243	209	2	0	2	45.8428002183
243	212	3	1	2	51.959944462
243	216	3	0	3	19.3448587202
243	217	6	1	5	12.6627039575
243	218	4	0	4	18.4078046394
243	219	130	22	108	6.04560491504
243	220	177	8	169	14.6504843239
243	221	5	3	2	18.5029844841
243	222	4	1	3	24.6903796151
243	223	2	0	2	26.5745363597
243	225	2	0	2	38.0137035094
243	227	2	0	2	28.5237781542
243	229	18	4	14	32.9551047587
243	232	1	0	1	41.5811112316
243	235	2	0	2	43.6276368174
243	236	3	0	3	43.6654200385
243	237	1	0	1	48.0666724768
243	238	1	0	1	35.1433247627
243	239	2	0	2	34.2930861565
243	240	7	0	7	17.5584473101
243	241	62	11	51	13.3404963328
243	242	289	245	44	6.13003238212
243	244	194	29	165	11.1330525824
243	245	5	0	5	93.1683388691
243	249	1	0	1	83.627662843
243	251	1	0	1	92.7540860164
243	253	1	0	1	78.0390730569
243	257	1	0	1	93.077621925
243	259	1	0	1	78.5507181337
243	262	3	0	3	78.4206115269
243	267	1	0	1	60.7174183945
243	271	1	0	1	47.6130542648
243	272	1	0	1	54.4189619808
243	275	0	0	0	65.6992878639
243	276	1	0	1	67.7767981053
243	277	24	5	19	67.1475274095
243	281	0	0	0	73.2966909498
243	282	3	0	3	70.0514194239
243	284	2	0	2	61.7597169713
243	285	0	0	0	55.420339103
243	293	3	0	3	66.8766429613
243	297	3	1	2	65.6921689393
243	304	1	0	1	106.452810434
243	305	1	0	1	83.3743715111
243	307	1	0	1	93.700369264
243	309	1	0	1	100.414094883
243	310	1	0	1	88.7461216076
243	319	1	0	1	140.898343468
243	326	1	0	1	124.876487356
243	332	1	0	1	106.136670747
243	338	1	0	1	112.872875004
243	345	2	0	2	54.7816951735
243	408	1	0	1	205.519308658
243	415	1	0	1	195.116630027
243	469	1	0	1	178.957056575
243	471	2	0	2	173.360922972
243	476	1	0	1	161.01505262
243	488	0	0	0	188.068964803
243	491	1	0	1	184.734484384
243	501	1	0	1	202.856614832
243	505	1	0	1	204.232253296
243	556	1	0	1	197.008836342
244	0	0	0	0	120.377974416
244	1	11	0	11	121.698090161
244	16	0	0	0	116.957848524
244	21	1	0	1	130.863326436
244	32	1	0	1	110.42816158
244	36	4	2	2	124.893269716
244	57	1	0	1	168.515147405
244	70	2	0	2	116.660926572
244	73	23	2	21	121.388513101
244	74	2	0	2	123.543765619
244	75	2	0	2	123.793491988
244	78	1	0	1	122.594028351
244	79	0	0	0	117.490242513
244	81	2	0	2	117.810259601
244	82	6	2	4	120.198502125
244	83	2	0	2	121.35889943
244	84	6	0	6	122.344195031
244	87	1	0	1	125.771827495
244	88	1	0	1	126.922543872
244	90	1	0	1	119.476180246
244	96	1	0	1	115.932347459
244	103	1	0	1	125.636436888
244	112	2	0	2	124.534431911
244	113	3	0	3	129.107910485
244	117	1	0	1	128.562349024
244	133	1	0	1	138.626767676
244	142	10	0	10	144.141492463
244	152	1	0	1	156.866374548
244	167	1	0	1	156.139274171
244	181	2	0	2	48.3388787978
244	183	75	1	74	44.0836571125
244	184	1	0	1	51.5855688294
244	185	6	0	6	34.0290431602
244	186	3	1	2	40.3382712985
244	187	7	1	6	30.1685344553
244	188	5	0	5	33.9932558008
244	190	1	0	1	55.0084088642
244	191	93	39	54	13.2494304908
244	192	12	0	12	18.3144360563
244	193	2	1	1	21.4266698604
244	194	18	3	15	23.7015473681
244	195	17	7	10	12.3048420272
244	196	51	1	50	25.6352450402
244	198	24	2	22	20.7261809822
244	199	1	0	1	38.0240996084
244	200	3	0	3	31.0669507791
244	201	1	0	1	32.3121477422
244	202	6	1	5	23.5512265965
244	203	8	2	6	15.7307525835
244	204	1	0	1	60.3027780067
244	207	3	0	3	49.3986386598
244	208	13	0	13	50.2020270005
244	209	3	0	3	47.2998626054
244	211	2	0	2	44.4710608685
244	212	2	0	2	54.8384695918
244	213	2	0	2	42.9707531525
244	214	3	0	3	57.4228767244
244	217	6	2	4	22.6582507842
244	218	6	0	6	26.6087454369
244	219	19	2	17	16.9965711324
244	220	78	11	67	25.7053858071
244	221	6	0	6	28.8486529342
244	222	2	0	2	35.6528369922
244	223	2	0	2	29.8981740546
244	224	1	0	1	43.98581106
244	225	2	0	2	40.3562492799
244	227	3	0	3	33.7367251585
244	229	23	9	14	35.0182431574
244	230	10	1	9	26.8543659795
244	232	1	0	1	45.3818490153
244	235	1	0	1	50.1813141152
244	236	6	0	6	49.1040750449
244	238	1	0	1	41.6463207716
244	239	4	2	2	38.355173148
244	240	39	12	27	7.93474307877
244	241	204	90	114	6.33973058387
244	242	356	150	206	7.11292405483
244	243	128	60	68	11.1330525824
244	245	4	0	4	98.9344212169
244	257	2	0	2	99.7394117002
244	271	3	0	3	54.6714555259
244	272	3	0	3	59.921763685
244	274	2	0	2	80.0398603052
244	276	1	0	1	72.6616450988
244	277	50	3	47	74.2168552112
244	281	1	0	1	79.3657879068
244	282	2	0	2	75.7276556286
244	284	0	0	0	66.9021144864
244	287	1	0	1	67.1047947123
244	293	2	0	2	70.3647106254
244	294	1	0	1	73.9241109649
244	303	2	1	1	111.888851004
244	306	1	0	1	103.498624671
244	332	1	0	1	105.489872009
244	345	1	0	1	53.689666533
244	346	2	0	2	37.7343249371
244	415	1	0	1	200.089908407
244	469	1	0	1	185.473084319
244	507	1	0	1	269.348228547
245	0	16	0	16	30.248905363
245	1	187	0	187	40.6930121022
245	3	10	2	8	26.9621595787
245	5	10	0	10	50.5528195755
245	7	10	0	10	34.6673526257
245	11	1	0	1	57.6944007619
245	13	13	0	13	32.9814292702
245	15	1	0	1	37.4933314432
245	16	0	0	0	25.9940403834
245	18	3	2	1	29.7109175432
245	19	9	0	9	27.5543509556
245	21	1	0	1	46.9616847336
245	23	1	0	1	44.5455945147
245	28	18	0	18	35.8542393797
245	29	1	0	1	59.4042487692
245	31	1	0	1	36.1566271831
245	32	20	6	14	20.7223735698
245	33	2	1	1	35.4063309879
245	34	2	1	1	48.7877464075
245	35	6	0	6	40.2706861744
245	36	103	0	103	28.2976414043
245	39	29	3	26	21.36227718
245	40	1	0	1	16.406148509
245	41	5	0	5	35.2450059255
245	42	14	4	10	24.2467279845
245	46	2	0	2	66.8172264672
245	48	2	0	2	68.6279444556
245	49	1	0	1	53.6621251587
245	50	1	0	1	58.3915912461
245	55	1	0	1	69.4585902035
245	56	1	0	1	63.6795885365
245	58	1	0	1	73.2671143905
245	59	1	0	1	82.268360552
245	60	2	0	2	62.084488292
245	65	3	0	3	74.3290171629
245	68	1	0	1	59.6688262403
245	70	304	4	300	20.3301960426
245	71	54	0	54	29.9437430059
245	72	63	15	48	18.1297559322
245	73	3049	402	2647	22.9400293361
245	74	137	0	137	26.0231040792
245	75	174	15	159	25.3116442525
245	76	306	0	306	23.0774883168
245	77	27	17	10	18.6073835361
245	78	306	0	306	25.5696792655
245	79	196	25	171	19.0559361657
245	80	25	7	18	20.0854771463
245	81	245	59	186	20.1462593841
245	82	337	119	218	23.2236916378
245	83	115	14	101	23.3927245321
245	84	318	175	143	24.0935911079
245	85	57	2	55	26.8113610677
245	86	36	2	34	30.0875422383
245	87	97	0	97	27.6429176588
245	88	42	9	33	29.1485418494
245	89	610	18	592	11.0935802894
245	90	53	1	52	27.114872837
245	92	269	12	257	15.4133137989
245	93	3	1	2	22.079340866
245	94	4	1	3	18.3165975933
245	95	81	2	79	21.5684082295
245	96	114	32	82	27.0146596193
245	98	4	0	4	33.7323436488
245	99	1	0	1	34.4770534248
245	100	5	2	3	21.0694605709
245	101	113	13	100	8.88421175934
245	102	46	6	40	16.2854326807
245	103	164	34	130	26.7272916624
245	104	29	3	26	17.3940392901
245	105	65	23	42	12.5179483209
245	106	108	12	96	8.091559511
245	108	3	0	3	22.9779183263
245	109	58	7	51	21.4181174059
245	110	25	0	25	30.2827107252
245	111	273	151	122	10.6901192611
245	112	148	0	148	25.6416196001
245	113	258	5	253	30.4162176237
245	114	6	0	6	27.5351371588
245	115	36	1	35	12.0894331309
245	116	9	3	6	23.8075103974
245	117	1	0	1	30.3255573271
245	118	5	0	5	27.6479202196
245	119	7	1	6	30.9025051811
245	120	39	6	33	17.3159151187
245	121	1	0	1	31.8099498844
245	122	28	0	28	16.0693500739
245	123	100	5	95	5.59153513379
245	124	3	0	3	55.9609757399
245	128	2	0	2	50.6472632528
245	129	1	0	1	34.6974155039
245	131	2	0	2	70.3474261452
245	135	1	0	1	59.6078111634
245	137	0	0	0	41.8438998801
245	140	8	3	5	35.5961925419
245	141	0	0	0	72.8566560522
245	142	78	0	78	45.2173964977
245	143	1	0	1	53.7415176281
245	144	2	0	2	45.5410684318
245	145	1	0	1	46.518204416
245	146	5	5	0	34.7828555261
245	147	7	0	7	63.0287473634
245	148	1	0	1	46.4814399412
245	149	1	0	1	73.455445859
245	153	2	0	2	62.3724666947
245	154	1	0	1	52.3338563188
245	155	6	0	6	36.2718720411
245	156	2	0	2	33.1418337819
245	158	1	0	1	49.5849235797
245	164	5	0	5	36.2172224811
245	165	1	0	1	51.8611132205
245	166	5	0	5	42.8895221952
245	168	2	0	2	40.6243480763
245	169	10	2	8	29.5830649399
245	171	8	0	8	35.161410307
245	172	9	0	9	44.7848837275
245	177	4	0	4	46.3042026937
245	181	1	1	0	56.0840529138
245	183	35	16	19	67.992887037
245	184	1	0	1	62.0517005621
245	185	1	0	1	73.1713915811
245	186	2	0	2	61.7791318508
245	187	0	0	0	69.3618708537
245	188	1	0	1	68.4168596358
245	190	1	0	1	68.1363448648
245	191	1	0	1	85.7828643175
245	192	1	0	1	82.1838897489
245	194	0	0	0	75.2332722879
245	201	1	0	1	88.9648812685
245	204	4	1	3	44.9607880844
245	205	1	0	1	47.024471033
245	206	1	0	1	50.5834902377
245	207	3	1	2	54.1599238564
245	208	19	4	15	58.6974431062
245	209	6	0	6	56.7009180747
245	211	1	0	1	66.3751975552
245	212	9	0	9	47.2832143924
245	213	5	0	5	64.0450728605
245	214	2	0	2	51.9272322139
245	216	1	0	1	82.8546531704
245	217	0	0	0	81.9798851876
245	220	10	0	10	85.0884303924
245	224	2	0	2	56.7036371629
245	225	3	0	3	60.5632557631
245	226	1	0	1	64.999589454
245	227	1	0	1	65.2531089665
245	229	8	0	8	65.5487576483
245	230	1	0	1	73.5726086374
245	231	1	0	1	46.4069742386
245	232	1	0	1	54.2214814558
245	233	1	0	1	51.2975252252
245	236	5	1	4	49.8481128133
245	237	2	0	2	49.3370706523
245	243	2	0	2	93.1683388691
245	244	1	0	1	98.9344212169
245	246	265	159	106	6.52706275828
245	247	59	21	38	21.6980038785
245	248	174	5	169	8.52026521974
245	249	41	4	37	14.8691875091
245	250	156	9	147	8.95023158899
245	251	353	5	348	13.934313227
245	252	33	0	33	13.6058512153
245	253	72	1	71	20.3526572784
245	254	608	313	295	8.57987667361
245	255	24	0	24	11.9560797009
245	256	70	45	25	11.7930092363
245	257	532	215	317	9.33742568101
245	258	36	9	27	15.6384411174
245	259	10	1	9	16.8840724868
245	260	269	151	118	6.3740158535
245	261	6	0	6	19.3492912058
245	262	166	18	148	14.965290779
245	263	28	0	28	10.0671355608
245	264	62	2	60	13.8317792151
245	266	8	1	7	44.9807634877
245	267	1	0	1	42.5406207364
245	268	1	1	0	51.5946916497
245	270	5	1	4	33.6300737363
245	271	4	0	4	46.0911090285
245	272	19	6	13	39.0158727112
245	273	4	2	2	28.3627812563
245	274	18	0	18	21.2648584282
245	275	16	0	16	33.5265045019
245	276	16	3	13	26.9153791689
245	277	1041	187	854	28.0181859028
245	278	3	0	3	47.9660028492
245	279	7	0	7	23.0106100778
245	280	1	0	1	35.5427872438
245	281	40	15	25	19.9406389016
245	282	48	2	46	23.2130367411
245	283	1	0	1	27.7953465239
245	284	17	0	17	32.179638326
245	286	9	1	8	19.044845191
245	287	5	1	4	32.0930149669
245	288	2	0	2	39.5313042668
245	291	2	0	2	41.7855532402
245	292	3	0	3	38.0294600735
245	293	31	7	24	33.0078065013
245	294	12	0	12	38.9795404022
245	295	1	0	1	31.5655613881
245	296	12	0	12	27.2462153805
245	297	2	0	2	42.0446295129
245	298	1	0	1	39.4459377084
245	300	3	0	3	22.4772334485
245	303	12	4	8	36.0481302673
245	304	4	1	3	28.3767930985
245	305	45	15	30	20.1982439909
245	306	1	0	1	31.868609384
245	307	68	7	61	24.6274409006
245	308	3	0	3	29.8934902101
245	309	35	4	31	23.0401035037
245	319	3	0	3	63.6985748553
245	322	1	0	1	66.0072924153
245	329	4	0	4	46.2043425279
245	338	1	0	1	55.1756628272
245	345	1	0	1	61.9302161616
245	346	1	0	1	82.7791214587
245	348	3	0	3	29.8306778894
245	350	15	0	15	30.6783158146
245	371	0	0	0	61.8386974824
245	397	1	0	1	101.3712908
245	408	2	0	2	112.516306573
245	416	1	0	1	119.126537052
245	435	1	0	1	128.462893164
245	442	1	0	1	132.671675359
245	447	1	0	1	134.311114732
245	466	1	0	1	99.9534632086
245	469	5	0	5	86.876184914
245	471	8	0	8	84.8655779434
245	473	2	0	2	80.0025946517
245	475	3	0	3	80.9893672457
245	476	1	0	1	71.1173544051
245	480	1	0	1	85.890401306
245	487	1	0	1	96.8421813851
245	495	1	0	1	103.054570764
245	499	0	0	0	99.0968135193
245	501	1	0	1	110.587787099
245	502	1	0	1	108.041385911
245	503	10	1	9	99.8530392082
245	504	1	0	1	88.7497977283
245	573	1	0	1	78.1534949454
245	583	0	0	0	104.997104946
246	0	4	0	4	35.5087945401
246	1	42	6	36	46.6784447655
246	3	1	0	1	31.8832800706
246	5	2	0	2	56.306716607
246	7	1	0	1	39.8530006989
246	13	1	0	1	37.7967497178
246	15	2	0	2	42.6814313944
246	21	2	0	2	52.495088236
246	24	1	0	1	48.0412942732
246	27	1	0	1	59.4322080283
246	28	1	0	1	41.9365713937
246	32	3	0	3	26.6030898948
246	36	25	0	25	31.7036886371
246	41	1	0	1	38.7892416243
246	42	3	0	3	28.6340102105
246	49	1	0	1	57.7389110305
246	52	1	0	1	60.4899080542
246	60	1	0	1	65.5877715512
246	70	133	81	52	17.6853490137
246	71	17	0	17	28.0115492924
246	72	26	1	25	16.7246226783
246	73	1221	124	1097	22.3181465682
246	74	71	0	71	24.3594740376
246	75	63	3	60	24.7095037932
246	76	93	0	93	20.3458466149
246	77	7	1	6	17.6905840864
246	78	129	2	127	23.5092051991
246	79	82	7	75	18.4848777388
246	80	7	1	6	18.849792791
246	81	104	10	94	18.5971840059
246	82	125	16	109	21.0965789653
246	83	45	5	40	22.1526069319
246	84	110	0	110	23.1825334433
246	85	30	3	27	23.8588458736
246	86	15	5	10	27.6919819815
246	87	28	1	27	26.5683676682
246	88	16	8	8	27.7200090698
246	89	159	130	29	11.2743905805
246	90	10	0	10	22.8550618767
246	92	98	10	88	12.8734616071
246	93	3	1	2	15.6501833692
246	94	6	0	6	12.0283615299
246	95	16	2	14	23.2484886415
246	96	77	22	55	21.8001234369
246	98	1	0	1	30.9258797058
246	101	153	12	141	3.31859207511
246	102	8	1	7	20.6103196938
246	103	57	0	57	27.1375433192
246	104	4	2	2	19.8750246955
246	105	6	1	5	15.0859691414
246	106	10	0	10	12.0584193955
246	107	1	0	1	35.7245042393
246	108	2	0	2	17.0211497032
246	109	14	0	14	17.1222624943
246	110	7	2	5	31.1733624008
246	111	145	46	99	7.45735036477
246	112	32	0	32	26.7994422703
246	113	77	0	77	30.11190011
246	114	2	1	1	29.861065958
246	115	23	15	8	6.0959069504
246	116	7	0	7	20.4214617554
246	117	3	1	2	29.3647804203
246	118	1	0	1	24.1141977707
246	119	2	0	2	27.2291605093
246	120	15	4	11	17.8142211158
246	121	2	1	1	30.8756435034
246	122	23	8	15	11.0093699937
246	123	32	2	30	4.48863501508
246	127	1	0	1	38.892598199
246	129	1	0	1	36.7481368059
246	131	1	0	1	71.9989578256
246	137	1	0	1	40.3585804143
246	140	3	0	3	35.8389445861
246	142	16	0	16	45.4556536467
246	146	1	0	1	33.5249285966
246	147	1	0	1	62.6089258317
246	155	1	0	1	31.5800201895
246	156	2	0	2	27.9565148144
246	164	1	0	1	33.1081869452
246	166	2	0	2	37.5321591517
246	169	2	1	1	23.7362920562
246	171	4	1	3	31.238756065
246	172	2	0	2	42.1299372751
246	175	1	0	1	36.3404831811
246	177	2	0	2	42.947722674
246	183	3	1	2	70.7616137812
246	185	1	0	1	75.18723491
246	186	2	0	2	63.4679688641
246	188	2	0	2	69.9566796665
246	190	1	0	1	71.88102086
246	194	0	0	0	75.5898193974
246	196	1	0	1	83.7201772657
246	207	1	0	1	52.7545773885
246	208	6	0	6	56.5594553619
246	209	1	0	1	55.2830013755
246	211	1	1	0	64.3271296336
246	213	1	0	1	62.3857574235
246	217	0	0	0	83.3763770666
246	220	0	0	0	86.911246143
246	229	0	0	0	65.0807056085
246	235	1	0	1	50.9179751432
246	236	1	0	1	50.458304604
246	242	0	0	0	99.4580897226
246	243	1	0	1	94.102476654
246	245	925	489	436	6.52706275828
246	247	33	31	2	16.0679595069
246	248	51	27	24	4.55477322716
246	249	8	0	8	11.7608576404
246	250	15	4	11	11.8651972074
246	251	258	57	201	7.68135892474
246	252	4	1	3	13.7114079489
246	253	24	1	23	17.8484721082
246	254	39	11	28	8.40543277237
246	255	4	1	3	17.5594036866
246	256	6	0	6	17.095787582
246	257	39	4	35	15.8598443955
246	258	2	0	2	22.0647746405
246	259	2	0	2	21.202339408
246	260	8	0	8	12.5473246539
246	261	2	1	1	25.8555307751
246	262	16	6	10	17.8276768546
246	263	2	0	2	14.4893209358
246	264	6	1	5	20.1835544852
246	267	2	0	2	46.7703956451
246	268	1	0	1	54.8472939823
246	270	2	0	2	38.9079047451
246	271	1	0	1	47.9269407522
246	272	4	0	4	39.6851671579
246	273	1	0	1	29.4210304689
246	274	3	0	3	24.7316009269
246	275	2	0	2	37.6342753585
246	276	1	0	1	26.5528774778
246	277	201	42	159	31.2987330842
246	279	1	0	1	27.9051605301
246	280	1	0	1	38.5548861813
246	281	3	0	3	22.0806005593
246	282	12	1	11	24.3017270708
246	284	2	0	2	32.3916417401
246	286	4	0	4	19.205706795
246	287	1	0	1	33.4774429389
246	289	1	0	1	35.1560608028
246	291	0	0	0	41.4467837904
246	292	0	0	0	37.1635988345
246	293	9	3	6	30.9006416603
246	294	1	0	1	35.122828246
246	296	3	1	2	23.2640964932
246	300	2	0	2	17.9734512623
246	301	1	0	1	31.0016224762
246	303	5	0	5	42.451423383
246	305	4	1	3	26.1269605748
246	306	1	1	0	38.3956113349
246	307	7	1	6	31.1544962629
246	309	9	3	6	29.318183204
246	310	1	0	1	34.0259917433
246	329	1	0	1	40.3209995628
246	338	1	0	1	48.6489747833
246	345	1	0	1	59.1246434791
246	346	1	0	1	80.6530282132
246	348	1	0	1	23.3058274483
246	349	2	0	2	46.4505425101
246	350	2	0	2	24.9880455194
246	353	1	0	1	35.6515817492
246	408	1	0	1	111.470771197
246	427	1	0	1	125.091254782
246	469	0	0	0	87.8392435815
246	471	2	0	2	87.3234776083
246	480	1	1	0	87.5482869416
246	491	1	0	1	96.2342266215
246	495	1	0	1	103.56051351
246	503	2	0	2	99.6103340168
246	505	1	0	1	113.917053849
246	579	1	0	1	63.4411842502
247	0	1	0	1	51.5636828037
247	1	39	11	28	62.3906270108
247	3	1	0	1	47.9488934431
247	12	1	0	1	72.2769221748
247	13	1	0	1	53.8475944841
247	18	1	0	1	50.3428733902
247	21	1	0	1	68.5009308436
247	24	1	0	1	64.1088798415
247	28	2	1	1	57.538220043
247	34	1	0	1	66.7614721415
247	35	0	0	0	60.189345212
247	36	21	0	21	47.2746424436
247	38	1	0	1	59.5505266994
247	39	4	0	4	42.4978232796
247	42	1	0	1	44.6278989929
247	46	2	0	2	87.5738356122
247	48	0	0	0	87.0655067352
247	56	1	0	1	83.9035717935
247	70	180	54	126	27.8838519947
247	71	25	1	24	37.7091294506
247	72	12	2	10	28.9792094693
247	73	1711	583	1128	34.7077895582
247	74	93	2	91	34.9841502572
247	75	75	8	67	36.8554498845
247	76	289	109	180	29.7881819947
247	77	3	1	2	30.3710821985
247	78	149	23	126	33.5916500261
247	79	55	1	54	31.4426729775
247	80	2	0	2	30.9379890671
247	81	108	0	108	30.3047475573
247	82	143	22	121	31.4661262739
247	83	45	0	45	33.7290255928
247	84	174	6	168	35.0850573277
247	85	51	2	49	32.1806323038
247	86	27	1	26	36.5561747775
247	87	33	14	19	37.8460982406
247	88	39	13	26	38.3168576505
247	89	55	11	44	26.0694066176
247	90	53	8	45	28.1780111327
247	91	6	3	3	7.91964179991
247	92	64	0	64	24.5791397363
247	93	55	16	39	6.61427147179
247	94	11	0	11	13.485265478
247	95	13	5	8	37.909051355
247	96	342	99	243	24.1721375524
247	97	54	15	39	11.2685417937
247	98	1	0	1	38.5228346786
247	99	1	0	1	49.47892455
247	101	39	3	36	16.4123175492
247	102	2	0	2	36.6376201181
247	103	43	14	29	40.3219755259
247	104	1	0	1	35.2430669136
247	105	4	1	3	30.7287560843
247	106	5	0	5	28.1167131093
247	107	1	0	1	44.2347856897
247	108	15	0	15	17.5860108038
247	109	39	0	39	23.9808872172
247	110	9	0	9	44.6523616838
247	111	62	22	40	20.4977518804
247	112	46	0	46	40.7972844256
247	113	61	0	61	42.1756300801
247	114	1	0	1	44.7506836717
247	115	22	6	16	15.036784392
247	116	15	3	12	28.5183242646
247	118	4	2	2	31.0795644867
247	119	4	0	4	33.283858897
247	120	11	0	11	31.927001998
247	122	29	1	28	18.6331884739
247	123	3	0	3	20.3075703475
247	124	2	0	2	71.3078416815
247	128	1	0	1	60.9391257438
247	140	6	1	5	48.2818893226
247	142	24	11	13	57.4713130732
247	146	3	0	3	43.8574835991
247	147	2	0	2	73.0479400287
247	154	1	0	1	60.5279890375
247	155	4	0	4	33.867930151
247	156	4	0	4	28.978533274
247	160	1	0	1	55.2654604613
247	164	3	0	3	39.7528264538
247	166	4	0	4	36.372688506
247	168	1	0	1	44.2290499334
247	169	19	12	7	22.4916829327
247	171	6	4	2	36.0038741484
247	172	1	0	1	49.0172640381
247	177	5	0	5	48.0445393598
247	179	1	0	1	19.9634523538
247	182	1	0	1	78.7870933767
247	183	9	4	5	70.2560627428
247	185	1	0	1	72.5711058966
247	186	1	0	1	60.4695340723
247	190	1	0	1	74.0157850799
247	202	1	0	1	70.1070240409
247	206	1	0	1	38.4459267332
247	208	6	1	5	45.0263493518
247	209	3	0	3	45.3399557823
247	210	1	0	1	48.6671253636
247	212	4	0	4	37.0217074281
247	213	2	1	1	51.6475545068
247	214	0	0	0	37.3864721895
247	220	2	0	2	83.4827714511
247	221	1	0	1	77.1238814465
247	225	2	0	2	51.5141264458
247	229	0	0	0	56.8521427451
247	239	2	0	2	54.083046963
247	243	1	0	1	88.3432327504
247	245	404	0	404	21.6980038785
247	246	48	2	46	16.0679595069
247	248	28	1	27	13.2588775839
247	249	45	0	45	10.134624475
247	250	4	0	4	20.9436135765
247	251	618	37	581	8.76829580376
247	252	21	0	21	16.9520646615
247	253	154	0	154	11.9912956532
247	254	42	2	40	16.1376586052
247	255	3	0	3	29.0280100286
247	257	19	1	18	30.5173160485
247	258	2	0	2	37.0766399462
247	259	1	0	1	29.2599852234
247	260	3	0	3	28.0709430378
247	261	1	0	1	39.5599297449
247	262	27	8	19	24.0113758433
247	263	1	0	1	24.6166298487
247	264	2	0	2	33.3074142575
247	266	2	0	2	51.9580892199
247	270	3	1	2	47.1273820545
247	271	4	0	4	46.2348022579
247	272	6	1	5	35.9037891843
247	274	4	1	3	30.1664764332
247	275	3	0	3	42.7157494553
247	276	3	0	3	22.604691449
247	277	379	0	379	35.092494679
247	278	1	0	1	50.4724304018
247	279	4	0	4	36.1222961593
247	280	1	0	1	40.7291672194
247	281	16	5	11	25.321034269
247	282	21	5	16	24.5014139759
247	284	4	0	4	28.5577716961
247	285	3	0	3	39.5107128514
247	286	14	9	5	19.2296773751
247	287	5	0	5	32.3278815175
247	288	1	0	1	46.2795248467
247	292	9	2	7	29.9290476081
247	293	120	30	90	21.5204069286
247	294	50	1	49	21.1225394839
247	295	2	0	2	24.4289889463
247	296	54	4	50	10.469784756
247	297	4	1	3	26.3107177624
247	298	2	1	1	27.5354135802
247	300	44	5	39	5.55090127031
247	301	3	1	2	18.5745979457
247	302	10	2	8	16.6708873725
247	303	3	1	2	57.3672664666
247	304	1	0	1	50.0729736719
247	305	1	0	1	37.3275584765
247	307	5	1	4	45.1611563512
247	310	32	0	32	18.1325516346
247	313	2	1	1	19.9228908398
247	314	1	0	1	24.6851234454
247	316	2	1	1	12.4751095432
247	317	0	0	0	23.9405288053
247	319	2	0	2	54.7161219268
247	326	1	0	1	39.6112766365
247	329	4	1	3	36.1212508765
247	332	1	0	1	39.8988492112
247	338	4	1	3	36.7054813033
247	340	1	0	1	44.9983253751
247	345	1	0	1	46.1972856116
247	348	17	3	14	14.402635825
247	350	136	38	98	8.98302734579
247	352	4	3	1	15.0694290288
247	353	5	4	1	25.5655044113
247	354	1	0	1	30.9743471027
247	369	1	0	1	39.659787685
247	375	3	1	2	39.3953251884
247	427	1	0	1	134.047700223
247	437	0	0	0	166.35625783
247	442	1	0	1	140.008342905
247	466	1	0	1	113.590544351
247	469	3	0	3	100.097874981
247	471	1	0	1	101.55301228
247	488	1	0	1	115.818099337
247	494	1	0	1	98.0234396164
247	503	2	0	2	109.742462441
247	568	1	0	1	72.9918751242
247	573	1	0	1	77.0192965726
247	577	1	0	1	62.7048638404
247	585	1	0	1	77.886729551
248	0	3	0	3	38.7052801486
248	1	29	0	29	49.1665724966
248	2	1	0	1	48.1487546742
248	5	1	0	1	59.0686182569
248	7	4	0	4	43.1092004
248	9	1	0	1	37.6674388372
248	13	4	0	4	41.2918374753
248	15	2	0	2	45.938851219
248	19	1	0	1	36.043958653
248	27	2	0	2	62.8991455486
248	28	2	0	2	44.293674814
248	32	3	0	3	29.2369420324
248	34	1	0	1	56.018765263
248	36	20	1	19	35.7994316474
248	39	2	0	2	29.7408600849
248	45	1	0	1	88.6413171028
248	49	1	0	1	61.6376553237
248	53	1	0	1	81.9086331428
248	64	1	0	1	75.2260868712
248	69	1	0	1	74.1992872277
248	70	100	49	51	21.9381234213
248	71	19	1	18	32.3319265562
248	72	20	4	16	21.217999897
248	73	958	22	936	26.8514783302
248	74	33	15	18	28.7578219654
248	75	31	1	30	29.2377759734
248	76	134	4	130	24.5332083119
248	77	2	0	2	22.2211036085
248	78	87	28	59	27.8343013948
248	79	52	14	38	23.0311235628
248	80	3	0	3	23.3461840715
248	81	62	5	57	23.0571299694
248	82	89	0	89	25.429804138
248	83	27	11	16	26.6288042826
248	84	96	2	94	27.6900317133
248	85	16	4	12	27.9286524366
248	86	23	0	23	31.8978796817
248	87	15	0	15	31.0445415696
248	88	9	0	9	32.1398630567
248	89	80	3	77	15.7843110931
248	90	8	4	4	26.334628917
248	92	53	7	46	17.2445977411
248	93	2	1	1	14.6670735548
248	94	9	3	6	13.6044861134
248	95	14	0	14	27.6912932963
248	96	78	0	78	24.5744733267
248	97	3	1	2	18.2555499472
248	101	51	0	51	7.29702192475
248	102	8	0	8	24.2866987708
248	103	34	6	28	31.6908392796
248	104	6	1	5	24.1479523205
248	105	5	1	4	19.276762604
248	106	10	4	6	15.7341633996
248	108	4	1	3	19.0214882872
248	109	17	3	14	20.7181684706
248	110	3	0	3	35.7136520874
248	111	61	21	40	11.8659781224
248	112	29	0	29	31.3140862348
248	113	51	1	50	34.6489845577
248	114	1	0	1	34.22378375
248	115	25	2	23	8.99681327438
248	116	8	0	8	24.3807297586
248	119	3	0	3	30.9589769886
248	120	7	0	7	22.3488942803
248	121	1	0	1	35.3545194991
248	122	15	1	14	14.3665853892
248	123	11	5	6	8.85301936049
248	130	1	0	1	59.8956891376
248	134	1	0	1	45.920813712
248	140	2	0	2	40.3921714131
248	142	14	0	14	50.0057118938
248	144	1	0	1	49.2339198849
248	146	4	0	4	37.9495048516
248	155	5	1	4	34.6318971666
248	166	1	0	1	39.9160449825
248	168	1	0	1	41.6254488619
248	169	3	0	3	25.7057826875
248	183	6	0	6	67.1530756931
248	186	2	0	2	59.4382385547
248	194	1	0	1	71.1903486718
248	196	1	0	1	79.1655282103
248	205	1	0	1	39.7465213855
248	206	1	0	1	44.2722366281
248	207	2	0	2	48.1998058251
248	208	8	2	6	52.0424203645
248	209	2	0	2	50.728304606
248	211	1	0	1	59.8048483394
248	212	4	0	4	41.4847738368
248	214	1	0	1	44.9365842255
248	220	0	0	0	82.8878395934
248	232	1	0	1	49.5124955192
248	234	1	0	1	52.6135894531
248	236	0	0	0	46.1482993977
248	242	1	0	1	95.1209956184
248	245	1332	79	1253	8.52026521974
248	246	94	55	39	4.55477322716
248	247	55	9	46	13.2588775839
248	249	22	12	10	7.24974594187
248	250	35	0	35	9.65222401819
248	251	318	98	220	6.56641747513
248	252	14	2	12	9.71340344522
248	253	38	1	37	13.3102453128
248	254	188	73	115	5.01687173692
248	255	1	0	1	16.8886929393
248	256	7	0	7	20.2011469887
248	257	41	6	35	17.2878182248
248	258	5	2	3	23.8276461835
248	259	1	0	1	19.1352412797
248	260	24	3	21	14.880527935
248	261	1	0	1	26.6407758966
248	262	32	3	29	14.9476465888
248	263	5	1	4	12.9904615323
248	264	2	0	2	20.5332754584
248	266	1	0	1	45.7617107197
248	268	1	0	1	51.5434463016
248	271	1	0	1	44.0014388137
248	272	6	2	4	35.4256027833
248	273	1	0	1	25.351403635
248	274	2	0	2	21.9260036386
248	276	2	0	2	22.1340424694
248	277	241	36	205	28.2270948979
248	279	1	0	1	26.0922227709
248	280	1	0	1	35.2342008532
248	281	7	0	7	18.6072610737
248	282	11	1	10	20.316586998
248	284	6	0	6	28.0568029739
248	285	2	0	2	36.3132196364
248	286	2	0	2	15.0122830468
248	287	3	0	3	29.4801446904
248	288	1	0	1	40.0658937985
248	291	1	0	1	36.977144611
248	292	2	0	2	32.6400359159
248	293	13	0	13	26.3605300404
248	294	3	0	3	30.9843429725
248	296	2	1	1	19.1363965791
248	297	2	0	2	34.579895395
248	300	7	1	6	14.0939041056
248	302	1	0	1	18.9186024729
248	303	3	0	3	44.1617413533
248	304	2	0	2	36.8702044093
248	305	7	0	7	25.5241547881
248	307	6	0	6	32.1730863542
248	309	5	0	5	31.3773738402
248	310	2	0	2	31.3840960503
248	348	1	0	1	23.17505572
248	349	1	0	1	47.1630613938
248	350	2	1	1	22.215979248
248	352	0	0	0	26.3588329013
248	419	1	0	1	125.72231242
248	466	0	0	0	105.677849102
248	469	1	0	1	92.3922211481
248	471	3	0	3	91.7272148331
248	478	2	0	2	111.086185717
248	488	1	0	1	106.277299553
248	491	2	0	2	100.738652596
248	496	1	0	1	95.0581163988
249	0	2	0	2	44.9681312445
249	1	26	1	25	54.5737897078
249	7	1	0	1	49.4022565426
249	13	2	0	2	47.8303312447
249	15	1	0	1	52.2169955743
249	19	2	0	2	42.2003091812
249	33	1	0	1	50.2327964189
249	36	7	6	1	42.8652447223
249	59	1	0	1	96.9361395785
249	70	83	3	80	28.5029094633
249	71	22	0	22	38.9182075475
249	72	7	1	6	28.1877674575
249	73	835	52	783	33.9010410574
249	74	40	1	39	35.505186668
249	75	33	1	32	36.2671010191
249	76	174	32	142	30.9678203683
249	77	3	0	3	29.2738547747
249	78	81	5	76	34.4575742605
249	79	43	37	6	30.133325291
249	80	4	0	4	30.3126953695
249	81	81	2	79	29.9511620477
249	82	104	5	99	32.0851093882
249	83	40	9	31	33.5387152475
249	84	100	10	90	34.6672827344
249	85	18	4	14	34.1437040449
249	86	9	0	9	38.2906711522
249	87	10	0	10	37.9389393736
249	88	19	5	14	38.9128294691
249	89	33	1	32	23.0256466722
249	90	9	0	9	31.7250018963
249	92	35	0	35	24.0427626363
249	93	4	0	4	14.7030622772
249	95	10	0	10	34.939018232
249	96	44	5	39	29.0500847178
249	97	1	0	1	19.2951107541
249	100	1	1	0	35.622825351
249	101	14	0	14	14.0902617613
249	102	7	1	6	31.0990104261
249	103	28	5	23	38.871439015
249	104	1	0	1	31.3410301157
249	105	1	0	1	26.4444316391
249	106	3	1	2	22.6569679671
249	107	2	0	2	46.3292423309
249	108	2	0	2	22.77948194
249	109	8	0	8	26.4220287544
249	110	3	1	2	42.9319204319
249	111	29	2	27	18.7971638709
249	112	22	5	17	38.5552769839
249	113	38	8	30	41.6984109583
249	115	8	0	8	14.8482077213
249	116	2	0	2	30.4850477035
249	118	1	0	1	33.8188465205
249	120	2	0	2	29.5750401428
249	122	5	0	5	20.0859448566
249	128	1	0	1	61.5992974517
249	142	16	2	14	57.1024570934
249	147	1	0	1	73.9909684123
249	155	1	0	1	39.224340021
249	156	1	0	1	34.7765142334
249	164	1	0	1	42.9158890235
249	168	1	0	1	47.5255210228
249	169	1	0	1	29.0145086703
249	177	1	0	1	52.232444682
249	181	0	0	0	49.8438040576
249	183	15	1	14	62.6260554399
249	186	1	1	0	53.9898175964
249	190	0	0	0	65.3615692229
249	194	0	0	0	64.7280940514
249	196	2	1	1	72.0508701215
249	202	1	0	1	67.7574169927
249	204	1	0	1	31.1065062424
249	205	1	0	1	32.5260911013
249	207	3	0	3	41.081453674
249	208	10	0	10	44.8002539536
249	209	3	0	3	43.6013218698
249	211	1	0	1	52.5665871682
249	212	6	2	4	34.4340243194
249	213	3	0	3	50.6492501934
249	220	3	0	3	77.372014413
249	224	2	0	2	44.6844018333
249	227	1	0	1	55.1446061382
249	229	2	0	2	53.7396568323
249	233	1	0	1	39.5187690311
249	236	1	0	1	40.0262579436
249	237	2	0	2	37.1673245275
249	239	0	0	0	49.8896029807
249	242	1	0	1	88.8059901554
249	244	0	0	0	88.2143923831
249	245	481	24	457	14.8691875091
249	246	37	0	37	11.7608576404
249	247	138	56	82	10.134624475
249	248	29	22	7	7.24974594187
249	250	26	9	17	11.2716541263
249	251	146	8	138	9.30629371607
249	252	96	0	96	6.83416805512
249	253	410	330	80	6.10869419344
249	254	210	44	166	7.05149687246
249	255	1	0	1	19.4201570205
249	256	2	0	2	26.6298495372
249	257	14	0	14	22.3124172971
249	258	3	0	3	28.8662617155
249	259	4	0	4	19.1337178085
249	260	5	0	5	20.8896653253
249	261	2	0	2	30.4147075933
249	262	55	30	25	13.8797050882
249	263	4	0	4	14.8963288265
249	264	3	1	2	24.0918422938
249	266	2	0	2	42.785463334
249	267	1	0	1	41.8800850905
249	268	1	0	1	47.7943908738
249	270	3	1	2	37.0169804008
249	271	1	0	1	38.9245083681
249	272	12	3	9	29.539421029
249	274	5	1	4	20.1825459424
249	275	3	0	3	32.9769594514
249	276	16	2	14	15.901759117
249	277	445	25	420	25.5187344361
249	279	4	0	4	25.9884585357
249	280	1	0	1	31.730698066
249	281	26	7	19	15.5948829828
249	282	43	13	30	15.7040951083
249	284	7	0	7	22.0286180066
249	285	1	0	1	31.5827920908
249	286	47	17	30	10.1230446802
249	287	8	0	8	24.4579852732
249	288	1	0	1	37.0562716718
249	292	4	0	4	25.8080005918
249	293	78	0	78	19.1510701193
249	294	15	0	15	24.1103592685
249	295	3	0	3	19.4238603217
249	296	26	0	26	12.4224930808
249	297	2	0	2	27.3982391027
249	298	3	0	3	25.7321600617
249	299	2	1	1	14.5391040734
249	300	11	1	10	8.22024300927
249	301	2	0	2	19.5455548255
249	302	12	0	12	11.851580044
249	303	3	0	3	48.6787699866
249	305	6	0	6	27.4366371305
249	307	7	1	6	36.0516406245
249	309	3	1	2	36.5274778181
249	310	4	2	2	27.0463024957
249	340	1	0	1	54.4637081525
249	345	1	0	1	47.4880542249
249	348	3	1	2	23.5304729692
249	350	14	0	14	18.0571823031
249	353	1	0	1	35.3748735627
249	377	1	0	1	35.6066073166
249	388	0	0	0	113.306920938
249	471	2	0	2	98.9580329607
249	478	2	0	2	118.248465373
249	480	1	0	1	99.3049918642
249	488	2	0	2	113.519059596
250	0	2	0	2	35.684163961
250	1	55	0	55	44.0614814176
250	3	1	0	1	33.0815554489
250	5	1	0	1	54.4018602116
250	7	2	0	2	40.095223082
250	15	1	0	1	42.841742938
250	21	2	1	1	51.4124025291
250	23	1	0	1	49.5107483942
250	28	4	1	3	39.0254761667
250	32	3	0	3	25.2854684342
250	33	1	0	1	42.3077682676
250	35	2	0	2	47.091450515
250	36	26	4	22	36.0063476865
250	39	2	0	2	27.5256976081
250	42	1	0	1	31.1672244219
250	50	1	0	1	65.4624632804
250	53	1	0	1	77.6797527249
250	54	1	0	1	61.6053672914
250	55	1	0	1	76.1151665966
250	65	1	0	1	80.2753624368
250	70	59	38	21	28.7496529612
250	71	6	1	5	38.6770043624
250	72	10	0	10	26.9048137643
250	73	617	0	617	31.867988209
250	74	34	4	30	34.8035670613
250	75	32	4	28	34.2472178928
250	76	117	0	117	31.4903142126
250	77	2	0	2	27.4779894052
250	78	58	1	57	34.2422754714
250	79	14	2	12	27.9725713402
250	80	1	0	1	28.9145342855
250	81	39	9	30	28.9100310624
250	82	70	0	70	31.8582456823
250	83	26	3	23	32.2437781247
250	84	63	10	53	32.9964151305
250	85	9	2	7	35.1566195006
250	86	7	0	7	38.6779292351
250	87	15	1	14	36.5378410126
250	88	11	0	11	37.9926213546
250	89	62	10	52	20.0115247062
250	90	7	0	7	34.6616093868
250	92	38	0	38	23.7938520394
250	93	2	0	2	23.9038563274
250	94	3	1	2	23.1377107689
250	95	8	2	6	30.2857192377
250	96	12	1	11	33.6186156043
250	97	1	0	1	27.7998969767
250	100	2	0	2	28.9449185891
250	101	19	1	18	15.1692689753
250	102	6	1	5	23.6855919505
250	103	17	0	17	35.6463061196
250	104	4	0	4	25.926582802
250	105	4	0	4	21.1859419357
250	106	7	2	5	16.4780643163
250	107	1	0	1	46.5684043965
250	109	9	0	9	28.9113819101
250	110	3	0	3	39.1135854376
250	111	37	0	37	18.5995095329
250	112	24	8	16	34.4465380912
250	113	57	5	52	39.3664456304
250	115	4	1	3	17.8283642479
250	116	3	1	2	31.9123749372
250	117	1	0	1	39.2412972249
250	118	1	0	1	35.6945897615
250	119	1	0	1	38.8794895335
250	120	6	0	6	26.2604200283
250	122	4	1	3	22.8740752356
250	123	9	4	5	13.7737064154
250	128	1	0	1	59.5959481228
250	129	1	0	1	43.1188171492
250	131	1	0	1	78.7686006454
250	140	1	0	1	44.5100152666
250	142	13	7	6	54.1141101711
250	155	1	0	1	43.4451831059
250	164	1	0	1	44.5326268878
250	166	2	0	2	49.2434913033
250	172	2	0	2	53.3281026669
250	181	1	0	1	47.2628899993
250	182	1	0	1	67.3903470972
250	183	13	1	12	59.3366331707
250	184	0	0	0	53.6263564154
250	187	0	0	0	60.4393629813
250	188	1	0	1	59.4735737406
250	196	1	0	1	76.6958782243
250	198	1	0	1	88.7162995028
250	207	1	0	1	46.182420812
250	208	5	2	3	51.2387986888
250	213	0	0	0	56.1749142098
250	220	8	1	7	76.1796461168
250	222	1	0	1	70.660785873
250	228	1	0	1	61.4952899023
250	229	2	0	2	56.9918763268
250	232	1	0	1	45.6074358929
250	236	3	0	3	40.9852589141
250	245	1144	702	442	8.95023158899
250	246	31	13	18	11.8651972074
250	247	5	0	5	20.9436135765
250	248	21	10	11	9.65222401819
250	249	9	0	9	11.2716541263
250	251	32	0	32	16.1160903312
250	252	78	7	71	6.25502832924
250	253	25	8	17	14.7074729548
250	254	250	135	115	4.97748666201
250	255	22	1	21	8.1531311038
250	256	13	7	6	18.4611536925
250	257	126	0	126	12.2305423511
250	258	8	2	6	18.4329337909
250	259	24	7	17	9.51456179986
250	260	24	0	24	12.4897073447
250	262	313	95	218	6.14865369735
250	263	86	59	27	3.67317572969
250	264	20	5	15	12.9104513049
250	265	3	0	3	33.210859604
250	266	2	0	2	36.8967777847
250	270	3	0	3	27.6237317905
250	271	1	0	1	37.1625321709
250	272	11	0	11	30.1719729987
250	273	2	1	1	19.484709165
250	274	17	0	17	12.8991782914
250	275	5	0	5	25.7726173003
250	276	2	1	1	18.6858175403
250	277	520	46	474	19.5497438913
250	279	7	0	7	16.4430574277
250	280	1	0	1	26.945885591
250	281	34	21	13	10.9965419649
250	282	33	3	30	14.376357159
250	284	5	0	5	23.5376643618
250	285	3	0	3	29.2584687496
250	286	15	1	14	10.834016107
250	287	1	0	1	23.1527431067
250	289	4	1	3	24.3592480872
250	290	1	0	1	32.5254237793
250	292	1	0	1	29.8774658574
250	293	17	0	17	25.9840127572
250	294	1	0	1	33.802292371
250	296	4	0	4	22.8746150995
250	300	1	0	1	19.4297691085
250	303	7	0	7	37.6305229244
250	305	21	3	18	16.408287112
250	306	1	0	1	31.698569402
250	307	29	6	23	24.8532740607
250	309	8	3	5	25.9986480795
250	310	1	0	1	38.3164478142
250	326	1	0	1	56.4647627941
250	329	1	0	1	51.5978422887
250	338	1	0	1	57.1613229075
250	464	1	0	1	90.9704444619
250	473	0	0	0	88.8125897261
250	495	2	0	2	111.838274597
250	504	1	0	1	97.6086219422
251	0	5	0	5	43.0854598445
251	1	48	3	45	54.3592115676
251	3	2	0	2	39.3689536663
251	5	2	0	2	63.9721026645
251	7	2	0	2	47.3975504587
251	13	1	0	1	45.2181473117
251	15	2	1	1	50.2205378543
251	17	1	0	1	57.8306707207
251	19	2	0	2	40.5985819761
251	28	2	0	2	49.6088560508
251	32	3	2	1	34.2844286113
251	33	1	0	1	46.6147868027
251	34	1	0	1	58.0626140952
251	35	1	0	1	51.4337862896
251	36	27	0	27	38.5063576543
251	39	3	0	3	33.9908387456
251	41	2	0	2	45.5839176818
251	42	4	2	2	35.9445372584
251	46	2	0	2	78.8776779793
251	47	1	0	1	90.7818059576
251	54	1	0	1	62.425116506
251	56	1	0	1	75.1518887203
251	59	1	0	1	92.2113188912
251	70	306	57	249	20.2481904208
251	71	23	1	22	30.5089799979
251	72	29	7	22	20.7503703376
251	73	1739	0	1739	26.542870466
251	74	96	2	94	27.3923505857
251	75	87	2	85	28.7927528227
251	76	338	119	219	22.4850251786
251	77	12	1	11	22.0576132694
251	78	161	22	139	26.1625425877
251	79	86	0	86	23.075786489
251	80	16	0	16	22.7966938688
251	81	211	13	198	22.2609446472
251	82	163	4	159	23.882705517
251	83	54	5	49	25.7956138589
251	84	159	65	94	27.072307628
251	85	40	0	40	25.3852604357
251	86	33	4	29	29.6571734677
251	87	52	0	52	30.0784553782
251	88	22	3	19	30.7943670336
251	89	159	7	152	17.3197656719
251	90	65	36	29	22.5233930812
251	91	3	0	3	13.8161180594
251	92	202	19	183	16.3668234257
251	93	42	15	27	8.23168430351
251	94	51	16	35	8.13304416447
251	95	21	2	19	29.2259505991
251	96	517	16	501	19.7478120545
251	97	34	0	34	11.6991866116
251	99	1	0	1	41.0532674796
251	100	4	0	4	31.4927715561
251	101	108	58	50	7.64405229898
251	102	6	2	4	27.995843856
251	103	80	13	67	31.9905260178
251	104	4	1	3	26.4767329071
251	105	5	0	5	21.9710643722
251	106	3	0	3	19.5511513526
251	107	1	0	1	37.6165259294
251	108	19	8	11	13.558582947
251	109	116	11	105	17.4095131183
251	110	7	1	6	36.2681471911
251	111	135	14	121	11.8586021833
251	112	52	12	40	32.2605939653
251	113	113	1	112	34.1993345976
251	114	4	0	4	36.0472694817
251	115	143	2	141	6.62565712486
251	116	15	1	14	21.6823433208
251	117	1	0	1	32.8430013415
251	118	6	0	6	24.8119056471
251	119	6	0	6	27.4920569891
251	120	22	11	11	23.309514665
251	121	1	0	1	34.3113259266
251	122	99	2	97	11.2557603153
251	123	20	1	19	11.6500175949
251	124	1	0	1	62.9610630103
251	126	1	0	1	69.3439688321
251	127	1	1	0	42.6025257876
251	131	1	0	1	77.1424770082
251	134	2	0	2	46.0187378042
251	137	1	0	1	42.8627025642
251	140	3	0	3	40.2315537026
251	141	2	0	2	74.7315296123
251	142	36	1	35	49.6184258584
251	143	1	0	1	58.1785006686
251	149	1	0	1	77.0266604812
251	152	1	0	1	63.5178696613
251	155	5	2	3	29.9243853126
251	156	2	0	2	25.5284019464
251	164	2	0	2	33.8613344085
251	166	2	0	2	34.3684413132
251	168	1	0	1	38.4595181361
251	169	6	0	6	19.9884752511
251	171	2	0	2	30.8907146829
251	172	1	0	1	43.1679015468
251	175	2	0	2	35.9053066367
251	177	4	1	3	43.0106050142
251	179	1	0	1	19.3336993309
251	181	1	0	1	59.0923696192
251	183	6	0	6	71.8260780764
251	185	2	0	2	75.2780373033
251	186	3	0	3	63.2952084149
251	188	1	0	1	69.5257568063
251	190	1	0	1	74.1840481018
251	208	15	0	15	52.1089302088
251	209	1	0	1	51.6390738172
251	211	1	0	1	59.8854424079
251	212	1	1	0	42.7589562889
251	213	2	1	1	58.3830369646
251	214	1	0	1	44.6544640258
251	220	7	0	7	86.6707540216
251	223	1	0	1	67.2052221446
251	225	1	0	1	57.0853647846
251	229	2	0	2	62.3689540752
251	233	1	0	1	48.2731013679
251	236	1	0	1	49.2277986548
251	241	1	0	1	103.046904755
251	242	1	0	1	97.859170331
251	245	812	235	577	13.934313227
251	246	171	1	170	7.68135892474
251	247	316	27	289	8.76829580376
251	248	76	23	53	6.56641747513
251	249	29	4	25	9.30629371607
251	250	15	0	15	16.1160903312
251	252	7	0	7	14.7667344173
251	253	55	2	53	14.738897093
251	254	57	1	56	11.2428528162
251	255	1	0	1	23.4448098852
251	256	3	0	3	24.7475370429
251	257	36	11	25	23.1961569768
251	258	4	0	4	29.5726845916
251	259	1	0	1	25.5020210457
251	260	3	0	3	20.1654979122
251	262	26	9	17	20.9700963815
251	263	1	0	1	19.5383154556
251	264	5	0	5	26.9195139785
251	266	2	0	2	51.3417807126
251	272	5	0	5	38.818982237
251	273	1	0	1	29.4944133213
251	274	1	0	1	27.8599421338
251	275	5	1	4	40.9446422286
251	276	3	0	3	25.1541816998
251	277	280	3	277	33.8480646954
251	279	0	0	0	32.496158931
251	280	1	0	1	40.5061893975
251	281	12	0	12	23.9719431628
251	282	23	1	22	24.7980942603
251	284	10	0	10	31.2997055641
251	286	4	1	3	19.2225182538
251	287	1	0	1	33.7083510438
251	289	1	1	0	40.4619254806
251	291	1	0	1	39.3403525615
251	292	1	0	1	34.587916582
251	293	16	2	14	27.1305940764
251	294	9	0	9	29.1975017997
251	296	19	1	18	17.628144277
251	297	3	0	3	33.7777263622
251	298	2	1	1	33.6101300165
251	300	16	2	14	12.0438236273
251	301	1	0	1	25.7972056562
251	302	2	0	2	20.5266521412
251	304	1	0	1	42.0145876865
251	305	9	0	9	32.0870654216
251	307	5	0	5	38.355653122
251	309	7	3	4	36.9311271701
251	310	11	4	7	26.4200373973
251	316	2	0	2	20.8384630378
251	319	3	1	2	54.310576542
251	329	2	0	2	35.8950634616
251	331	1	0	1	45.5749222997
251	338	1	0	1	41.6245938407
251	346	3	0	3	76.0037030641
251	348	5	4	1	16.6092775748
251	350	7	0	7	17.4807715227
251	352	2	0	2	19.9941709121
251	353	2	0	2	29.0126480189
251	375	1	0	1	48.0777796176
251	377	1	0	1	36.7320268785
251	466	2	0	2	105.705627459
251	469	3	0	3	92.2712753406
251	471	2	0	2	93.0664785789
251	472	1	0	1	84.7616928529
251	476	2	0	2	78.8417881726
251	480	1	0	1	92.6153964255
251	503	1	0	1	102.778888375
251	505	1	0	1	118.428724239
251	573	1	0	1	73.4882738004
252	0	1	0	1	41.8960110932
252	1	17	0	17	50.2572734292
252	3	1	0	1	39.2006095681
252	5	1	0	1	60.6236535166
252	7	1	0	1	46.3147706695
252	9	1	0	1	40.1733421853
252	17	0	0	0	57.8338206856
252	21	1	0	1	57.6646858819
252	28	4	0	4	45.2139644178
252	30	1	0	1	58.008139105
252	32	4	1	3	31.5294389346
252	36	4	0	4	41.6655709954
252	41	1	0	1	48.4872458799
252	64	1	0	1	78.0756230373
252	65	1	0	1	86.473593764
252	70	19	0	19	31.3967161454
252	71	2	0	2	41.702877309
252	72	6	0	6	30.2408409248
252	73	280	35	245	35.6313018543
252	74	15	3	12	38.000198488
252	75	12	0	12	38.0363890039
252	76	103	1	102	34.0527082162
252	78	30	0	30	37.2022799624
252	79	7	0	7	31.7296672903
252	80	2	1	1	32.3431274317
252	81	21	0	21	32.1734152955
252	82	24	7	17	34.7886634716
252	83	11	7	4	35.6793598997
252	84	36	1	35	36.613416137
252	85	8	1	7	37.5319927452
252	86	8	4	4	41.4028037607
252	87	5	0	5	40.0771632067
252	88	3	1	2	41.3283211933
252	89	16	0	16	23.9545774341
252	90	2	0	2	36.0420306362
252	92	11	2	9	26.5625237729
252	96	4	1	3	34.0916832608
252	97	1	0	1	25.7607347883
252	101	2	0	2	16.851034492
252	103	4	1	3	39.9694895069
252	105	1	0	1	26.1151316183
252	108	1	0	1	28.2154042865
252	109	2	0	2	30.4310661369
252	110	3	0	3	43.7105766246
252	111	11	1	10	21.1486880126
252	112	10	0	10	39.1170173837
252	113	18	0	18	43.3468735147
252	115	1	0	1	18.7012853924
252	124	1	0	1	69.5651477757
252	142	6	1	5	58.4676442797
252	171	1	0	1	44.5033549492
252	182	1	0	1	65.7675356934
252	183	3	0	3	57.4709670242
252	184	1	0	1	52.3817724308
252	190	2	0	2	59.4395461236
252	202	1	0	1	66.3819147099
252	208	5	0	5	45.3207013726
252	209	3	0	3	43.1174468487
252	212	5	1	4	33.6889719649
252	213	1	0	1	50.4960179347
252	217	1	0	1	69.6650389645
252	220	1	0	1	73.2314586646
252	224	2	0	2	43.142735055
252	231	1	0	1	32.9783254486
252	232	1	0	1	40.7669142263
252	235	1	0	1	37.2076444958
252	237	2	0	2	35.7482006023
252	241	1	0	1	91.4911397467
252	245	280	108	172	13.6058512153
252	246	10	0	10	13.7114079489
252	247	17	0	17	16.9520646615
252	248	9	5	4	9.71340344522
252	249	61	7	54	6.83416805512
252	250	46	2	44	6.25502832924
252	251	18	7	11	14.7667344173
252	253	145	3	142	8.59928659073
252	254	129	38	91	5.44196996668
252	256	2	2	0	24.3585959449
252	257	15	1	14	18.472446865
252	258	2	0	2	24.6768595456
252	259	3	0	3	12.4042708388
252	260	10	6	4	18.352703434
252	261	1	0	1	25.0880818849
252	262	123	6	117	7.06875498311
252	263	12	7	5	9.29116648637
252	264	3	3	0	18.8516860032
252	266	5	1	4	36.5772386584
252	268	1	0	1	42.0375848231
252	270	4	1	3	30.1834673179
252	272	5	0	5	26.0279488495
252	273	1	0	1	15.7131584565
252	274	9	4	5	13.4236477507
252	275	3	0	3	26.3681542526
252	276	4	0	4	13.3414330334
252	277	401	28	373	19.1069361754
252	278	1	0	1	37.2067243611
252	279	6	0	6	19.1809339457
252	280	1	0	1	25.772810267
252	281	32	22	10	9.20560255737
252	282	36	8	28	10.622086984
252	283	1	0	1	28.3576052247
252	284	9	0	9	18.8602207811
252	286	67	2	65	5.58339273464
252	287	5	0	5	19.7988742031
252	290	1	0	1	31.1549473102
252	291	1	0	1	28.271242351
252	292	2	0	2	24.424103443
252	293	40	2	38	19.8510861092
252	294	1	0	1	27.5993643236
252	296	4	1	3	16.9580727711
252	297	1	0	1	29.5494271231
252	299	2	1	1	16.8213127916
252	301	1	0	1	22.3599081951
252	302	3	0	3	12.2203383328
252	303	1	0	1	43.5902406154
252	304	1	0	1	38.5054503981
252	305	12	0	12	21.1393542001
252	307	7	1	6	30.6657415825
252	309	3	0	3	32.2149029722
252	310	1	0	1	33.2369220662
252	315	1	0	1	26.495034585
252	319	1	0	1	69.0538861853
252	329	1	0	1	50.579270051
252	350	2	0	2	24.4873331341
252	460	1	0	1	101.252680465
252	464	1	0	1	96.3801245301
252	471	1	0	1	98.3796298434
252	495	1	0	1	116.467197567
252	503	1	0	1	112.938999612
253	0	2	0	2	49.9469973489
253	1	49	1	48	58.767166523
253	2	1	0	1	59.7963922014
253	3	1	0	1	47.0071242461
253	5	2	1	1	69.0910024792
253	9	1	0	1	48.3962671414
253	13	2	0	2	53.0358236538
253	15	1	0	1	57.1710409645
253	19	5	0	5	47.1079455437
253	21	1	0	1	66.0175998632
253	22	1	0	1	64.9351539121
253	28	4	1	3	53.7326120304
253	31	1	0	1	56.2664379003
253	32	3	0	3	39.7439300899
253	33	2	0	2	55.7320509094
253	35	1	0	1	60.5894355381
253	36	19	0	19	48.5979477221
253	39	1	0	1	41.3863181997
253	46	2	0	2	86.7395504171
253	48	0	0	0	88.9534009494
253	50	1	0	1	78.744182088
253	55	1	0	1	89.7708962831
253	65	1	0	1	94.4067639792
253	70	107	30	77	34.5007985003
253	71	13	0	13	44.8996371517
253	72	5	2	3	34.2840433193
253	73	1270	0	1270	40.0058857003
253	74	64	0	64	41.5433940032
253	75	54	6	48	42.3690294257
253	76	186	44	142	36.916151942
253	77	5	0	5	35.3798899978
253	78	96	12	84	40.4594386768
253	79	27	0	27	36.2419352364
253	80	6	0	6	36.4072399149
253	81	81	10	71	36.0323850258
253	82	184	0	184	38.1015503291
253	83	44	1	43	39.6204175606
253	84	115	0	115	40.76157517
253	85	25	0	25	40.0001175862
253	86	13	8	5	44.20258677
253	87	24	1	23	44.0141862888
253	88	19	1	18	44.9546199704
253	89	26	0	26	29.0931424053
253	90	17	0	17	37.2458876426
253	91	1	0	1	19.5996650628
253	92	28	0	28	30.1118956686
253	93	1	0	1	18.0977476268
253	94	3	0	3	22.5609726447
253	95	9	0	9	40.9524662634
253	96	15	0	15	34.1687192908
253	97	1	0	1	22.879784241
253	100	1	0	1	41.3542820097
253	101	9	0	9	20.1848216329
253	102	4	0	4	36.6324627567
253	103	30	0	30	44.9745858245
253	104	2	0	2	37.2496607882
253	105	5	1	4	32.3322160891
253	106	1	0	1	28.3440499526
253	108	2	0	2	27.6913493437
253	109	8	0	8	32.127386493
253	110	6	0	6	49.021045583
253	111	18	1	17	24.8964410326
253	112	26	0	26	44.6216270862
253	113	61	0	61	47.8019891527
253	115	4	0	4	20.7652514189
253	116	13	4	9	36.3156838542
253	117	1	0	1	46.8146240325
253	118	3	0	3	39.5348230926
253	119	1	0	1	42.230092404
253	120	4	0	4	35.6582145962
253	121	1	0	1	48.3145382253
253	122	3	0	3	25.8745003888
253	123	5	0	5	22.1338127499
253	131	1	0	1	89.812212079
253	140	1	0	1	53.626341056
253	141	1	0	1	89.1700497049
253	142	14	1	13	63.2098350709
253	143	1	0	1	71.8228503076
253	147	1	0	1	80.0511251981
253	155	5	0	5	44.2733263533
253	168	1	0	1	53.1972902823
253	169	5	0	5	33.5139604564
253	171	2	0	2	45.570135303
253	177	1	0	1	57.7046409043
253	181	1	0	1	45.472590067
253	183	13	0	13	58.3967440342
253	186	1	0	1	49.0433627393
253	187	1	0	1	54.2450028437
253	188	1	0	1	55.1120252811
253	190	1	0	1	62.0284991323
253	204	1	0	1	25.028161663
253	205	2	1	1	26.6885664602
253	206	1	0	1	30.9769186374
253	207	3	0	3	34.9774517785
253	208	42	0	42	38.7434750294
253	209	1	0	1	37.4954888622
253	210	1	0	1	40.2999719212
253	212	9	0	9	28.3538118008
253	213	2	1	1	44.5438885514
253	214	3	0	3	31.7183027251
253	220	6	0	6	72.2885360867
253	224	4	1	3	38.6921649841
253	225	1	0	1	42.5104043578
253	229	6	0	6	47.7589751639
253	230	1	0	1	55.992803535
253	232	1	0	1	36.9844183271
253	236	5	1	4	34.601887133
253	237	1	0	1	31.1754163596
253	239	1	0	1	44.1019806992
253	242	0	0	0	83.12266381
253	245	292	0	292	20.3526572784
253	246	23	6	17	17.8484721082
253	247	172	3	169	11.9912956532
253	248	12	3	9	13.3102453128
253	249	116	19	97	6.10869419344
253	250	14	0	14	14.7074729548
253	251	85	15	70	14.738897093
253	252	86	7	79	8.59928659073
253	254	58	7	51	11.8941682955
253	255	1	0	1	22.3575091672
253	256	1	0	1	31.9050094026
253	257	17	0	17	26.7381694986
253	258	1	0	1	33.1025569822
253	259	5	0	5	20.2002065276
253	260	2	0	2	25.9905390474
253	261	1	0	1	33.6854781026
253	262	72	1	71	14.8130864938
253	263	2	0	2	17.8900745634
253	264	2	0	2	27.4493041759
253	266	5	0	5	40.115818172
253	270	9	0	9	36.8594969127
253	271	2	1	1	34.4286622093
253	272	26	4	22	24.4320402036
253	273	1	0	1	16.252711153
253	274	6	4	2	19.63632334
253	275	5	0	5	31.4072629429
253	276	46	3	43	10.8261365401
253	277	946	206	740	23.6658284898
253	279	2	0	2	26.4272845571
253	280	5	0	5	28.8539068737
253	281	57	23	34	14.3903376089
253	282	55	12	43	12.7039076768
253	284	23	8	15	16.9399470873
253	285	4	2	2	27.5443083373
253	286	105	79	26	7.93488810121
253	287	10	0	10	20.3530259752
253	288	1	0	1	34.4812882295
253	289	1	0	1	35.0980904146
253	290	1	0	1	33.6240478166
253	291	4	1	3	24.6015654584
253	292	11	1	10	19.882359144
253	293	360	0	360	13.0521751084
253	294	69	0	69	19.1254453332
253	295	15	2	13	13.6359026782
253	296	116	34	82	8.44694474541
253	297	5	0	5	21.6966116054
253	298	15	1	14	19.6309266683
253	299	8	0	8	8.74282186072
253	300	33	11	22	7.24737792057
253	301	6	0	6	14.0910340273
253	302	84	0	84	5.82520461923
253	303	2	1	1	52.1895244747
253	305	7	0	7	29.4170761098
253	307	15	0	15	39.2553419574
253	308	1	0	1	41.3869134201
253	309	2	0	2	40.6981851068
253	317	1	0	1	25.1458169971
253	319	1	0	1	66.6070938361
253	329	1	0	1	47.9916308984
253	339	1	0	1	47.9592290583
253	341	1	0	1	42.3154043083
253	345	3	0	3	41.6231526518
253	348	5	0	5	26.3858116506
253	349	1	0	1	50.3448164777
253	350	5	0	5	17.366313655
253	353	1	0	1	37.3328742721
253	375	3	0	3	39.5650246292
253	426	1	0	1	165.789119598
253	469	2	0	2	105.672828787
253	480	1	0	1	105.367059613
253	492	2	0	2	124.674043318
253	496	1	0	1	108.071211712
253	501	1	0	1	129.081457218
253	567	1	0	1	100.090091439
254	0	4	1	3	38.1373335463
254	1	45	0	45	47.5266382998
254	3	2	1	1	35.1250278792
254	5	1	0	1	57.7052353551
254	7	1	0	1	42.5752115428
254	13	3	0	3	41.1553930686
254	17	1	0	1	53.8881813798
254	19	1	0	1	35.3293310876
254	23	2	0	2	52.2724208926
254	28	4	0	4	42.54189341
254	32	2	1	1	28.0798248846
254	34	1	0	1	57.3674727723
254	35	3	0	3	48.7105213264
254	36	22	9	13	36.8736456266
254	39	2	0	2	29.5031022045
254	41	1	1	0	43.803315734
254	42	5	1	4	32.6699980916
254	43	1	0	1	91.4939078442
254	48	0	0	0	77.1894183499
254	49	1	0	1	62.0808219313
254	50	0	0	0	66.9070271788
254	64	1	0	1	74.5921874368
254	68	1	0	1	68.2485017744
254	70	77	13	64	26.0525114793
254	71	17	5	12	36.3138436596
254	72	17	1	16	24.8069502754
254	73	901	92	809	30.1901167
254	74	34	0	34	32.5858366122
254	75	29	1	28	32.5952192241
254	76	144	3	141	28.7325531997
254	77	8	0	8	25.6193947642
254	78	103	0	103	31.8169351274
254	79	34	8	26	26.2895324333
254	80	2	1	1	26.9060522998
254	81	91	21	70	26.7465507121
254	82	101	40	61	29.4037950477
254	83	26	0	26	30.2440098951
254	84	90	0	90	31.1720641739
254	85	17	1	16	32.2631660864
254	86	15	0	15	36.0642975169
254	87	19	1	18	34.6389909583
254	88	14	4	10	35.9035787421
254	89	70	1	69	18.5386761852
254	90	8	0	8	31.0872228971
254	92	47	1	46	21.1825710162
254	93	3	0	3	18.9301719787
254	94	1	0	1	18.6156218869
254	95	16	0	16	29.8681036738
254	96	33	0	33	29.538893513
254	97	2	0	2	22.8837157048
254	98	2	0	2	39.3301824198
254	100	1	0	1	29.6487517012
254	101	8	1	7	11.6471809128
254	102	2	0	2	24.7901400334
254	103	33	1	32	34.5722123422
254	104	1	0	1	25.861889874
254	105	2	1	1	20.9452411575
254	106	5	2	3	16.664488666
254	107	1	0	1	44.0804428662
254	109	4	1	3	25.4000969946
254	110	4	0	4	38.3616970064
254	111	48	4	44	15.7807550157
254	112	31	5	26	33.7957336332
254	113	52	13	39	37.9111290098
254	114	1	0	1	36.027860467
254	115	12	1	11	13.833952937
254	116	4	0	4	28.8211182311
254	117	1	0	1	37.413503641
254	118	1	0	1	32.4930498575
254	119	1	0	1	35.5786288078
254	120	8	1	7	25.0956599886
254	122	6	0	6	19.1283628716
254	123	13	0	13	11.6401249841
254	128	2	0	2	58.1188792273
254	131	4	0	4	78.7626160725
254	134	1	0	1	48.7197663589
254	140	4	1	3	43.4091986391
254	142	27	2	25	53.0599297064
254	143	1	0	1	61.6463475581
254	145	1	0	1	54.8456391384
254	146	2	0	2	41.6853393159
254	148	0	0	0	54.9576524396
254	155	1	0	1	39.5502740968
254	156	1	0	1	35.622586704
254	168	1	0	1	46.0765754309
254	171	2	0	2	39.5197519142
254	172	0	0	0	50.5339042498
254	182	1	0	1	70.6268412541
254	183	18	0	18	62.4144777239
254	185	1	0	1	66.7827385845
254	186	1	0	1	55.0787548978
254	187	1	0	1	61.9727192222
254	188	1	0	1	61.5864290188
254	190	2	0	2	63.8428706716
254	196	1	0	1	76.5333429902
254	204	1	0	1	36.3836513087
254	205	0	0	0	38.4947011228
254	207	1	0	1	45.6835560381
254	208	6	0	6	50.1227801287
254	209	2	0	2	48.2247338389
254	211	1	0	1	57.8090181542
254	212	3	0	3	38.8346255041
254	213	2	0	2	55.5275752477
254	218	0	0	0	67.9128478688
254	220	3	0	3	78.5175968072
254	221	1	0	1	72.0086452989
254	222	1	0	1	73.4887604146
254	225	1	0	1	52.336581072
254	229	4	1	3	57.4007168453
254	237	1	0	1	41.0439960235
254	243	1	0	1	85.8657675106
254	245	1415	778	637	8.57987667361
254	246	52	4	48	8.40543277237
254	247	38	2	36	16.1376586052
254	248	77	5	72	5.01687173692
254	249	74	11	63	7.05149687246
254	250	95	1	94	4.97748666201
254	251	97	5	92	11.2428528162
254	252	63	25	38	5.44196996668
254	253	83	6	77	11.8941682955
254	255	9	6	3	12.9042143239
254	256	3	0	3	20.010844351
254	257	59	0	59	15.2676779833
254	258	3	0	3	21.8151208728
254	259	4	2	2	14.2591949095
254	260	32	3	29	14.1113038439
254	261	1	0	1	23.5484250042
254	262	77	3	74	9.93077567094
254	263	14	2	12	8.58964481969
254	264	15	5	10	17.2470622624
254	266	1	0	1	40.7737490853
254	270	1	1	0	32.4562371681
254	271	3	0	3	39.5232479357
254	272	5	0	5	31.4605062721
254	273	1	0	1	21.0698000676
254	274	5	1	4	16.9096191835
254	275	6	0	6	29.9928347768
254	276	6	1	5	18.6978154817
254	277	390	70	320	23.2471500646
254	279	2	0	2	21.2546404617
254	280	2	0	2	30.3357468392
254	281	16	0	16	13.75418858
254	282	27	0	27	15.9257048985
254	283	1	0	1	28.9992303893
254	284	11	1	10	24.299062846
254	286	21	0	21	11.0234230731
254	287	4	2	2	25.0918412935
254	288	1	0	1	35.0881558945
254	290	1	0	1	35.8359188338
254	291	4	0	4	33.6498869975
254	292	2	0	2	29.6702141394
254	293	32	0	32	24.428075636
254	294	3	1	2	30.832764746
254	296	4	2	2	19.3540749474
254	297	1	0	1	33.5756607711
254	300	2	0	2	15.2369587577
254	301	1	0	1	25.9649295289
254	302	9	0	9	16.7409213492
254	303	1	0	1	41.6886309967
254	304	1	0	1	35.434908812
254	305	11	2	9	21.3383928557
254	306	1	0	1	36.1846352918
254	307	12	0	12	29.1786807266
254	309	11	2	9	29.4762709913
254	310	1	0	1	33.8186618477
254	350	1	0	1	24.7050918314
254	353	2	0	2	39.9949456192
254	375	0	0	0	51.1658335076
254	408	1	0	1	119.656460857
254	471	3	0	3	93.4273067612
254	473	1	0	1	88.006271066
254	492	1	0	1	113.455326211
254	503	2	0	2	107.503503406
254	507	0	0	0	190.629831058
254	581	1	0	1	67.1458111385
255	0	1	0	1	30.1145903958
255	1	90	0	90	36.9210959648
255	2	1	0	1	40.2094167038
255	3	1	0	1	28.241304344
255	5	1	0	1	47.3874827224
255	6	2	1	1	56.1956203709
255	7	2	0	2	34.380988478
255	13	3	0	3	33.9434787943
255	15	5	0	5	36.9944140999
255	17	1	0	1	46.1046761941
255	18	4	1	3	31.5377999717
255	19	3	0	3	27.1643804271
255	21	1	0	1	44.7795298095
255	23	2	0	2	43.2485843799
255	28	14	1	13	31.8689819991
255	32	9	2	7	19.5657692868
255	35	2	0	2	42.5456405128
255	36	21	0	21	32.9568337902
255	39	11	0	11	23.0529955538
255	40	1	1	0	17.6811731252
255	42	11	4	7	27.2892970065
255	48	2	0	2	71.7047229109
255	49	1	0	1	55.4125827935
255	53	2	0	2	70.744968082
255	65	1	0	1	74.4829941039
255	70	22	0	22	31.8632219828
255	71	9	1	8	40.8453046187
255	72	3	1	2	29.1614625232
255	73	207	0	207	33.1693296613
255	74	8	3	5	36.8631845903
255	75	16	2	14	35.3965921341
255	76	36	0	36	34.5778526988
255	77	1	0	1	29.3167152277
255	78	12	1	11	36.6681674682
255	79	8	0	8	29.498967648
255	80	4	1	3	30.9078158183
255	81	18	6	12	31.1532824816
255	82	13	3	10	34.4301380597
255	83	8	1	7	34.0528642652
255	84	17	0	17	34.4838391615
255	85	1	0	1	38.334660751
255	86	2	0	2	41.2702805071
255	87	5	0	5	38.0029664148
255	88	1	0	1	39.7229961615
255	89	9	0	9	21.8959920424
255	90	2	1	1	39.0302089495
255	92	10	0	10	27.0662512448
255	94	1	0	1	29.553952268
255	95	6	0	6	29.6188908418
255	96	3	0	3	38.9320025734
255	99	1	0	1	42.0551265422
255	100	1	0	1	26.5137111008
255	101	2	0	2	20.5156885226
255	102	6	1	5	20.9848165005
255	103	8	0	8	35.7871325712
255	104	1	0	1	24.9831644019
255	105	2	0	2	20.9974501784
255	106	7	0	7	16.3208730118
255	109	6	1	5	33.3576958105
255	110	2	0	2	38.5919543921
255	111	11	2	9	22.6215915165
255	112	25	1	24	33.9457249362
255	113	24	0	24	39.9963606745
255	114	2	1	1	34.108921466
255	115	0	0	0	23.6043928777
255	116	3	0	3	35.5385283008
255	120	1	0	1	27.07392428
255	123	1	0	1	17.5359305899
255	129	0	0	0	41.1785336719
255	140	2	0	2	44.3975792191
255	142	9	2	7	53.7113785975
255	151	1	0	1	69.3527768513
255	154	2	0	2	62.2240491192
255	177	0	0	0	57.8238631969
255	181	1	0	1	46.6594602261
255	183	3	0	3	57.8561255884
255	188	1	0	1	59.8893566845
255	196	1	0	1	80.5673328036
255	206	1	0	1	48.0704207565
255	208	5	0	5	56.5889309406
255	209	2	1	1	53.3167467732
255	210	1	0	1	54.949012719
255	212	1	0	1	43.9678875672
255	219	0	0	0	80.5900448288
255	220	1	0	1	75.989529797
255	222	1	0	1	69.566046277
255	225	1	0	1	55.6729158781
255	236	1	0	1	43.1902210871
255	244	1	0	1	91.9364522252
255	245	294	74	220	11.9560797009
255	246	4	0	4	17.5594036866
255	248	1	0	1	16.8886929393
255	249	2	0	2	19.4201570205
255	250	23	2	21	8.1531311038
255	251	7	1	6	23.4448098852
255	252	6	0	6	13.767159128
255	253	2	0	2	22.3575091672
255	254	28	7	21	12.9042143239
255	256	46	1	45	15.6133159199
255	257	438	212	226	7.84054144767
255	258	45	18	27	12.1539115486
255	259	87	0	87	6.6876949463
255	260	38	6	32	10.9185983632
255	261	14	1	13	11.3383495783
255	262	150	40	110	8.93611869011
255	263	106	46	60	4.54768426201
255	264	389	102	287	5.25276509488
255	265	1	0	1	28.1325913634
255	266	2	1	1	34.0048951523
255	268	3	0	3	41.0799776397
255	270	7	1	6	21.677228627
255	271	1	0	1	37.6252894109
255	272	9	2	7	32.7843942255
255	274	22	5	17	11.916389716
255	275	8	0	8	22.3756895157
255	276	5	0	5	23.7824054564
255	277	530	23	507	18.2410188977
255	279	48	10	38	11.3195622989
255	280	1	0	1	25.7426629409
255	281	18	7	11	13.5247680372
255	282	15	6	9	18.0587072039
255	284	7	0	7	27.3170041709
255	286	3	0	3	16.7352544878
255	287	3	1	2	25.1567227211
255	289	3	0	3	17.6514036847
255	290	1	0	1	31.2015951411
255	291	1	0	1	37.1397988735
255	292	1	0	1	34.5884992705
255	293	3	1	2	32.3075967549
255	296	1	1	0	30.7182963635
255	297	1	0	1	42.5160108448
255	303	20	12	8	29.8560183327
255	304	6	1	5	25.6787202332
255	305	274	106	168	8.65695854916
255	307	71	12	59	16.8988243677
255	308	4	1	3	19.8802890472
255	309	19	4	15	19.1417450103
255	310	1	0	1	46.4664548372
255	319	1	0	1	75.5675123045
255	375	1	0	1	61.59654706
255	408	1	0	1	121.790652591
255	466	1	0	1	106.36355703
255	471	2	0	2	89.2926407224
255	487	1	0	1	100.402632797
255	520	1	0	1	130.18237889
255	548	1	0	1	198.387125692
255	573	1	0	1	89.746940637
256	0	14	0	14	18.5091967755
256	1	176	0	176	29.7732047242
256	3	17	0	17	15.1749956019
256	5	5	0	5	39.2276959082
256	6	1	0	1	46.8509630616
256	7	4	0	4	22.9081346763
256	8	1	0	1	52.0992325854
256	9	3	2	1	17.6644787809
256	11	1	0	1	46.9583530143
256	13	5	0	5	21.2004890996
256	15	5	2	3	25.7380018749
256	16	2	1	1	14.2773772626
256	18	7	4	3	18.0010014504
256	19	6	0	6	15.8991711047
256	23	1	0	1	32.8449566968
256	24	1	0	1	31.1271670181
256	26	1	0	1	40.2069746355
256	28	8	0	8	25.2003950705
256	30	1	0	1	33.6691426487
256	32	96	27	69	9.78368104354
256	33	3	0	3	23.9278809357
256	34	2	0	2	38.138243044
256	35	2	1	1	28.7556116112
256	36	135	25	110	17.6761429373
256	39	96	0	96	9.56937278672
256	40	30	0	30	4.90710069579
256	41	6	0	6	24.2478666656
256	42	27	10	17	12.7434227222
256	46	1	0	1	55.0267941741
256	48	0	0	0	57.5225243391
256	50	2	0	2	47.0598502363
256	62	1	0	1	73.0013090022
256	65	1	0	1	62.5688395488
256	67	1	0	1	57.9240226768
256	70	36	1	35	21.3842259762
256	71	10	0	10	28.0189626289
256	72	11	0	11	17.6724558644
256	73	493	133	360	19.7836068572
256	74	19	0	19	24.1667419267
256	75	38	2	36	21.6564636672
256	76	21	0	21	23.6857813228
256	77	6	0	6	17.139398313
256	78	42	2	40	24.5104199012
256	79	59	17	42	16.8280993781
256	80	1	1	0	18.735621543
256	81	36	10	26	19.3332258239
256	82	33	3	30	22.7168541977
256	83	20	5	15	21.2562337575
256	84	67	0	67	21.2222976225
256	85	7	2	5	27.1980648428
256	86	8	0	8	29.00255338
256	87	21	0	21	24.4664517976
256	88	7	2	5	26.4046710322
256	89	77	2	75	11.6932012014
256	90	5	1	4	29.9650803685
256	92	30	1	29	17.8094539311
256	95	52	0	52	14.5027661536
256	96	2	0	2	31.8720756496
256	98	1	0	1	33.0344840683
256	99	0	0	0	26.515150882
256	100	49	3	46	10.9284057169
256	101	4	2	2	17.8117344324
256	102	205	70	135	5.4168279687
256	103	42	0	42	21.029574026
256	104	40	18	22	9.92325798553
256	105	86	4	82	7.53422136488
256	106	98	23	75	5.64770536348
256	107	4	0	4	35.5591158228
256	109	7	1	6	25.1669635876
256	110	8	0	8	23.3176778353
256	111	17	13	4	16.251348167
256	112	66	2	64	18.7865924668
256	113	70	13	57	25.5004204684
256	114	2	0	2	18.4976122303
256	115	3	0	3	20.6602433324
256	116	3	0	3	25.4700528657
256	117	3	2	1	26.5889245234
256	119	2	1	1	32.1675775956
256	120	21	4	17	13.7521125124
256	122	1	0	1	22.2313861479
256	123	1	0	1	13.3397446005
256	129	0	0	0	25.5729219258
256	137	1	0	1	38.0672314722
256	140	2	0	2	29.2530232436
256	142	16	4	12	38.3336446201
256	146	1	0	1	31.1183675508
256	155	1	0	1	39.2175136823
256	164	1	0	1	35.8877616304
256	169	1	0	1	35.7932871367
256	171	1	0	1	36.5438913452
256	172	1	0	1	43.0113985216
256	177	1	0	1	45.8360467315
256	183	3	0	3	73.1334656523
256	186	2	0	2	68.758244984
256	188	1	0	1	75.5026640329
256	202	1	0	1	89.581105647
256	208	1	0	1	69.6532215366
256	209	1	0	1	67.1618781348
256	212	1	0	1	57.7124170454
256	220	1	0	1	91.5503592795
256	224	1	0	1	66.4955487369
256	226	1	0	1	75.2079603674
256	229	2	0	2	75.0864335118
256	232	2	0	2	63.6624062253
256	242	0	0	0	106.587468898
256	245	85	0	85	11.7930092363
256	246	4	0	4	17.095787582
256	247	3	0	3	33.0989311961
256	248	3	1	2	20.2011469887
256	250	2	1	1	18.4611536925
256	251	5	0	5	24.7475370429
256	252	2	0	2	24.3585959449
256	254	1	0	1	20.010844351
256	255	2	1	1	15.6133159199
256	257	540	21	519	7.79221617638
256	258	25	4	21	8.43442416619
256	260	78	14	64	6.00627510182
256	261	3	0	3	14.707906035
256	262	10	1	9	23.0965308084
256	263	3	0	3	17.2517107859
256	264	44	12	32	12.9734460161
256	266	1	0	1	48.8772218227
256	270	1	0	1	34.3098835239
256	272	4	2	2	47.8361769332
256	274	1	0	1	27.4972783906
256	276	1	0	1	37.1304791201
256	277	68	1	67	33.8375848285
256	279	1	0	1	25.970675411
256	281	1	0	1	28.2316424802
256	282	4	0	4	32.3541157472
256	283	2	0	2	25.9555378264
256	284	1	0	1	41.7000220303
256	291	1	0	1	51.5444291374
256	293	1	0	1	44.1849964596
256	294	1	0	1	50.7273710167
256	303	11	0	11	26.7776909526
256	304	3	1	2	17.4821846778
256	305	21	0	21	20.0809799603
256	307	30	0	30	18.1385330529
256	309	12	4	8	13.4902343866
256	310	1	0	1	51.1199894349
256	329	1	0	1	51.8015085455
256	464	1	0	1	72.7709980533
256	466	0	0	0	90.8631809165
256	471	1	0	1	74.4277482308
256	495	1	0	1	94.814375063
256	505	1	0	1	103.638060689
257	0	28	1	27	23.4748605823
257	1	418	6	412	32.2615970095
257	2	3	1	2	33.5092138459
257	3	13	2	11	21.0621307583
257	4	2	0	2	33.1919146276
257	5	3	2	1	42.4499780229
257	6	2	0	2	50.8173008579
257	7	8	0	8	27.875403767
257	8	1	0	1	53.7194436204
257	9	3	0	3	21.7029396428
257	10	1	0	1	30.4371362399
257	11	1	0	1	48.9834818605
257	12	1	0	1	42.0438363891
257	13	18	0	18	26.9633255581
257	14	1	0	1	30.58119453
257	15	9	0	9	30.6140812454
257	17	2	0	2	39.4693979332
257	18	12	0	12	24.2564288242
257	19	11	4	7	20.5662668814
257	20	1	0	1	42.6755195035
257	21	5	0	5	39.2805397045
257	23	9	0	9	37.2955330115
257	24	3	0	3	35.9482604782
257	26	1	0	1	45.9087872071
257	28	31	8	23	27.2877786697
257	29	1	0	1	52.551850353
257	30	2	1	1	40.5188574467
257	31	1	0	1	33.6081032282
257	32	90	1	89	13.0569987654
257	33	5	0	5	30.5751449785
257	35	2	0	2	35.2630012868
257	36	181	34	147	25.1685391588
257	37	1	0	1	42.3233939864
257	38	1	0	1	38.2641094188
257	39	103	5	98	15.6334856866
257	40	30	7	23	10.1713063719
257	41	7	0	7	31.4153960133
257	42	45	18	27	19.6630656056
257	46	1	0	1	60.2458652718
257	47	1	0	1	75.8269599072
257	48	2	0	2	64.3480006029
257	50	6	2	4	53.6798513755
257	53	2	0	2	65.6306908912
257	54	1	0	1	50.6378745576
257	59	1	0	1	77.6085120988
257	60	1	0	1	57.5680784543
257	61	1	0	1	71.5842179394
257	62	1	0	1	78.1235662084
257	64	1	0	1	59.6163824981
257	65	6	0	6	68.0710896189
257	70	79	13	66	26.2550140331
257	71	13	6	7	34.3430432363
257	72	18	0	18	23.0516818233
257	73	1180	31	1149	26.3449919492
257	74	56	0	56	30.3784886743
257	75	62	39	23	28.4448726562
257	76	59	0	59	28.8482298908
257	77	11	0	11	22.9263615141
257	78	97	0	97	30.4167247917
257	79	69	2	67	22.9110810931
257	80	9	0	9	24.55466954
257	81	69	9	60	24.9531316502
257	82	98	11	87	28.3386891903
257	83	50	3	47	27.4894786102
257	84	116	0	116	27.7276573774
257	85	26	1	25	32.559212771
257	86	12	1	11	35.0225890192
257	87	36	0	36	31.1618578722
257	88	19	3	16	32.9920378951
257	89	144	0	144	15.9854049388
257	90	8	0	8	34.2081142432
257	92	37	2	35	21.8322590519
257	93	1	0	1	31.3861878897
257	95	39	16	23	22.0455351067
257	96	13	2	11	35.0457452366
257	98	2	0	2	38.9686252769
257	100	31	1	30	18.6738790837
257	101	12	0	12	17.9320511322
257	102	106	17	89	13.1450445785
257	103	55	3	52	28.3961549795
257	104	18	0	18	17.4045763788
257	105	41	19	22	13.8619944332
257	106	82	48	34	9.61117588543
257	107	1	0	1	42.1318319256
257	109	7	2	5	28.8138021928
257	110	11	1	10	30.9694802758
257	111	45	1	44	18.4231470612
257	112	92	0	92	26.3684276656
257	113	95	21	74	32.7404402446
257	115	2	0	2	21.1391833084
257	116	6	0	6	30.1940135366
257	119	1	0	1	37.2319941404
257	120	24	11	13	20.1765112235
257	121	2	0	2	34.8611050834
257	122	6	0	6	24.381171694
257	123	13	4	9	13.8468514342
257	124	1	0	1	54.3414293237
257	131	2	0	2	68.5402869545
257	133	0	0	0	39.1892691948
257	135	1	0	1	61.6526454563
257	138	1	0	1	39.5292856992
257	140	5	1	4	36.8475781919
257	142	40	11	29	46.0469683634
257	144	3	0	3	47.7621602748
257	146	2	0	2	38.0796385861
257	147	1	0	1	64.331782404
257	151	1	0	1	61.5331995862
257	154	1	0	1	54.9398818219
257	155	1	0	1	43.5549399343
257	164	4	0	4	41.711629869
257	166	1	0	1	50.8150544093
257	168	1	0	1	45.7889615117
257	169	6	0	6	38.1818998373
257	171	1	0	1	41.6210000278
257	172	2	0	2	49.468344064
257	177	3	0	3	51.81834992
257	182	1	0	1	72.8936242128
257	183	13	0	13	65.4199456808
257	186	1	0	1	60.974868417
257	187	0	0	0	69.6846605796
257	188	3	0	3	67.7209183487
257	196	1	0	1	87.9235055652
257	207	2	0	2	57.8261927982
257	208	9	0	9	63.2094708547
257	211	1	0	1	70.6618027162
257	212	4	0	4	50.9106934144
257	213	1	0	1	67.864762936
257	214	1	0	1	57.0234618263
257	220	5	0	5	83.7607358245
257	222	1	0	1	77.1926510104
257	229	1	0	1	67.7626696451
257	233	1	0	1	53.8414638041
257	236	0	0	0	50.9035791285
257	237	2	0	2	52.2813268292
257	238	1	0	1	58.1829533668
257	242	0	0	0	98.8495649314
257	243	1	0	1	93.077621925
257	244	0	0	0	99.7394117002
257	245	783	302	481	9.33742568101
257	246	8	0	8	15.8598443955
257	247	2	0	2	30.5173160485
257	248	8	2	6	17.2878182248
257	249	2	1	1	22.3124172971
257	250	27	4	23	12.2305423511
257	251	28	1	27	23.1961569768
257	252	1	0	1	18.472446865
257	253	5	1	4	26.7381694986
257	254	32	6	26	15.2676779833
257	255	74	2	72	7.84054144767
257	256	545	11	534	7.79221617638
257	258	356	73	283	6.59083468598
257	259	12	0	12	14.5274671097
257	260	394	55	339	4.37513422627
257	261	54	16	38	10.1907767412
257	262	129	21	108	15.8478698263
257	263	88	1	87	10.1111632839
257	264	376	318	58	5.84743229751
257	266	6	0	6	41.2809914123
257	268	0	0	0	48.5557354537
257	270	6	0	6	27.4139797969
257	271	7	1	6	45.4657634183
257	272	10	0	10	40.3836489003
257	274	17	10	7	19.7514274758
257	275	4	1	3	29.6595856016
257	276	3	1	2	30.4057423332
257	277	505	76	429	26.04666914
257	278	1	0	1	46.1568691223
257	279	19	1	18	18.3520613945
257	280	2	0	2	33.5037020069
257	281	11	1	10	20.8614503542
257	282	19	1	18	25.1851061583
257	283	4	2	2	19.9786162784
257	284	9	1	8	34.5470057562
257	285	4	0	4	37.6861900827
257	286	1	0	1	22.7874142779
257	287	4	0	4	32.826457596
257	288	1	0	1	36.3384506781
257	289	3	0	3	22.7820578622
257	291	4	0	4	44.4118156959
257	292	2	0	2	41.4897720475
257	293	4	1	3	38.1785959087
257	294	4	0	4	45.8600591043
257	296	1	0	1	34.5835761009
257	297	2	0	2	48.0200166505
257	303	40	23	17	26.8766344144
257	304	8	3	5	20.1947024382
257	305	244	32	212	13.1302200385
257	306	9	1	8	22.5503624083
257	307	390	128	262	15.309454268
257	308	6	1	5	20.9978715493
257	309	80	13	67	14.2376203425
257	329	2	0	2	54.709386636
257	338	0	0	0	64.5069813301
257	349	1	0	1	61.8013260958
257	415	1	0	1	104.195071813
257	427	1	0	1	126.999232567
257	465	1	0	1	93.8306756939
257	466	2	0	2	98.5390008045
257	469	1	0	1	85.882772774
257	471	3	0	3	81.6844091455
257	495	0	0	0	102.588659275
257	496	1	0	1	91.1121345761
257	503	1	0	1	100.480926622
257	573	1	0	1	83.7180270241
258	0	17	1	16	17.9692748425
258	1	471	210	261	25.7252088649
258	2	1	0	1	28.0601436166
258	3	9	5	4	16.3659006236
258	4	1	0	1	27.3547095765
258	5	8	1	7	35.9911417297
258	6	5	0	5	44.5083883259
258	7	8	0	8	22.2278250398
258	9	14	3	11	15.7720270959
258	12	3	0	3	35.4729688744
258	13	11	2	9	21.8820631018
258	15	9	0	9	24.8545770832
258	16	1	0	1	14.0552555629
258	17	2	0	2	33.9507819158
258	18	2	0	2	19.7198574024
258	19	1	0	1	15.0197249711
258	21	6	0	6	32.9997535535
258	22	1	0	1	32.363220565
258	23	6	0	6	31.2396010838
258	24	5	0	5	30.0771125466
258	28	55	0	55	20.7280720451
258	30	0	0	0	36.2081003508
258	31	1	0	1	30.7878475799
258	32	106	15	91	7.44888926495
258	33	1	0	1	26.2219675056
258	34	1	0	1	41.6638433104
258	35	2	0	2	30.6430182672
258	36	55	1	54	22.3801184825
258	37	1	0	1	37.4517329365
258	39	68	2	66	11.655234199
258	40	4	0	4	7.02877387285
258	41	3	0	3	27.75668573
258	42	22	8	14	16.196570499
258	46	2	0	2	54.4052145059
258	49	1	0	1	43.3294192053
258	50	9	0	9	48.9539070848
258	53	1	0	1	59.2479788196
258	55	3	1	2	58.8941000069
258	60	1	0	1	52.9250684513
258	65	1	0	1	62.3607474752
258	69	1	0	1	60.5162500269
258	70	14	4	10	29.7003869926
258	71	6	1	5	36.3970457577
258	72	6	1	5	26.0620940531
258	73	206	3	203	28.1381133714
258	74	17	0	17	32.5741941952
258	75	18	0	18	29.9201603889
258	76	19	1	18	32.066845758
258	78	17	1	16	32.9430130242
258	79	4	0	4	25.260907458
258	80	0	0	0	27.1683854832
258	81	11	6	5	27.7558911097
258	82	9	1	8	31.1452421673
258	83	8	2	6	29.6681873333
258	84	22	0	22	29.5836936428
258	85	4	0	4	35.6126608303
258	86	7	2	5	37.4237163177
258	87	8	0	8	32.7502147529
258	88	4	0	4	34.7177693902
258	89	18	4	14	19.7105060131
258	90	5	0	5	38.1644952473
258	92	11	3	8	25.845113126
258	94	1	0	1	33.1858522748
258	95	14	3	11	22.2242352563
258	96	3	1	2	39.7016685481
258	100	4	0	4	17.1408738529
258	101	3	0	3	23.7698464031
258	102	12	4	8	12.135512295
258	103	18	0	18	28.8716327548
258	104	5	0	5	17.8878819142
258	105	3	0	3	15.9639540752
258	106	10	1	9	13.1664584744
258	109	1	0	1	33.1397639095
258	110	5	1	4	30.6016444921
258	111	4	0	4	23.4175218932
258	112	18	9	9	26.328790317
258	113	19	2	17	33.4275874355
258	114	1	0	1	24.8311747235
258	116	2	0	2	33.7738511743
258	118	1	0	1	37.379332243
258	120	6	4	2	22.1672107303
258	124	2	0	2	51.6408294888
258	129	1	0	1	31.3920741047
258	131	1	0	1	65.5376210644
258	133	1	0	1	37.2862834365
258	140	1	0	1	36.6041733348
258	142	17	7	10	45.2185446863
258	143	1	0	1	52.919369737
258	144	2	0	2	47.8768489148
258	145	1	0	1	43.4831218965
258	146	2	0	2	39.2279803943
258	169	0	0	0	43.2868820595
258	177	2	1	1	54.2449495046
258	183	10	1	9	66.8946296611
258	185	1	0	1	73.8619519735
258	186	2	0	2	63.7016356635
258	187	0	0	0	73.0164684555
258	188	2	0	2	70.4438810565
258	196	1	0	1	92.608203037
258	200	1	0	1	82.9898137274
258	206	1	0	1	60.2020029597
258	208	0	0	0	68.7065069149
258	209	1	0	1	65.468352304
258	213	1	0	1	73.0385339094
258	214	1	0	1	62.7826899241
258	220	4	0	4	85.9412378156
258	225	2	0	2	67.689534222
258	229	1	0	1	72.1606847516
258	232	0	0	0	60.7839859008
258	233	0	0	0	58.5262162678
258	235	1	0	1	53.0170553078
258	236	3	0	3	54.8598277327
258	237	1	0	1	57.1722988783
258	239	1	0	1	66.4055269088
258	242	2	0	2	101.889100804
258	245	79	11	68	15.6384411174
258	246	2	0	2	22.0647746405
258	247	1	0	1	37.0766399462
258	251	4	0	4	29.5726845916
258	253	5	1	4	33.1025569822
258	254	5	2	3	21.8151208728
258	255	9	5	4	12.1539115486
258	256	82	70	12	8.43442416619
258	257	739	330	409	6.59083468598
258	259	3	0	3	18.3152968959
258	260	42	0	42	9.61970894858
258	261	124	18	106	6.41118159581
258	262	28	3	25	21.0290820189
258	263	8	2	6	15.7424693077
258	264	251	12	239	7.37092498924
258	265	1	0	1	33.9840578159
258	266	0	0	0	42.3358757833
258	270	2	0	2	26.7627872624
258	271	3	0	3	48.5461474367
258	272	3	0	3	44.6843517472
258	274	4	0	4	23.414478585
258	275	3	0	3	31.0207327765
258	276	2	1	1	35.8669428894
258	277	231	0	231	28.965188818
258	279	14	0	14	19.9594776722
258	280	2	1	1	36.0191783715
258	281	4	0	4	25.6653874331
258	282	7	1	6	30.2125861418
258	283	3	2	1	17.8733414034
258	284	1	0	1	39.452220834
258	285	2	0	2	41.0320488623
258	287	5	0	5	36.9971856827
258	289	1	0	1	21.820898483
258	292	1	0	1	46.7384539085
258	293	3	0	3	44.1026176994
258	302	2	0	2	36.7079713715
258	303	106	25	81	20.4097811141
258	304	30	26	4	13.8310893045
258	305	202	19	183	13.0776236138
258	306	11	10	1	16.9163680684
258	307	882	0	882	9.89365780543
258	308	21	8	13	16.8356615626
258	309	271	112	159	7.66123990155
258	319	1	0	1	75.9553210679
258	375	1	0	1	72.6673915562
258	385	1	0	1	99.0526367243
258	408	0	0	0	113.291825473
258	415	1	0	1	103.533868585
258	416	1	0	1	118.903969516
258	464	1	0	1	76.6172370302
258	466	1	0	1	95.593932411
258	469	0	0	0	83.2851236078
258	471	1	0	1	77.6964003847
258	475	3	0	3	80.2201821501
258	488	1	0	1	92.4726016109
259	0	7	1	6	36.2127979953
259	1	78	22	56	41.7474389088
259	5	1	0	1	52.2550597975
259	13	2	0	2	40.1952433035
259	15	3	0	3	42.88337952
259	19	1	0	1	33.273604302
259	21	1	0	1	50.0478400975
259	23	1	0	1	48.8230078284
259	24	1	0	1	47.938042512
259	25	1	0	1	63.4047726103
259	28	6	0	6	36.7486387707
259	32	4	0	4	25.7581222743
259	34	1	0	1	59.6460486621
259	36	12	0	12	39.6266417737
259	39	1	0	1	29.5813918704
259	40	1	0	1	24.2736160889
259	41	2	0	2	45.6523400719
259	42	2	0	2	33.8923929666
259	46	1	0	1	72.1343080734
259	50	1	0	1	67.2677027191
259	53	1	0	1	75.5713559643
259	54	1	0	1	64.9443783088
259	70	4	1	3	37.2130656813
259	71	2	0	2	46.6544591401
259	72	1	0	1	34.8585677936
259	73	113	0	113	39.2389682554
259	74	13	1	12	42.6931938681
259	75	6	0	6	41.5270207948
259	76	12	2	10	39.959378455
259	78	8	0	8	42.3531420117
259	79	2	0	2	35.4668827863
259	81	6	5	1	36.8732483991
259	82	15	5	10	40.0403956118
259	83	2	0	2	39.9574392274
259	84	13	1	12	40.5017890197
259	85	3	0	3	43.6953292723
259	86	1	0	1	46.9098734006
259	87	8	2	6	44.0482074373
259	88	1	0	1	45.6873455629
259	89	3	0	3	27.6434503358
259	90	4	0	4	43.7464089868
259	92	8	5	3	32.2959018677
259	95	6	4	2	36.1424048732
259	96	3	0	3	43.002323587
259	100	1	0	1	33.1986826147
259	101	1	0	1	24.4509068948
259	102	3	0	3	27.66995769
259	103	4	1	3	42.1837966455
259	104	2	0	2	31.5242818358
259	110	2	0	2	45.1267509542
259	111	3	0	3	27.4069737088
259	112	8	1	7	40.4608031327
259	113	24	1	23	46.2941625597
259	115	0	0	0	27.2508035237
259	116	2	0	2	40.658727588
259	120	1	0	1	33.2417478215
259	122	1	0	1	32.1519121522
259	123	1	0	1	22.3536423765
259	127	1	0	1	55.0068847035
259	129	1	0	1	47.8602435136
259	140	1	0	1	50.8761240895
259	142	6	0	6	60.2593941515
259	143	1	0	1	68.5246703871
259	171	1	0	1	51.9410782986
259	172	1	0	1	61.6085148738
259	177	1	0	1	63.1867123741
259	183	5	0	5	51.5149226383
259	188	2	0	2	53.2209189522
259	193	1	1	0	64.5395480387
259	196	1	0	1	74.3183979135
259	207	4	0	4	45.0342504129
259	208	6	0	6	51.129704879
259	211	2	0	2	58.2303992797
259	212	4	1	3	38.2427870564
259	213	1	0	1	55.0441130255
259	214	2	0	2	45.7647476428
259	220	2	0	2	69.3959181816
259	224	1	0	1	45.6836557
259	225	1	0	1	49.3925350897
259	229	3	1	2	53.8455460653
259	232	2	0	2	42.470768451
259	234	1	0	1	43.5227354926
259	236	1	0	1	36.6236379363
259	237	2	0	2	39.0107466369
259	243	1	0	1	78.5507181337
259	244	1	0	1	85.2726279913
259	245	62	1	61	16.8840724868
259	247	2	1	1	29.2599852234
259	248	2	0	2	19.1352412797
259	249	1	0	1	19.1337178085
259	250	15	0	15	9.51456179986
259	251	6	0	6	25.5020210457
259	252	5	2	3	12.4042708388
259	253	5	0	5	20.2002065276
259	254	25	4	21	14.2591949095
259	255	42	12	30	6.6876949463
259	257	74	32	42	14.5274671097
259	258	5	2	3	18.3152968959
259	260	6	0	6	17.3409191939
259	262	456	429	27	5.4211379117
259	263	45	1	44	6.86132277302
259	264	57	30	27	10.9632743412
259	265	3	1	2	23.705188205
259	266	5	2	3	28.1103284018
259	268	1	0	1	34.8853235181
259	270	25	3	22	18.2057243405
259	271	1	0	1	30.9401780038
259	272	15	5	10	26.3690582298
259	274	134	24	110	5.23449628552
259	275	7	0	7	16.6501703327
259	276	5	1	4	18.780878069
259	277	1164	284	880	11.6468656412
259	279	89	82	7	7.00588769208
259	280	2	0	2	19.2058659194
259	281	48	1	47	7.95598900043
259	282	48	0	48	12.5703507685
259	283	4	1	3	16.122361308
259	284	14	3	11	21.4163588307
259	285	4	0	4	23.1645111737
259	286	11	0	11	13.0320534008
259	287	3	1	2	18.6846974721
259	288	5	2	3	22.7280216808
259	289	7	3	4	15.3607548538
259	290	2	0	2	24.7291977868
259	291	6	1	5	31.0899677985
259	292	1	0	1	28.9967716868
259	293	14	0	14	27.9574224437
259	294	1	0	1	37.8995068791
259	296	3	0	3	28.5958738057
259	302	4	1	3	21.5306713871
259	303	11	1	10	33.7616766225
259	304	3	0	3	31.2336453771
259	305	75	4	71	9.55433155838
259	306	1	0	1	26.484477973
259	307	48	2	46	20.7508468024
259	308	3	0	3	21.421915109
259	309	6	0	6	24.6302297639
259	341	1	1	0	62.0259076496
259	350	1	0	1	36.8674951398
259	408	0	0	0	128.257611083
259	465	0	0	0	108.356985424
259	466	1	0	1	113.046009679
259	469	1	0	1	100.410133649
259	471	1	0	1	95.8402263872
259	472	1	0	1	91.0468415089
259	487	1	0	1	106.818926719
259	503	1	0	1	114.841519849
259	515	1	0	1	166.503261654
260	0	7	1	6	24.078582016
260	1	132	0	132	34.3220268714
260	3	4	2	2	21.0167049371
260	5	5	1	4	44.1886078055
260	6	1	0	1	52.1634746014
260	7	2	0	2	28.5133121483
260	13	4	0	4	27.0460339121
260	15	2	0	2	31.3273322375
260	16	1	0	1	19.8146615119
260	18	3	0	3	23.9451999814
260	19	4	0	4	21.3197663162
260	21	1	0	1	40.6455449823
260	22	2	0	2	41.4506854688
260	24	1	0	1	36.7214973338
260	28	9	2	7	29.4973315028
260	32	41	15	26	14.3570314935
260	33	1	0	1	29.9309822094
260	34	1	0	1	44.0534794805
260	35	1	0	1	34.7527054332
260	36	50	5	45	23.5325364907
260	39	27	0	27	15.3957954807
260	40	14	8	6	10.1983299759
260	41	2	0	2	30.2133015889
260	42	11	3	8	18.749450487
260	46	1	0	1	60.7973559994
260	48	1	0	1	63.5198874158
260	49	1	1	0	48.0768363398
260	65	3	0	3	68.4210799217
260	69	1	0	1	62.8167872894
260	70	57	9	48	21.9061025926
260	71	18	0	18	30.2202118652
260	72	11	0	11	18.7790716623
260	73	669	283	386	22.3590475888
260	74	26	0	26	26.2416137562
260	75	27	8	19	24.5405194458
260	76	60	6	54	24.5187479096
260	77	5	3	2	18.7350118081
260	78	63	31	32	26.2013186119
260	79	69	53	16	18.7970716026
260	80	7	1	6	20.3560639728
260	81	38	2	36	20.7096233862
260	82	61	6	55	24.0761470482
260	83	25	0	25	23.3778301557
260	84	63	0	63	23.7073498906
260	85	7	2	5	28.242529599
260	86	9	3	6	30.8145244813
260	87	31	0	31	27.1940789267
260	88	8	2	6	28.9682332914
260	89	171	8	163	11.6449063665
260	90	5	1	4	29.83426523
260	92	30	9	21	17.457241471
260	94	2	0	2	23.5903292955
260	95	27	0	27	18.8095400747
260	96	16	3	13	30.7457434624
260	100	13	5	8	16.5459467044
260	101	9	1	8	14.1518628461
260	102	54	14	40	11.2047429249
260	103	38	0	38	24.8787412733
260	104	27	2	25	14.2086673919
260	105	55	6	49	10.0790512208
260	106	150	9	141	5.47130679544
260	107	1	0	1	38.0653881553
260	109	5	0	5	24.4579056462
260	110	5	1	4	27.7944645075
260	111	30	17	13	14.1662063017
260	112	50	11	39	23.1230364282
260	113	68	0	68	29.0788361737
260	114	4	0	4	23.7908505935
260	115	5	0	5	17.3039085004
260	116	1	0	1	25.8284600113
260	117	1	0	1	29.6324243161
260	118	2	0	2	29.6131448173
260	120	15	0	15	16.219583392
260	122	2	0	2	20.1844222383
260	123	5	4	1	9.84097310217
260	124	2	0	2	52.2022556556
260	127	1	0	1	37.7149815414
260	129	1	0	1	30.9719871806
260	134	1	0	1	38.074482599
260	135	1	0	1	58.1988499512
260	138	0	0	0	37.501326297
260	142	8	1	7	42.9290691217
260	146	1	0	1	34.2053607352
260	155	2	0	2	39.1820892855
260	156	1	0	1	36.682783125
260	164	3	0	3	37.4450009574
260	166	2	0	2	46.4803900413
260	169	3	0	3	34.0081383036
260	171	3	0	3	37.2638109006
260	172	2	0	2	45.3437791728
260	177	1	0	1	47.5663464358
260	181	1	0	1	57.4342039122
260	183	3	0	3	68.7613926855
260	190	1	0	1	67.7791375625
260	208	1	0	1	63.6494359293
260	212	1	0	1	51.7517308738
260	229	2	0	2	69.3027726112
260	236	0	0	0	52.883238234
260	244	1	0	1	101.92255902
260	245	434	116	318	6.3740158535
260	246	11	0	11	12.5473246539
260	247	4	0	4	28.0709430378
260	248	3	0	3	14.880527935
260	249	1	0	1	20.8896653253
260	250	8	3	5	12.4897073447
260	251	12	0	12	20.1654979122
260	252	1	1	0	18.352703434
260	253	3	0	3	25.9905390474
260	254	18	1	17	14.1113038439
260	255	8	1	7	10.9185983632
260	256	240	33	207	6.00627510182
260	257	961	196	765	4.37513422627
260	258	74	1	73	9.61970894858
260	259	4	1	3	17.3409191939
260	261	18	11	7	14.3624120653
260	262	25	1	24	17.4134784242
260	263	6	0	6	11.6066730541
260	264	79	11	68	10.1511148883
260	266	1	0	1	44.8936475905
260	270	1	0	1	31.5890186278
260	271	2	0	2	48.0765003679
260	272	4	1	3	42.1790383941
260	274	3	0	3	22.412065602
260	276	1	0	1	31.1744353645
260	277	139	18	121	28.9872257712
260	279	3	0	3	22.0571254632
260	281	2	1	1	22.5861645544
260	282	1	0	1	26.5583032198
260	283	1	0	1	24.3473538609
260	284	1	0	1	35.8676807752
260	285	1	0	1	40.2020943461
260	286	1	0	1	23.3180301789
260	289	3	0	3	27.0385269619
260	290	1	0	1	42.0493368019
260	292	1	0	1	42.3648239253
260	293	5	0	5	38.1842715281
260	295	1	0	1	36.0436461169
260	297	2	1	1	47.628443352
260	303	13	2	11	29.9284962887
260	304	1	0	1	22.0028330742
260	305	45	11	34	17.3731353959
260	306	2	0	2	26.3591351152
260	307	73	8	65	19.1675729134
260	308	1	0	1	25.2452710979
260	309	19	10	9	16.772685473
260	319	1	0	1	67.3400094277
260	345	1	0	1	67.2576870812
260	348	1	0	1	35.5750884517
260	375	1	0	1	65.1876808649
260	408	1	0	1	110.924707623
260	439	1	0	1	144.514398449
260	447	1	0	1	131.874411597
260	464	1	0	1	78.5651476024
260	469	1	0	1	83.5505445192
260	475	1	0	1	78.6891073559
260	496	1	0	1	88.2227536893
260	505	1	0	1	109.189938074
261	0	12	0	12	21.5251599383
261	1	345	75	270	25.9697233442
261	3	4	0	4	20.9971623609
261	5	3	0	3	36.4782720145
261	6	1	0	1	45.4953734679
261	7	7	0	7	25.3328617417
261	9	2	1	1	18.7227741301
261	13	4	1	3	25.8226903892
261	15	7	0	7	27.6518804091
261	18	2	0	2	24.3341874967
261	19	3	1	2	18.7185531421
261	21	3	0	3	34.278472271
261	23	1	0	1	33.2031423199
261	24	4	1	3	32.4892395972
261	28	42	7	35	20.9576478604
261	32	28	16	12	12.014733264
261	33	1	0	1	30.7859021392
261	35	1	0	1	34.8422582809
261	36	29	1	28	28.0797603512
261	39	18	4	14	17.153737109
261	40	1	0	1	13.240542765
261	41	2	0	2	32.8383509412
261	42	8	2	6	21.7388492976
261	46	2	0	2	56.5055211142
261	48	2	0	2	63.7148908717
261	49	3	0	3	46.8423133256
261	50	2	0	2	52.7733491682
261	55	1	0	1	62.0325640863
261	60	2	0	2	56.8013822128
261	62	1	0	1	73.9400863969
261	65	2	0	2	64.6534648559
261	67	1	0	1	60.1487951025
261	68	1	0	1	56.3734836239
261	70	5	1	4	35.6563892035
261	71	3	0	3	42.7260342771
261	72	2	1	1	32.1416903001
261	73	79	43	36	34.4826861384
261	74	3	0	3	38.8715980387
261	75	18	2	16	36.302721773
261	76	5	0	5	38.1111118791
261	78	7	1	6	39.1772291203
261	79	2	0	2	31.5007867571
261	81	7	0	7	33.9028623976
261	82	4	0	4	37.3061853165
261	84	9	0	9	35.9242921649
261	85	2	1	1	41.7205098523
261	86	1	0	1	43.6956928472
261	87	6	0	6	39.1278487161
261	88	4	0	4	41.0851280034
261	89	8	0	8	25.4844256177
261	90	1	0	1	43.9397920022
261	92	2	0	2	31.5444404515
261	95	4	0	4	28.6280739262
261	96	3	0	3	45.091668414
261	99	1	0	1	39.2938083793
261	102	3	0	3	18.5173599665
261	103	7	2	5	35.2777932581
261	104	1	0	1	24.2970869375
261	105	2	0	2	22.1724678626
261	106	2	1	1	18.8865537047
261	107	1	0	1	50.224103086
261	110	2	1	1	36.9280728776
261	112	5	1	4	32.7081719772
261	113	11	0	11	39.8367555214
261	116	1	0	1	39.6960455546
261	131	1	0	1	70.7143690313
261	140	1	0	1	42.9295259384
261	142	6	0	6	51.4034854903
261	144	1	0	1	54.2293100888
261	154	1	0	1	61.546886732
261	156	1	0	1	50.9860291949
261	171	1	0	1	50.9862631633
261	175	1	0	1	55.5979063314
261	177	1	0	1	60.5374920167
261	181	1	0	1	51.6461255607
261	182	1	0	1	68.1890601444
261	183	2	0	2	61.360417542
261	188	1	0	1	65.6679586811
261	190	1	1	0	58.2280169224
261	191	1	0	1	85.6557500253
261	208	4	0	4	66.924048325
261	220	1	0	1	80.7470642767
261	225	1	0	1	64.6658809484
261	229	1	0	1	68.8836378188
261	231	1	0	1	50.2286210745
261	233	1	0	1	55.6830000897
261	236	0	0	0	51.2485088542
261	239	0	0	0	62.831406202
261	242	0	0	0	97.2451657767
261	245	30	1	29	19.3492912058
261	247	2	0	2	39.5599297449
261	250	2	0	2	19.2245004116
261	251	3	1	2	32.9050422418
261	255	4	0	4	11.3383495783
261	256	13	6	7	14.707906035
261	257	103	6	97	10.1907767412
261	258	116	39	77	6.41118159581
261	259	2	1	1	15.7960422492
261	260	12	3	9	14.3624120653
261	262	8	1	7	19.8865801689
261	263	1	0	1	15.807185169
261	264	109	1	108	6.32338546294
261	265	1	0	1	27.8580872249
261	266	1	0	1	36.7303427634
261	267	1	0	1	32.7666554426
261	270	3	0	3	20.619614964
261	272	0	0	0	41.5647716814
261	274	1	0	1	20.3171249263
261	275	3	1	2	25.7491201263
261	276	1	0	1	34.4559481177
261	277	208	61	147	24.8953798889
261	279	10	0	10	15.3094555563
261	281	8	2	6	23.7135496129
261	282	1	0	1	28.3453881778
261	283	3	0	3	11.4910194436
261	285	1	0	1	37.0284185559
261	286	1	0	1	27.882489351
261	287	1	0	1	33.8870140817
261	288	1	0	1	32.6823956893
261	289	2	0	2	15.6520853303
261	290	1	0	1	36.2177769629
261	292	1	0	1	44.7887241917
261	293	6	2	4	43.3562207123
261	295	3	0	3	39.3753600347
261	296	0	0	0	42.016518836
261	303	71	23	48	18.5183680488
261	304	14	5	9	15.7533560161
261	305	253	57	196	7.94730167747
261	306	26	2	24	12.7069896877
261	307	730	593	137	5.63700544726
261	308	23	1	22	10.90423393
261	309	150	66	84	9.27747661402
261	315	1	0	1	51.5215460747
261	469	1	0	1	88.6519508406
261	474	1	0	1	104.92443174
261	488	1	0	1	96.8104350285
261	503	1	0	1	104.734262072
261	549	1	0	1	188.742762655
262	0	7	0	7	38.9355431648
262	1	97	23	74	45.7460252853
262	2	1	0	1	49.0312107218
262	5	2	1	1	56.2352485323
262	6	1	0	1	65.0986195342
262	7	1	0	1	43.2426421622
262	9	1	0	1	36.7977990154
262	13	4	1	3	42.6540185233
262	17	1	0	1	54.9505916308
262	19	2	0	2	35.9881573745
262	21	1	0	1	53.7027248508
262	28	6	0	6	40.7010463129
262	30	1	0	1	56.3663078009
262	32	5	0	5	28.3768812176
262	33	1	0	1	46.420757026
262	34	2	0	2	61.1671189863
262	35	1	0	1	51.090533164
262	36	39	8	31	40.7693939602
262	39	6	0	6	31.473494675
262	41	1	0	1	47.2038578745
262	42	2	0	2	35.4822120796
262	46	2	0	2	75.4127852248
262	48	1	0	1	80.1942725126
262	54	1	0	1	66.3495845337
262	55	2	0	2	79.7865566012
262	70	33	4	29	34.897510615
262	71	2	0	2	44.8098175959
262	72	1	0	1	33.0238678904
262	73	331	0	331	37.9020158412
262	74	13	2	11	40.9247113911
262	75	25	0	25	40.2679918938
262	76	97	15	82	37.6373575252
262	78	34	4	30	40.3827814457
262	79	9	0	9	34.0211160211
262	80	4	0	4	35.017748138
262	81	25	1	24	35.0329515995
262	82	38	10	28	38.0017953731
262	83	13	0	13	38.3387757948
262	84	50	24	26	39.0583861112
262	85	7	0	7	41.2988210642
262	86	5	0	5	44.8254155299
262	87	7	2	5	42.6066796373
262	88	10	2	8	44.0923091933
262	89	14	1	13	26.0588203955
262	90	2	0	2	40.6808766093
262	92	14	1	13	29.9419930262
262	95	5	0	5	35.8915725413
262	96	11	0	11	39.4043526007
262	97	1	0	1	32.3899147426
262	100	1	0	1	33.924573013
262	101	1	0	1	21.1462597906
262	102	3	1	2	28.4879164739
262	103	16	0	16	41.4878357494
262	104	1	0	1	31.4105249427
262	105	3	0	3	26.8276739787
262	107	2	0	2	52.7075452677
262	109	5	1	4	34.9414508142
262	110	5	0	5	44.8096750542
262	111	13	2	11	24.7304602092
262	112	11	2	9	40.1253340606
262	113	30	2	28	45.3194939654
262	114	1	0	1	41.1930742018
262	115	1	0	1	23.630136979
262	116	1	0	1	38.0335616241
262	118	1	0	1	41.8030832529
262	120	3	1	2	32.1857410483
262	122	5	0	5	28.8093863259
262	123	1	0	1	19.9218457851
262	131	1	0	1	83.9257289499
262	140	4	1	3	50.3269939742
262	142	16	1	15	59.8860268263
262	144	0	0	0	60.4749251692
262	165	1	0	1	66.1740108754
262	166	1	0	1	54.8592032696
262	171	1	0	1	49.0439207768
262	173	1	0	1	69.5270397001
262	177	3	0	3	60.6328891364
262	182	3	0	3	61.2503539591
262	183	28	1	27	53.1880503803
262	186	2	0	2	46.8431522543
262	187	1	0	1	54.7166441508
262	188	2	1	1	53.5032175584
262	196	1	0	1	72.0795835237
262	198	1	0	1	83.954669566
262	206	2	0	2	39.174882052
262	207	4	0	4	42.0520192233
262	208	8	1	7	47.6778031058
262	209	3	0	3	44.5451851117
262	212	4	0	4	35.1524470585
262	213	5	0	5	52.097470035
262	216	1	0	1	67.8976128186
262	220	8	1	7	70.1264592125
262	224	1	1	0	43.4706419057
262	225	1	0	1	47.2737615251
262	229	4	0	4	51.9982606752
262	231	1	0	1	32.7906009403
262	234	2	0	2	42.3322519616
262	235	2	0	2	34.7946918048
262	236	2	0	2	35.4751970867
262	237	1	0	1	36.4346064562
262	239	2	0	2	46.7319020072
262	245	290	64	226	14.965290779
262	246	8	0	8	17.8276768546
262	247	7	0	7	24.0113758433
262	248	2	1	1	14.9476465888
262	249	17	0	17	13.8797050882
262	250	61	2	59	6.14865369735
262	251	17	3	14	20.9700963815
262	252	50	3	47	7.06875498311
262	253	37	12	25	14.8130864938
262	254	49	4	45	9.93077567094
262	255	44	8	36	8.93611869011
262	256	11	1	10	23.0965308084
262	257	138	2	136	15.8478698263
262	258	5	0	5	21.0290820189
262	259	199	2	197	5.4211379117
262	260	11	1	10	17.4134784242
262	261	4	1	3	19.8865801689
262	263	141	30	111	5.84487714007
262	264	60	2	58	14.1402053317
262	265	5	1	4	28.0654757999
262	266	8	0	8	30.9288361453
262	268	3	0	3	37.0560398931
262	270	10	0	10	23.1610435791
262	271	9	1	8	31.151054199
262	272	24	3	21	24.7691898638
262	273	3	0	3	14.1106532869
262	274	116	3	113	6.98214682427
262	275	10	0	10	20.0629488005
262	276	15	3	12	14.8499166514
262	277	1573	68	1505	13.472133826
262	278	2	0	2	33.0621239256
262	279	36	12	24	12.1130906704
262	280	9	0	9	20.8088236486
262	281	190	1	189	5.1763268938
262	282	121	2	119	9.33731991518
262	283	3	0	3	21.5285535088
262	284	33	7	26	18.6998599195
262	285	4	0	4	23.2353509104
262	286	48	2	46	8.03065122554
262	287	7	2	5	17.4408640556
262	288	1	0	1	25.2817997453
262	289	9	0	9	20.6759318467
262	290	4	0	4	26.383547743
262	291	7	1	6	28.5649678675
262	292	4	0	4	25.7450673907
262	293	27	2	25	23.4780269656
262	294	1	0	1	32.8782718138
262	295	1	0	1	19.8426328244
262	296	5	2	3	23.2351466896
262	297	1	0	1	33.774923435
262	302	6	4	2	16.5893036135
262	303	13	2	11	38.2829693627
262	305	74	3	71	14.6732692761
262	306	2	0	2	31.3833039951
262	307	54	1	53	25.2158947451
262	309	14	4	10	28.0695031899
262	319	1	0	1	75.1541588801
262	320	1	0	1	80.778591522
262	338	1	0	1	60.7091703534
262	345	1	0	1	52.0880752453
262	350	1	0	1	31.4682586569
262	469	1	0	1	100.943099308
262	471	2	0	2	97.4627131631
262	473	0	0	0	94.4140880961
262	475	1	0	1	95.69691003
262	480	0	0	0	99.3704910085
262	488	2	0	2	112.233658003
262	503	1	0	1	114.56978249
263	1	67	3	64	41.0824790645
263	3	3	0	3	31.1686581519
263	6	1	0	1	60.179234695
263	7	1	0	1	37.806697487
263	13	2	0	2	37.0453158982
263	15	2	0	2	40.4977609659
263	18	1	0	1	34.367217838
263	28	3	1	2	36.0313588302
263	32	2	0	2	22.9186253287
263	36	18	1	17	34.9252759199
263	39	8	0	8	25.7387722232
263	42	2	0	2	29.6785337521
263	46	1	0	1	70.1047693179
263	55	2	0	2	74.1853320403
263	68	1	0	1	66.0167991869
263	70	30	2	28	30.3909252368
263	71	6	1	5	39.9571090281
263	72	1	0	1	28.1432563275
263	73	318	0	318	32.7185845319
263	74	17	1	16	36.014234434
263	75	12	1	11	35.0465918941
263	76	103	54	49	33.1393978502
263	77	2	1	1	28.5328625033
263	78	29	5	24	35.6131675812
263	79	9	0	9	28.8909869784
263	80	4	0	4	30.0525766018
263	81	12	2	10	30.160781096
263	82	28	3	25	33.2791620695
263	83	8	1	7	33.3253443228
263	84	45	1	44	33.938927695
263	85	6	1	5	36.8673119425
263	86	3	0	3	40.1463131942
263	87	9	1	8	37.4929483139
263	88	4	0	4	39.0742177284
263	89	13	0	13	20.9872409714
263	90	2	0	2	36.8945329057
263	92	14	0	14	25.4614641889
263	94	1	0	1	26.2064377987
263	95	6	1	5	30.2361793893
263	96	8	0	8	36.2572145425
263	99	1	0	1	43.0092668143
263	101	3	1	2	17.6851389495
263	102	2	0	2	22.6440552719
263	103	13	0	13	36.0019602617
263	105	1	0	1	21.2322788585
263	106	1	0	1	16.4227290293
263	108	1	0	1	31.4214474557
263	109	1	0	1	31.14914308
263	110	1	0	1	39.1920882768
263	111	17	5	12	20.5456510853
263	112	12	3	9	34.5053882223
263	113	17	2	15	39.9632758474
263	115	2	0	2	20.5773374726
263	116	1	0	1	33.8040187932
263	119	1	0	1	40.8702683494
263	120	5	1	4	26.837705263
263	123	2	0	2	15.4961904543
263	131	1	0	1	78.094103775
263	133	1	0	1	48.3113870692
263	134	1	0	1	49.5421624462
263	135	1	0	1	69.2031181889
263	142	3	0	3	54.3050659987
263	144	1	0	1	55.1472257329
263	155	1	0	1	45.8835606136
263	164	1	0	1	46.2739133542
263	172	1	0	1	54.8455965866
263	181	1	0	1	46.2980470577
263	183	5	0	5	58.0269902617
263	185	1	0	1	63.4783901453
263	188	1	0	1	58.9985353096
263	206	1	0	1	44.6923764101
263	208	5	0	5	53.1417174679
263	209	1	0	1	50.2224130886
263	212	1	0	1	40.7995301994
263	216	1	0	1	73.0899670866
263	220	2	0	2	75.4636560548
263	222	0	0	0	69.5393481582
263	229	1	0	1	57.8397047076
263	234	1	0	1	48.1495634606
263	236	1	0	1	41.2817410589
263	239	1	0	1	52.5684756355
263	245	350	52	298	10.0671355608
263	246	10	1	9	14.4893209358
263	247	4	0	4	24.6166298487
263	248	4	0	4	12.9904615323
263	249	7	3	4	14.8963288265
263	250	128	77	51	3.67317572969
263	251	12	3	9	19.5383154556
263	252	17	1	16	9.29116648637
263	253	7	1	6	17.8900745634
263	254	57	33	24	8.58964481969
263	255	56	27	29	4.54768426201
263	256	9	1	8	17.2517107859
263	257	223	26	197	10.1111632839
263	258	18	0	18	15.7424693077
263	259	49	0	49	6.86132277302
263	260	7	0	7	11.6066730541
263	261	3	0	3	15.807185169
263	262	506	243	263	5.84487714007
263	264	25	17	8	9.56157824595
263	266	5	0	5	34.9187125048
263	270	3	0	3	24.4698945339
263	271	1	0	1	36.6262347707
263	272	10	0	10	30.6036143299
263	273	2	1	1	19.95502252
263	274	19	1	18	11.2775447014
263	275	1	0	1	23.5066184937
263	276	4	1	3	20.310013547
263	277	539	0	539	18.0255624728
263	279	10	6	4	13.4159619715
263	280	4	0	4	25.5872801333
263	281	45	28	17	10.9958785726
263	282	31	0	31	15.1369310033
263	284	12	1	11	24.5008683827
263	285	1	0	1	28.7219161754
263	286	13	4	9	12.8164508457
263	287	2	1	1	23.2143768247
263	291	1	0	1	34.3628461834
263	293	7	0	7	28.3605176976
263	295	1	0	1	25.2927857659
263	296	1	0	1	26.21034543
263	300	1	0	1	23.0025063597
263	303	2	0	2	34.300213452
263	305	58	14	44	12.7513342409
263	307	22	1	21	21.4042221932
263	308	1	0	1	24.3262340114
263	309	8	0	8	23.1155870063
263	332	0	0	0	64.4994848241
263	345	1	0	1	57.2935346804
263	350	1	0	1	32.9402662579
263	379	0	0	0	107.623315914
263	507	1	0	1	196.824602723
263	573	0	0	0	88.162348678
264	0	6	0	6	25.254467857
264	1	222	24	198	31.6683878924
264	2	1	0	1	35.3181673749
264	3	3	0	3	23.7297033857
264	5	3	0	3	42.1356976028
264	7	6	0	6	29.4347220582
264	13	4	1	3	29.2370689371
264	15	5	3	2	31.9894629596
264	16	1	1	0	21.4126842584
264	18	2	0	2	27.0778833904
264	19	4	0	4	22.3129030524
264	20	1	0	1	43.4772330388
264	21	2	0	2	39.5645007378
264	24	2	0	2	37.1111485186
264	26	1	1	0	47.6729003033
264	28	19	0	19	26.6162212291
264	32	19	2	17	14.8000705568
264	33	1	0	1	33.5732198665
264	35	2	0	2	38.0136074223
264	36	36	4	32	29.2960831328
264	39	23	0	23	18.8549893109
264	41	0	0	0	34.9861223016
264	42	10	0	10	23.3010593934
264	46	3	0	3	61.3849903465
264	47	1	0	1	78.2133629444
264	48	2	0	2	67.1638886768
264	49	2	0	2	50.6637798299
264	50	3	0	3	56.3196089199
264	52	1	0	1	59.2654536399
264	53	2	1	1	65.4938801797
264	55	4	2	2	66.1789164939
264	58	1	0	1	67.1957142981
264	65	2	0	2	69.4191142432
264	70	15	0	15	32.0562279941
264	71	6	1	5	40.1744305625
264	72	4	1	3	28.8946671928
264	73	218	67	151	32.1384823242
264	74	24	0	24	36.2145430212
264	75	19	0	19	34.2020690665
264	76	32	0	32	34.6684176343
264	77	2	0	2	28.7725598032
264	78	18	1	17	36.2638063413
264	79	13	0	13	28.7457536986
264	80	1	0	1	30.401185692
264	81	12	2	10	30.7999924828
264	82	21	3	18	34.1839603508
264	83	9	3	6	33.3209388881
264	84	31	0	31	33.5317338746
264	85	7	0	7	38.3879776314
264	86	2	0	2	40.8689695791
264	87	1	0	1	36.9421616966
264	88	6	0	6	38.7925670187
264	89	11	2	9	21.7957058098
264	90	5	2	3	39.8850925198
264	92	4	0	4	27.5552291151
264	93	1	0	1	35.1384686608
264	94	1	0	1	32.1327739283
264	95	6	1	5	27.4696668681
264	96	2	0	2	40.4700336769
264	100	3	1	2	23.3958388113
264	102	10	1	9	17.9699987949
264	103	13	2	11	33.947626126
264	104	4	0	4	22.8641591452
264	105	5	2	3	19.6260103923
264	106	7	1	6	15.4585368896
264	109	2	0	2	34.4050147897
264	110	5	1	4	36.2803078309
264	111	3	1	2	23.8385316798
264	112	15	2	13	31.7598854438
264	113	29	0	29	38.3620804504
264	115	1	0	1	25.9212122181
264	116	1	1	0	35.9640498415
264	120	3	0	3	25.9710110822
264	122	1	0	1	29.6477185502
264	123	4	2	2	19.0008947616
264	131	2	0	2	72.6415913013
264	134	2	0	2	46.1722308459
264	135	1	0	1	67.0777019671
264	141	1	0	1	79.9010769675
264	142	13	1	12	51.2438809147
264	144	1	0	1	53.2769855593
264	146	2	0	2	43.8083995319
264	151	1	0	1	65.6945327076
264	156	1	0	1	46.5096034919
264	168	2	0	2	51.6352061096
264	171	1	0	1	47.4081922746
264	177	0	0	0	57.6654371961
264	182	2	1	1	67.6051247088
264	183	7	0	7	60.3053318433
264	185	1	0	1	66.9448725385
264	186	2	0	2	56.5674479186
264	187	0	0	0	65.7302613759
264	190	1	0	1	58.4213890003
264	192	1	0	1	80.4581024162
264	205	1	0	1	52.0178612099
264	208	5	1	4	61.7034718928
264	209	2	0	2	58.2836641135
264	212	1	0	1	48.9839960135
264	214	1	0	1	55.991630383
264	220	2	0	2	79.0297071224
264	222	1	0	1	72.1521846826
264	229	1	0	1	64.8007708478
264	231	1	0	1	45.8260928317
264	232	0	0	0	53.4324361105
264	237	1	0	1	49.9125463782
264	238	1	0	1	54.2366672776
264	239	1	0	1	59.0347071688
264	245	78	23	55	13.8317792151
264	246	2	1	1	20.1835544852
264	250	5	1	4	12.9104513049
264	251	3	0	3	26.9195139785
264	252	1	0	1	18.8516860032
264	253	1	0	1	27.4493041759
264	254	4	2	2	17.2470622624
264	255	70	5	65	5.25276509488
264	256	35	4	31	12.9734460161
264	257	497	170	327	5.84743229751
264	258	149	11	138	7.37092498924
264	259	15	0	15	10.9632743412
264	260	32	0	32	10.1511148883
264	261	54	5	49	6.32338546294
264	262	54	16	38	14.1402053317
264	263	25	6	19	9.56157824595
264	266	3	0	3	35.9401128201
264	268	1	0	1	43.3743723899
264	270	6	1	5	21.5949689869
264	271	1	0	1	41.2944668775
264	272	4	0	4	37.3267354702
264	273	3	1	2	27.2088626135
264	274	6	1	5	16.0435694723
264	275	2	0	2	24.4010597591
264	276	5	0	5	28.9542355403
264	277	424	45	379	21.7045109784
264	278	0	0	0	41.4571021387
264	279	18	2	16	13.109152393
264	281	11	0	11	18.4913259722
264	282	12	0	12	23.0928569727
264	283	4	0	4	14.2632486769
264	284	7	0	7	32.233549872
264	285	6	2	4	33.7155175314
264	286	1	0	1	21.9875753151
264	287	4	1	3	29.6347467646
264	289	2	0	2	16.9355813028
264	292	1	0	1	39.6426609984
264	293	15	3	12	37.5567430435
264	295	4	0	4	33.9332681739
264	300	1	0	1	32.2974084053
264	303	63	0	63	24.748637942
264	304	6	0	6	20.5116773064
264	305	628	44	584	7.29353639606
264	306	4	0	4	18.943980015
264	307	281	2	279	11.9599635868
264	308	6	2	4	16.1310567262
264	309	57	15	42	13.9402726264
264	310	1	0	1	51.0582636667
264	329	2	0	2	59.9395702352
264	400	1	0	1	124.163992
264	415	1	0	1	109.51596091
264	464	3	0	3	83.889579725
264	465	1	0	1	98.2651740722
264	471	4	0	4	85.0358033844
264	476	2	0	2	72.2742934285
264	485	1	0	1	117.35524171
264	488	1	0	1	99.8153029991
264	491	1	0	1	95.9963269486
264	503	1	0	1	105.416646485
265	1	55	2	53	46.2196879791
265	3	1	0	1	48.2454795613
265	5	2	0	2	55.4394321209
265	7	1	0	1	50.6697204065
265	15	4	0	4	52.3292347944
265	17	1	0	1	61.1480489951
265	28	8	1	7	42.3895200702
265	32	1	0	1	39.6412603434
265	36	4	0	4	55.8828661688
265	39	1	0	1	44.9556471607
265	47	1	0	1	98.0127145533
265	59	1	0	1	100.148805915
265	70	1	0	1	59.9770625645
265	73	26	0	26	60.7045959403
265	74	4	0	4	64.6788772803
265	75	4	1	3	62.7926511743
265	76	2	0	2	62.6794292413
265	78	4	1	3	64.6139364219
265	80	1	0	1	58.7854379654
265	81	1	0	1	59.1054464467
265	82	5	0	5	62.4363274229
265	84	3	0	3	62.0843376098
265	85	1	0	1	66.4351566315
265	87	4	0	4	65.5205144362
265	88	2	1	1	67.3494734371
265	89	2	0	2	49.9010497896
265	92	1	0	1	55.1984423043
265	95	3	0	3	55.8955747257
265	96	2	0	2	66.6379109104
265	100	1	0	1	51.1242301803
265	103	2	0	2	62.4559209817
265	111	1	0	1	50.6675078253
265	112	2	0	2	60.1251959936
265	113	3	0	3	66.9153962945
265	120	1	0	1	54.5362098092
265	142	3	0	3	79.2006114795
265	147	1	0	1	97.4836547411
265	166	1	0	1	82.3871424916
265	181	1	0	1	27.7023352778
265	183	28	10	18	34.746509562
265	184	9	0	9	27.1179318688
265	185	1	0	1	43.3039674903
265	186	4	2	2	35.8529637579
265	188	3	0	3	41.996638343
265	190	7	0	7	30.391352175
265	208	0	0	0	57.009098644
265	213	0	0	0	58.0574392068
265	214	1	0	1	54.5104584262
265	219	1	0	1	61.5194645114
265	220	3	1	2	54.9748768557
265	225	1	0	1	49.2441109228
265	229	1	0	1	51.8885527681
265	238	1	0	1	36.8085581141
265	242	0	0	0	73.194983776
265	245	1	0	1	39.9790975191
265	251	0	0	0	49.0044874241
265	254	1	0	1	37.8195519639
265	256	0	0	0	41.4265558058
265	257	1	0	1	34.3597053528
265	259	3	2	1	23.705188205
265	260	1	0	1	38.4377962131
265	261	2	1	1	27.8580872249
265	262	8	0	8	28.0654757999
265	263	2	0	2	30.3808656858
265	264	6	0	6	28.5954535742
265	266	273	70	203	11.2357156772
265	267	70	0	70	6.4613437743
265	268	41	17	24	18.7056554941
265	269	33	6	27	10.0613493263
265	270	318	9	309	7.23847266241
265	271	25	7	18	25.0642123336
265	272	12	0	12	29.7580379428
265	273	3	0	3	27.0327588808
265	274	14	1	13	21.393022056
265	275	288	166	122	9.34002191953
265	276	2	0	2	33.2389012399
265	277	1548	40	1508	17.0095015785
265	278	4	0	4	21.155909097
265	279	6	2	4	16.9987424339
265	280	30	6	24	15.3419797112
265	281	15	1	14	26.2347607627
265	282	18	5	13	28.1796238433
265	283	4	4	0	16.8040917038
265	284	5	1	4	30.9294018706
265	285	7	3	4	21.9289525101
265	288	29	1	28	11.1106910063
265	289	35	9	26	12.2063864436
265	290	12	0	12	15.7738176956
265	293	8	1	7	42.0794262879
265	294	1	0	1	53.6353393784
265	297	1	0	1	51.4273115998
265	303	7	0	7	36.3064849481
265	305	16	1	15	21.3546271807
265	306	1	0	1	28.1421600938
265	307	12	0	12	28.3031235857
265	308	3	1	2	21.9265881563
265	309	1	0	1	35.792689243
265	310	0	0	0	65.50674324
265	319	1	0	1	102.940596129
265	338	2	0	2	88.0403262575
265	375	1	0	1	71.2803506539
265	379	1	0	1	134.806804864
265	465	0	0	0	124.063744585
265	467	1	0	1	115.505161812
265	471	1	0	1	107.786704779
265	477	1	0	1	118.954733264
265	577	1	0	1	107.653619102
266	0	1	0	1	57.6241538304
266	1	49	19	30	57.154493139
266	5	2	0	2	66.5575604207
266	7	1	0	1	60.8500545215
266	19	1	0	1	55.0303133342
266	21	1	0	1	66.3397153501
266	28	4	0	4	53.1353684304
266	32	1	0	1	48.7434157629
266	35	1	0	1	71.0700685783
266	36	5	1	4	64.6813066
266	39	1	0	1	53.8093942988
266	41	1	0	1	69.5503173144
266	46	1	0	1	88.7863553537
266	47	2	0	2	108.784044868
266	53	1	0	1	87.8843921532
266	55	1	0	1	96.2715862307
266	70	1	0	1	65.3092511913
266	73	98	1	97	67.1663760021
266	74	3	1	2	70.7580276856
266	75	3	0	3	69.4013425096
266	76	2	0	2	68.0573927886
266	78	5	1	4	70.4537537144
266	79	3	0	3	63.4609079391
266	81	11	0	11	64.9637803212
266	82	3	0	3	68.1482963496
266	83	2	0	2	67.9891974205
266	84	16	1	15	68.4684497385
266	85	1	0	1	71.7858720863
266	87	4	0	4	71.996949048
266	88	1	0	1	73.6916899166
266	90	1	0	1	71.5583817529
266	92	6	1	5	60.379169218
266	95	1	0	1	63.3149140322
266	96	4	1	3	70.3098345637
266	98	1	0	1	78.7091548369
266	102	1	0	1	53.8952604799
266	103	3	0	3	69.6643225362
266	110	3	0	3	72.1935179082
266	111	1	0	1	55.3843862856
266	112	3	0	3	67.6301043924
266	113	10	1	9	73.9522399246
266	120	1	0	1	61.0788106121
266	135	1	0	1	102.932333856
266	142	6	0	6	87.1839533012
266	146	1	0	1	79.0650541745
266	154	1	0	1	96.1785752139
266	171	1	0	1	79.8668006886
266	181	7	1	6	16.4706941878
266	182	3	0	3	31.6672351282
266	183	146	2	144	24.6325888606
266	184	40	1	39	17.5837490067
266	185	3	0	3	32.4832714803
266	186	19	2	17	24.6177052591
266	187	1	0	1	35.7405203512
266	188	5	0	5	30.7929819407
266	190	28	4	24	23.1775901588
266	191	1	0	1	52.0695931706
266	193	1	0	1	43.3821087464
266	196	3	0	3	61.6467507777
266	202	1	0	1	54.0144017409
266	204	1	0	1	41.1463152572
266	207	3	2	1	40.8608732382
266	208	13	4	9	48.5574181756
266	209	4	1	3	42.3599575358
266	212	3	0	3	36.604513329
266	213	2	0	2	48.6742794775
266	214	2	1	1	47.2183027623
266	216	1	0	1	41.0132317245
266	220	6	0	6	44.3632670436
266	222	1	0	1	36.5716999186
266	223	0	0	0	40.5460645699
266	225	4	1	3	39.3072380106
266	229	4	0	4	41.4540306032
266	231	2	0	2	28.9367267772
266	234	1	0	1	29.8697314505
266	235	2	1	1	19.9402244957
266	236	16	0	16	25.0742074683
266	237	3	0	3	34.2205918266
266	238	1	0	1	25.8864310403
266	239	1	0	1	34.4871612855
266	242	0	0	0	62.1236493739
266	243	2	0	2	56.0222201082
266	245	11	2	9	44.9807634877
266	247	4	0	4	51.9580892199
266	250	1	0	1	36.8967777847
266	251	5	0	5	51.3417807126
266	252	1	0	1	36.5772386584
266	253	2	0	2	40.115818172
266	254	7	0	7	40.7737490853
266	255	1	0	1	34.0048951523
266	256	2	0	2	48.8772218227
266	257	3	0	3	41.2809914123
266	259	2	0	2	28.1103284018
266	260	1	0	1	44.8936475905
266	262	7	1	6	30.9288361453
266	263	1	0	1	34.9187125048
266	264	2	0	2	35.9401128201
266	265	125	9	116	11.2357156772
266	267	99	24	75	4.77451927163
266	268	310	81	229	7.81494692794
266	269	35	1	34	7.41228059468
266	270	71	0	71	17.1667968582
266	271	127	0	127	15.2808771107
266	272	25	0	25	22.9079422046
266	273	3	1	2	24.3593398439
266	274	9	0	9	24.0021872699
266	275	158	6	152	11.6383800116
266	276	4	2	2	30.7518196814
266	277	1310	907	403	17.5374417042
266	278	47	9	38	10.3325235773
266	279	9	0	9	22.9298083765
266	280	80	3	77	11.272275362
266	281	13	1	12	27.3720942421
266	282	8	0	8	27.4587504144
266	284	13	1	12	26.6019605759
266	285	20	1	19	15.1861811584
266	287	11	0	11	20.9679038237
266	288	105	0	105	5.73465245443
266	289	5	0	5	21.7290087388
266	290	54	15	39	7.60319494222
266	291	2	0	2	29.263811173
266	292	3	1	2	31.9377945055
266	293	6	0	6	38.1310473104
266	294	1	0	1	49.5534531194
266	295	1	0	1	32.0805590832
266	296	1	0	1	46.1672730142
266	303	4	1	3	47.2707472561
266	305	9	4	5	29.2589099453
266	307	4	0	4	38.2212299513
266	308	1	0	1	32.5598736285
266	309	1	0	1	45.3904284345
266	321	1	0	1	97.1480680681
266	323	1	0	1	104.443372487
266	402	1	0	1	162.366203733
266	406	0	0	0	154.211322442
266	469	1	0	1	125.380679897
266	471	3	2	1	118.077898972
266	556	1	0	1	164.522909339
267	0	2	0	2	53.3465900159
267	1	18	2	16	52.4860061874
267	13	1	0	1	57.7768625987
267	15	1	0	1	58.2364109297
267	23	1	0	1	62.0240694412
267	28	3	0	3	48.5338890473
267	30	1	0	1	72.6466967092
267	36	1	0	1	60.8271328862
267	46	1	0	1	84.0818473164
267	70	2	0	2	62.8287301644
267	73	26	1	25	64.2370498462
267	74	2	0	2	67.9908572472
267	75	2	0	2	66.418627722
267	76	0	0	0	65.5662877329
267	77	1	0	1	60.4445234364
267	78	3	0	3	67.7822815946
267	83	1	0	1	65.1746966745
267	84	4	0	4	65.5733910214
267	85	1	0	1	69.3155471095
267	88	1	0	1	70.8251896522
267	92	2	0	2	57.943530982
267	99	1	0	1	71.6619767848
267	110	1	0	1	68.7922070452
267	112	2	0	2	64.2873726564
267	131	1	0	1	103.283465611
267	142	5	0	5	83.680523011
267	146	1	0	1	76.0804057834
267	181	1	0	1	21.2436600595
267	183	30	0	30	28.8415507685
267	184	11	1	10	21.4498375909
267	185	1	0	1	37.0589343338
267	186	3	0	3	29.3916571855
267	187	2	0	2	40.4965679312
267	190	2	0	2	25.9172459058
267	191	0	0	0	56.8438004016
267	194	1	0	1	48.1913444029
267	208	2	0	2	52.0013412736
267	220	1	0	1	48.8478531493
267	225	2	0	2	43.4390824104
267	227	1	0	1	39.1172458756
267	229	4	0	4	45.8311049845
267	234	1	0	1	34.1849110269
267	242	0	0	0	66.8264264787
267	245	4	0	4	42.5406207364
267	250	1	0	1	34.9121344268
267	253	1	0	1	39.8599715192
267	254	1	0	1	39.1261386449
267	260	1	0	1	41.8815637822
267	262	5	0	5	29.1953969043
267	263	1	0	1	32.571128386
267	265	82	0	82	6.4613437743
267	266	322	44	278	4.77451927163
267	268	55	8	47	12.3744136825
267	269	39	4	35	6.6432980103
267	270	33	10	23	12.6727791544
267	271	27	4	23	19.2312352546
267	272	4	1	3	25.4178602991
267	273	1	0	1	24.8902906543
267	274	3	0	3	22.2195700485
267	275	80	0	80	9.14450057944
267	276	1	0	1	31.3162440653
267	277	539	0	539	16.3717812224
267	278	10	0	10	14.8495979257
267	279	3	0	3	19.8335568615
267	280	22	1	21	11.8996569186
267	281	3	1	2	26.2867342874
267	282	11	0	11	27.1777738903
267	283	1	0	1	22.3366818885
267	284	2	0	2	27.9486688104
267	285	3	1	2	17.4731362833
267	287	1	0	1	22.078725108
267	288	48	34	14	6.34090633202
267	289	3	0	3	17.4212286299
267	290	6	2	4	10.3790411455
267	291	2	0	2	31.9928196436
267	293	1	0	1	39.440979706
267	296	0	0	0	46.526778519
267	303	1	0	1	42.5883464709
267	305	9	0	9	25.5780654311
267	306	4	1	3	34.3312082287
267	307	7	0	7	33.8934872176
267	308	1	0	1	27.9752279822
267	309	3	0	3	41.196557102
267	460	1	0	1	128.33113062
267	469	1	0	1	121.32621775
267	471	1	0	1	113.67165092
267	495	1	0	1	138.455298286
267	556	1	0	1	163.195638506
267	573	0	0	0	120.69334364
268	0	2	0	2	65.4267477809
268	1	46	4	42	64.8589800969
268	2	1	0	1	74.4401037361
268	3	1	0	1	65.4083344536
268	5	1	0	1	74.1450873653
268	13	2	0	2	69.8448340627
268	15	1	0	1	70.5016931053
268	21	1	0	1	74.0425860312
268	23	1	0	1	74.3887717796
268	24	1	0	1	74.4741729507
268	26	2	0	2	85.6490852987
268	28	1	0	1	60.8981215071
268	29	1	0	1	88.5733451859
268	32	3	0	3	56.4637419999
268	35	0	0	0	78.8735798432
268	36	6	1	5	72.3162258381
268	39	1	0	1	61.4764610307
268	42	1	0	1	66.0637376029
268	43	1	0	1	114.794331614
268	47	1	0	1	116.551530207
268	51	1	0	1	91.56679915
268	69	1	0	1	109.334083075
268	70	4	1	3	71.848957709
268	71	4	0	4	81.5031098177
268	73	81	3	78	74.1185084804
268	74	6	0	6	77.5533575542
268	75	5	1	4	76.3944996671
268	76	3	1	2	74.5971031342
268	78	5	0	5	77.1600477463
268	79	2	0	2	70.3521441623
268	81	4	0	4	71.7086358405
268	82	11	0	11	74.8183782034
268	83	5	2	3	74.8360373053
268	84	5	0	5	75.386633851
268	85	5	1	4	78.292001191
268	86	2	0	2	81.6810115213
268	87	4	0	4	78.9319371272
268	88	3	0	3	80.5707056132
268	89	2	1	1	62.5093826797
268	90	1	0	1	77.6934373694
268	92	3	0	3	66.8960519291
268	95	3	0	3	70.597055224
268	96	2	0	2	76.0963638145
268	100	1	0	1	66.7576942974
268	102	2	0	2	61.3435686158
268	109	1	0	1	71.9690910828
268	112	4	1	3	74.9222957061
268	113	8	0	8	81.0738095212
268	116	1	0	1	75.0774975069
268	127	1	1	0	89.6944238462
268	131	1	0	1	115.154764633
268	142	6	0	6	94.5716526408
268	155	1	0	1	86.1752727338
268	156	1	0	1	82.0995913719
268	181	53	1	52	9.52705551102
268	182	14	0	14	24.4027782868
268	183	655	196	459	16.9525708063
268	184	229	1	228	10.4637232355
268	185	4	0	4	24.6947516486
268	186	74	10	64	17.6770363602
268	187	5	1	4	29.0130824072
268	188	28	3	25	23.4390568137
268	189	1	0	1	23.0682860635
268	190	187	9	178	17.6667220135
268	191	1	0	1	44.8715350749
268	196	2	1	1	55.9577830211
268	200	1	0	1	48.3480697615
268	204	1	0	1	40.8676027415
268	205	1	0	1	46.7776492187
268	206	2	0	2	39.9870114092
268	207	5	0	5	38.5092510599
268	208	10	0	10	46.1512077626
268	209	4	0	4	39.6087170353
268	212	3	0	3	35.4334473879
268	213	2	0	2	45.1562995146
268	214	3	0	3	46.0589811665
268	216	1	0	1	33.2179203031
268	217	1	0	1	35.7532808244
268	218	1	0	1	30.7803239175
268	219	1	0	1	42.8373548286
268	220	20	2	18	36.5491615226
268	221	1	0	1	30.5565616649
268	222	2	1	1	28.8624172127
268	224	2	0	2	33.5091356263
268	225	3	1	2	35.2403662469
268	226	1	0	1	41.9621516616
268	227	3	1	2	28.4642138454
268	228	1	0	1	43.8168333818
268	229	17	2	15	36.5390795829
268	230	2	0	2	40.5978676776
268	231	1	0	1	27.4087573196
268	232	0	0	0	29.548675408
268	233	2	0	2	30.790248731
268	234	4	1	3	25.4478071923
268	235	7	0	7	16.6006941961
268	236	24	6	18	22.1560417466
268	237	4	0	4	32.3299322016
268	238	5	1	4	20.3534006014
268	239	4	0	4	29.6337765451
268	242	1	0	1	54.4893388672
268	243	1	0	1	48.3730258148
268	244	1	0	1	57.3803315427
268	245	15	2	13	51.5946916497
268	251	1	0	1	56.7226549698
268	254	1	0	1	46.6481404958
268	255	2	0	2	41.0799776397
268	257	1	0	1	48.5557354537
268	258	3	0	3	49.9430185189
268	259	1	0	1	34.8853235181
268	262	6	0	6	37.0560398931
268	264	3	1	2	43.3743723899
268	265	167	58	109	18.7056554941
268	266	703	15	688	7.81494692794
268	267	42	7	35	12.3744136825
268	269	33	0	33	11.3616889415
268	270	45	6	39	24.9611021722
268	271	249	38	211	13.3409071135
268	272	41	11	30	23.5645684471
268	273	2	0	2	28.1271968101
268	274	8	0	8	30.3496877164
268	275	72	2	70	18.9759870094
268	276	3	1	2	34.1615499198
268	277	746	43	703	23.6232974183
268	278	58	1	57	7.27894216977
268	280	35	1	34	16.3127418748
268	281	11	0	11	32.9375863307
268	282	18	0	18	32.1114042482
268	284	3	0	3	29.0432452592
268	285	20	1	19	17.1874521784
268	286	1	0	1	37.6739040854
268	287	6	1	5	24.1622906017
268	288	52	28	24	12.226538478
268	289	5	1	4	29.5433752806
268	290	42	3	39	10.8968076649
268	291	4	1	3	29.0513661489
268	292	4	0	4	32.7500900958
268	293	6	1	5	40.1499763711
268	295	1	0	1	34.3975712956
268	303	4	0	4	54.9584445556
268	305	3	0	3	36.8736861783
268	307	6	1	5	46.033767574
268	309	1	0	1	53.1778152554
268	345	1	0	1	53.2234583675
268	469	0	0	0	133.096173679
268	471	2	0	2	125.89272051
268	487	1	0	1	135.41537439
268	517	2	0	2	207.263417577
269	1	14	0	14	55.4730578601
269	5	1	0	1	64.2599241944
269	6	1	0	1	73.3735938466
269	23	1	0	1	65.3071276087
269	36	2	0	2	65.9406901253
269	54	1	0	1	88.7044465867
269	70	1	0	1	69.1586469549
269	73	10	0	10	70.3009396978
269	74	2	0	2	74.1554453842
269	75	5	0	5	72.4398058649
269	76	1	0	1	71.8872546262
269	78	3	1	2	74.0043932981
269	79	0	0	0	66.7388278194
269	81	2	0	2	68.4885795865
269	82	1	0	1	71.7736828964
269	84	6	0	6	71.6585358886
269	85	1	0	1	75.6418329109
269	106	1	0	1	53.4236808565
269	112	1	0	1	70.0072896973
269	113	2	0	2	76.6930603517
269	131	1	0	1	107.827940842
269	142	2	0	2	89.1905288563
269	152	1	0	1	99.2878349496
269	181	1	0	1	20.8776829065
269	183	45	0	45	25.4315955095
269	184	15	0	15	17.6141110576
269	186	8	2	6	28.9762945629
269	187	2	0	2	40.3285977861
269	188	3	0	3	34.4400178644
269	190	15	0	15	20.3327117263
269	196	1	0	1	67.2751215623
269	208	1	0	1	55.7231105765
269	209	1	0	1	49.4211811025
269	214	1	0	1	54.5858207459
269	220	2	1	1	45.8906033538
269	229	2	0	2	47.5950107508
269	231	1	0	1	36.2086346787
269	236	3	0	3	31.9872481663
269	241	1	0	1	71.9471787141
269	242	1	0	1	64.8018575191
269	245	1	0	1	48.9287437171
269	254	2	0	2	45.7378426564
269	257	1	0	1	44.005206589
269	259	1	1	0	32.1785228703
269	260	1	0	1	47.9529459953
269	262	4	0	4	35.8081453881
269	264	2	0	2	38.331217498
269	265	70	25	45	10.0613493263
269	266	372	65	307	7.41228059468
269	267	55	26	29	6.6432980103
269	268	125	7	118	11.3616889415
269	270	33	1	32	17.2884331685
269	271	45	14	31	22.3017146526
269	272	3	0	3	30.3180853056
269	274	4	1	3	28.8399824746
269	275	46	9	37	15.7451984943
269	276	3	0	3	37.5567945389
269	277	388	0	388	22.9988494508
269	278	2	1	1	16.7628209765
269	279	4	0	4	26.0260205825
269	280	16	11	5	17.9598835781
269	281	4	0	4	32.9238122756
269	282	5	1	4	33.6935579801
269	283	1	0	1	26.8491631267
269	284	6	3	3	33.764761289
269	285	7	0	7	22.5572081396
269	286	1	0	1	38.8062557671
269	288	25	9	16	12.1734664802
269	289	3	1	2	22.2552376124
269	290	9	1	8	14.9919880418
269	292	1	0	1	39.3223667658
269	293	2	0	2	45.3069705099
269	305	6	0	6	31.1838011916
269	306	2	0	2	37.6586900517
269	307	3	0	3	38.3044720523
269	309	1	0	1	45.8294597885
269	415	1	0	1	147.50881956
270	0	1	0	1	40.7223865607
270	1	53	5	48	40.0907345376
270	2	1	0	1	49.5219069689
270	5	4	0	4	49.7147364342
270	7	2	0	2	43.7935390336
270	15	1	0	1	45.5667326923
270	23	1	0	1	49.4704778204
270	26	1	0	1	60.6942984669
270	28	9	3	6	35.9851332138
270	32	1	0	1	32.4250543729
270	36	2	1	1	48.6527377878
270	39	1	0	1	37.7238989554
270	50	1	0	1	71.163867678
270	60	1	0	1	75.2055682147
270	70	1	0	1	53.3250591859
270	73	22	0	22	53.7325489809
270	74	1	0	1	57.7897633527
270	75	5	0	5	55.7810932232
270	76	1	0	1	55.9995334707
270	78	3	1	2	57.7895626291
270	79	2	0	2	50.3239262351
270	81	2	0	2	52.2977813502
270	82	2	0	2	55.6567202817
270	83	1	0	1	54.9032030129
270	84	1	0	1	55.1267016736
270	85	1	0	1	59.7472415646
270	87	2	0	2	58.531776615
270	89	1	0	1	43.1569838807
270	95	1	0	1	48.7460290567
270	102	1	0	1	38.8218337845
270	103	1	1	0	55.3287398172
270	111	1	0	1	44.2975567765
270	112	2	0	2	52.9567692668
270	113	5	0	5	59.8102276796
270	141	1	0	1	100.713788643
270	142	1	0	1	71.9733246231
270	177	1	0	1	79.1445505721
270	181	1	0	1	33.3428473038
270	183	5	0	5	41.5043026565
270	186	1	0	1	41.2971397007
270	187	0	0	0	52.0398681902
270	188	2	0	2	47.7132378725
270	190	1	0	1	37.6211178743
270	196	2	0	2	76.2472184454
270	204	1	0	1	47.8960711753
270	205	1	0	1	53.062317149
270	208	0	0	0	58.4793459337
270	209	1	0	1	53.2071145207
270	220	1	0	1	61.4958425271
270	229	1	0	1	55.4643525283
270	237	4	0	4	44.3973652359
270	245	2	0	2	33.6300737363
270	247	1	0	1	47.1273820545
270	254	2	0	2	32.4562371681
270	255	2	1	1	21.677228627
270	257	6	3	3	27.4139797969
270	258	2	0	2	26.7627872624
270	259	1	0	1	18.2057243405
270	261	1	0	1	20.619614964
270	262	5	0	5	23.1610435791
270	264	4	0	4	21.5949689869
270	265	193	57	136	7.23847266241
270	266	66	29	37	17.1667968582
270	267	8	2	6	12.6727791544
270	268	2	1	1	24.9611021722
270	269	3	0	3	17.2884331685
270	272	8	0	8	30.9025445548
270	274	14	0	14	17.2244751438
270	275	123	46	77	9.35698751571
270	276	2	0	2	31.2546064077
270	277	1678	0	1678	15.0289867139
270	278	3	0	3	25.973475516
270	279	12	0	12	11.2021319392
270	280	4	2	2	16.7793131437
270	281	7	0	7	22.4989347756
270	282	10	0	10	25.4395353143
270	283	12	1	11	9.6990331794
270	284	2	0	2	30.2890160896
270	285	1	0	1	23.7243524176
270	286	2	0	2	28.956712111
270	287	2	0	2	24.7692808076
270	288	11	0	11	14.8192946033
270	289	72	16	56	4.96825964369
270	293	1	0	1	40.6152902318
270	303	16	4	12	30.2586223803
270	304	2	0	2	34.0043424322
270	305	29	12	17	14.306315191
270	306	5	1	4	21.8849203646
270	307	18	0	18	21.2590672317
270	308	8	0	8	15.4119152081
270	309	3	0	3	28.6595814174
270	319	1	0	1	97.080156092
270	345	1	0	1	64.5995360088
270	349	1	0	1	84.3242400552
270	408	1	0	1	139.974544972
270	466	3	0	3	120.615588835
270	467	1	0	1	108.271465623
270	469	1	0	1	108.841636096
270	502	1	0	1	132.298321743
271	1	53	5	48	67.9061728693
271	13	1	0	1	69.9874299779
271	15	2	0	2	71.7116786936
271	19	1	1	0	62.892648467
271	21	2	0	2	76.9664082809
271	22	1	0	1	70.6229190758
271	26	1	0	1	87.3720083353
271	28	6	0	6	63.3926781607
271	36	10	1	9	70.4844951792
271	39	1	0	1	60.1449301974
271	42	1	0	1	64.5895828608
271	43	1	0	1	117.799810026
271	44	1	0	1	108.293973757
271	48	1	0	1	107.92244795
271	50	1	0	1	96.9815570463
271	55	1	0	1	106.010045013
271	58	0	0	0	104.444873843
271	61	1	0	1	111.956577003
271	65	0	0	0	107.845157805
271	70	17	1	16	65.5509695168
271	71	2	2	0	75.7116281087
271	73	220	0	220	69.0278487788
271	74	9	0	9	71.8919482791
271	75	17	1	16	71.4026141277
271	76	17	1	16	68.2463209719
271	78	18	4	14	71.2362373931
271	79	2	0	2	65.1348162692
271	80	0	0	0	66.0482348635
271	81	10	2	8	66.00269422
271	82	27	5	22	68.8305106765
271	83	5	0	5	69.3853699459
271	84	28	1	27	70.157995164
271	85	3	0	3	71.785785062
271	86	3	0	3	75.5586345834
271	87	7	1	6	73.6969813063
271	88	2	0	2	75.1242234678
271	89	2	1	1	57.1727286565
271	90	4	0	4	70.2751643258
271	92	6	0	6	60.6429950181
271	95	1	0	1	66.8418593581
271	96	3	0	3	67.9480410568
271	100	1	0	1	64.1386482541
271	102	1	0	1	58.6098187563
271	103	4	1	3	72.6047541686
271	104	1	0	1	62.2752169047
271	109	1	0	1	64.7121703243
271	110	3	0	3	75.8104617293
271	111	5	0	5	55.2736250924
271	112	10	0	10	71.1247611136
271	113	10	0	10	76.4704080719
271	116	1	0	1	68.3204142366
271	120	4	0	4	63.3356376995
271	123	1	0	1	50.7773376781
271	124	1	0	1	99.7697776255
271	142	8	0	8	90.929913588
271	166	2	0	2	82.1388408671
271	181	113	3	110	11.0650493823
271	182	4	0	4	32.5912362727
271	183	260	0	260	24.0392039195
271	184	26	4	22	21.0203160102
271	185	2	0	2	27.2615790477
271	186	49	2	47	15.6921690226
271	187	2	0	2	24.5054745469
271	188	19	3	16	22.3724566546
271	190	16	4	12	29.6078506367
271	194	1	0	1	31.5667520802
271	196	2	0	2	47.5806711405
271	198	1	0	1	58.0571573676
271	204	2	0	2	27.5376425411
271	206	2	0	2	26.7930215635
271	207	5	0	5	25.7316171125
271	208	19	1	18	33.4349696887
271	209	2	0	2	27.1254935517
271	211	2	1	1	37.7565220998
271	212	12	0	12	22.1429160339
271	213	4	0	4	33.403438882
271	214	12	1	11	32.7974618852
271	216	1	0	1	37.0763998438
271	217	3	1	2	35.9766619972
271	218	1	0	1	29.2317962268
271	219	1	0	1	43.0227590584
271	220	40	12	28	39.0384723878
271	222	1	0	1	34.2512223857
271	223	4	1	3	27.2401942299
271	224	1	0	1	21.7007931316
271	225	4	0	4	24.2194538793
271	226	1	0	1	30.9311299155
271	227	2	0	2	21.6482550235
271	228	1	0	1	33.7585389158
271	229	35	5	30	26.8908505258
271	230	1	0	1	32.8884158326
271	231	13	0	13	14.1614887015
271	232	10	0	10	17.6221795793
271	233	6	1	5	18.0771075435
271	234	4	1	3	15.2229032482
271	235	111	0	111	5.09351200608
271	236	114	32	82	9.80303848914
271	237	11	0	11	19.2597618909
271	238	26	3	23	13.1095680284
271	239	4	0	4	20.0565524693
271	242	5	1	4	53.4138235795
271	243	4	1	3	47.6130542648
271	244	0	0	0	54.6714555259
271	245	23	0	23	46.0911090285
271	247	1	0	1	46.2348022579
271	248	2	0	2	44.0014388137
271	251	2	0	2	48.2063292007
271	252	1	0	1	34.3005754861
271	253	6	1	5	34.4286622093
271	254	8	0	8	39.5232479357
271	255	1	0	1	37.6252894109
271	257	6	0	6	45.4657634183
271	258	0	0	0	48.5461474367
271	259	5	0	5	30.9401780038
271	260	2	0	2	48.0765003679
271	262	14	0	14	31.151054199
271	264	4	0	4	41.2944668775
271	265	4	0	4	25.0642123336
271	266	105	49	56	15.2808771107
271	267	4	1	3	19.2312352546
271	268	84	18	66	13.3409071135
271	269	3	0	3	22.3017146526
271	270	10	0	10	28.6957601511
271	272	281	5	276	10.9694536299
271	273	10	0	10	18.7338188893
271	274	12	2	10	25.7331977413
271	275	40	4	36	19.7292087648
271	276	14	2	12	23.6405946856
271	277	1241	38	1203	19.5904973862
271	278	131	85	46	6.07325166805
271	279	5	0	5	28.9013200613
271	280	25	10	15	12.8600257315
271	281	16	1	15	26.1719510105
271	282	32	10	22	23.6848528206
271	284	39	1	38	17.7362809702
271	285	107	46	61	7.91641882037
271	286	2	0	2	29.1050012295
271	287	19	0	19	14.5424667042
271	288	7	2	5	14.1184059117
271	289	1	0	1	31.96219067
271	290	42	21	21	9.4012519678
271	291	25	0	25	15.7907678856
271	292	16	1	15	19.8407429758
271	293	16	0	16	27.8667311002
271	294	1	0	1	38.2740285312
271	295	1	0	1	22.595806335
271	296	0	0	0	38.1141007755
271	297	1	0	1	33.7342943237
271	302	4	0	4	29.6797481755
271	303	2	0	2	58.345911587
271	305	10	3	7	36.2636711937
271	307	11	2	9	47.2930657796
271	309	2	1	1	53.4627382778
271	316	1	0	1	41.3230379596
271	345	3	0	3	40.3883819258
271	375	1	1	0	51.4569151028
271	421	1	0	1	173.955793391
271	465	1	0	1	139.296437846
271	466	1	0	1	143.928266062
271	469	1	0	1	131.344029411
271	471	2	0	2	126.171078229
271	472	1	0	1	121.906622082
271	475	0	0	0	126.730152367
271	480	0	0	0	129.118728081
271	503	1	0	1	145.599444563
271	512	1	0	1	201.900136601
271	537	0	0	0	177.250446282
271	573	1	0	1	121.666384977
272	0	3	0	3	62.5514809627
272	1	72	2	70	66.9097182703
272	2	0	0	0	72.5710181632
272	5	1	0	1	77.2941377003
272	12	2	0	2	75.1200273965
272	13	2	1	1	66.5631535471
272	15	3	0	3	69.103357262
272	16	1	0	1	58.7375121819
272	17	0	0	0	78.34654634
272	19	2	0	2	59.6197918756
272	25	1	0	1	87.8929372761
272	28	7	0	7	62.0798669317
272	32	2	0	2	52.125786823
272	34	1	0	1	85.7857224197
272	36	10	0	10	65.4875300799
272	39	1	0	1	55.8369805819
272	41	1	0	1	71.7921298859
272	46	1	0	1	98.0352796087
272	48	2	0	2	104.452470801
272	50	1	0	1	93.6357886102
272	55	1	0	1	103.432123339
272	70	22	4	18	57.3416272336
272	71	2	0	2	67.6964282171
272	72	1	0	1	56.2671472333
272	73	244	67	177	61.610750881
272	74	14	4	10	64.0218240385
272	75	13	0	13	64.0142073708
272	76	10	1	9	59.9564716828
272	78	21	6	15	63.1940200957
272	79	6	1	5	57.7018600696
272	81	5	0	5	58.2012877374
272	82	36	2	34	60.7816476699
272	83	7	0	7	61.7045161125
272	84	26	0	26	62.6217571148
272	85	3	0	3	63.3395055854
272	86	2	0	2	67.3205884808
272	87	3	0	3	66.098036931
272	88	2	0	2	67.3555503711
272	89	8	2	6	49.8407906854
272	90	4	0	4	61.2525579736
272	92	13	2	11	52.5581359655
272	95	8	1	7	60.4555917484
272	96	2	0	2	58.4990256261
272	102	1	0	1	53.2406301298
272	103	13	1	12	65.7310867554
272	104	1	0	1	56.0606432829
272	107	1	0	1	75.3711675179
272	109	1	0	1	55.8668018993
272	110	5	1	4	69.2768650667
272	111	4	0	4	47.1413614942
272	112	5	0	5	64.6152218688
272	113	22	3	19	69.2775065437
272	114	1	0	1	65.9397402714
272	115	0	0	0	44.1417766891
272	116	1	0	1	59.7545078714
272	120	4	0	4	56.2816186142
272	134	1	0	1	79.6808262922
272	142	11	0	11	84.2306534916
272	155	2	0	2	68.6441507713
272	164	1	0	1	72.3300918477
272	166	1	0	1	72.1373029866
272	171	2	0	2	69.6747330979
272	177	0	0	0	81.7600858944
272	181	9	1	8	21.8157872529
272	182	0	0	0	43.3314211473
272	183	59	1	58	34.7684069379
272	184	6	0	6	31.971384313
272	185	3	0	3	36.7016819625
272	186	7	1	6	24.6181071647
272	187	3	0	3	30.5171755006
272	188	1	0	1	30.7154500071
272	190	3	0	3	40.4866426592
272	191	1	0	1	46.7689820846
272	194	1	0	1	36.2202574795
272	196	7	1	6	48.0220914316
272	198	1	0	1	59.5988315321
272	199	4	1	3	37.9862158337
272	200	1	0	1	38.5038469293
272	204	13	1	12	18.2916188672
272	205	5	0	5	24.0780016841
272	206	12	0	12	19.5303930816
272	207	12	0	12	20.3272189031
272	208	126	2	124	27.5802272961
272	209	17	3	14	22.4567495219
272	210	1	0	1	23.0682378684
272	211	9	1	8	33.6101435819
272	212	170	43	127	14.5677301571
272	213	10	0	10	29.8392854892
272	214	10	2	8	24.7784861408
272	216	1	0	1	46.5421263686
272	219	3	0	3	50.5623622759
272	220	11	1	10	47.8794121751
272	221	1	0	1	41.4369251726
272	222	3	0	3	44.3146578308
272	223	5	0	5	30.3993051484
272	224	5	0	5	19.4931786528
272	225	13	1	12	23.1031569721
272	227	1	0	1	26.246833038
272	229	32	0	32	27.4769055884
272	230	2	0	2	35.0872637361
272	231	98	59	39	8.73218326867
272	232	13	1	12	16.1140203462
272	233	12	0	12	14.2097557674
272	234	12	3	9	17.6041957421
272	235	9	0	9	11.8315780536
272	236	166	0	166	10.8392169972
272	237	72	0	72	13.6165846193
272	238	9	3	6	19.5189500004
272	239	2	0	2	21.9653211519
272	242	1	0	1	59.8199981967
272	244	2	1	1	59.921763685
272	245	40	14	26	39.0158727112
272	246	2	1	1	39.6851671579
272	247	0	0	0	35.9037891843
272	248	3	0	3	35.4256027833
272	249	2	0	2	29.539421029
272	250	3	0	3	30.1719729987
272	251	4	0	4	38.818982237
272	252	3	0	3	26.0279488495
272	253	6	0	6	24.4320402036
272	254	8	1	7	31.4605062721
272	255	2	0	2	32.7843942255
272	256	1	0	1	47.8361769332
272	257	9	0	9	40.3836489003
272	258	1	0	1	44.6843517472
272	259	4	0	4	26.3690582298
272	261	1	0	1	41.5647716814
272	262	45	2	43	24.7691898638
272	263	2	1	1	30.6036143299
272	264	6	1	5	37.3267354702
272	265	1	0	1	29.7580379428
272	266	29	1	28	22.9079422046
272	268	4	0	4	23.5645684471
272	270	14	2	12	30.9025445548
272	271	132	1	131	10.9694536299
272	273	42	28	14	10.7007840298
272	274	26	0	26	21.3486171051
272	275	35	0	35	21.6482052287
272	276	62	27	35	13.6782237842
272	277	1988	987	1001	17.3516424641
272	278	10	0	10	16.4684882143
272	279	13	2	11	26.9105906311
272	280	14	0	14	14.4881704095
272	281	48	1	47	19.6085936784
272	282	56	12	44	15.8059025489
272	284	277	0	277	7.52305963606
272	285	105	14	91	7.94849310917
272	286	7	1	6	20.4816105008
272	287	137	66	71	7.70257962213
272	288	8	7	1	19.1326803667
272	290	11	3	8	15.3450682427
272	291	250	7	243	6.65228895592
272	292	120	31	89	9.21718749274
272	293	131	0	131	16.8988635697
272	294	20	3	17	27.5226385952
272	295	19	0	19	11.7533469324
272	296	5	1	4	27.3010970962
272	297	2	1	1	23.4542834716
272	298	6	0	6	15.8199664734
272	299	1	0	1	21.5847628893
272	301	1	0	1	23.405002498
272	302	9	2	7	19.2331324518
272	303	6	0	6	57.9547054784
272	304	2	0	2	57.2944283599
272	305	19	1	18	33.9778540759
272	306	1	0	1	49.7682323136
272	307	10	0	10	45.6890022159
272	309	3	0	3	50.7309355822
272	332	1	0	1	65.746091553
272	338	2	1	1	67.8850677442
272	345	2	0	2	33.8424617592
272	346	1	0	1	48.9695750889
272	375	2	0	2	42.3113724068
272	377	1	0	1	44.4318833926
272	391	1	0	1	129.158079653
272	471	1	0	1	122.054405035
272	475	1	0	1	119.980311819
272	484	1	0	1	127.406986198
272	515	1	0	1	184.982417364
272	563	0	0	0	124.730167924
272	573	1	0	1	112.210580912
273	0	5	0	5	52.4491448331
273	1	60	3	57	57.7942549642
273	9	1	0	1	50.079340935
273	13	2	0	2	56.3473828985
273	15	2	1	1	59.181478016
273	19	1	0	1	49.502509552
273	20	2	0	2	70.4423579093
273	26	1	0	1	74.880944945
273	28	5	0	5	52.8479757461
273	32	6	1	5	41.9361730761
273	36	9	0	9	54.8751414123
273	39	2	0	2	45.4060999221
273	46	2	0	2	88.4291309881
273	70	14	0	14	47.1042039515
273	71	4	0	4	57.3835750645
273	72	2	1	1	45.8278158065
273	73	205	2	203	51.0779297752
273	74	12	0	12	53.6432399991
273	75	9	0	9	53.4771817162
273	76	6	0	6	49.7651954977
273	78	22	0	22	52.8866645059
273	79	4	0	4	47.1670334447
273	81	17	0	17	47.7865493106
273	82	29	3	26	50.4734458677
273	83	12	0	12	51.2526153433
273	84	27	0	27	52.124730899
273	85	6	0	6	53.2406624989
273	86	1	0	1	57.1128128655
273	87	4	0	4	55.6256469187
273	88	2	0	2	56.9431657597
273	89	6	1	5	39.2647502656
273	90	1	0	1	51.5613185974
273	92	12	2	10	42.2509346835
273	95	2	0	2	49.7614807274
273	96	1	0	1	49.2252799225
273	101	2	0	2	32.5577970716
273	102	1	0	1	42.5985655434
273	103	9	0	9	55.0895537592
273	105	2	0	2	40.6630141445
273	107	1	0	1	65.1406638523
273	110	2	0	2	58.5976737603
273	111	4	0	4	36.843851133
273	112	3	0	3	53.9312234762
273	113	15	2	13	58.6993659266
273	115	2	1	1	34.2636113878
273	116	1	0	1	49.7241952322
273	118	1	0	1	53.3000948034
273	120	3	0	3	45.658601989
273	131	0	0	0	98.0217109434
273	140	1	0	1	63.9588295959
273	142	6	1	5	73.5783369124
273	148	1	0	1	74.0544697086
273	171	0	0	0	60.0234548882
273	172	1	0	1	71.5014347884
273	177	0	0	0	72.0107631649
273	181	2	1	1	29.6030274425
273	182	1	0	1	50.8500682213
273	183	22	1	21	42.3992153989
273	186	4	1	3	34.0869364714
273	187	1	0	1	41.0232188991
273	188	3	1	2	40.5383002125
273	190	5	0	5	45.7936919627
273	191	2	0	2	57.4311717012
273	194	2	0	2	46.9046295019
273	196	4	1	3	58.1513392335
273	198	1	0	1	69.9338425335
273	202	1	0	1	52.4178889917
273	205	1	0	1	27.6677127085
273	206	3	1	2	26.5585124097
273	207	7	0	7	28.7695431443
273	208	37	2	35	35.1128727471
273	209	5	1	4	31.1786295078
273	211	2	0	2	42.0309313441
273	212	8	0	8	22.0511677017
273	213	4	0	4	38.7557518713
273	214	3	0	3	30.3717394098
273	220	9	0	9	57.536730178
273	223	2	0	2	41.0914318287
273	225	3	0	3	33.2675382605
273	229	10	4	6	37.9136027955
273	230	1	0	1	45.6840859929
273	231	1	0	1	18.7411017141
273	232	1	0	1	26.4870229708
273	233	3	0	3	24.0522725398
273	236	8	5	3	21.5005638056
273	237	1	0	1	22.7073758417
273	242	1	0	1	70.369292654
273	245	27	0	27	28.3627812563
273	246	1	0	1	29.4210304689
273	247	2	0	2	28.2435034117
273	249	1	0	1	20.2420861274
273	250	2	0	2	19.484709165
273	251	4	0	4	29.4944133213
273	252	4	0	4	15.7131584565
273	253	5	0	5	16.252711153
273	254	5	0	5	21.0698000676
273	255	1	0	1	22.416312479
273	256	1	0	1	37.2055190351
273	257	3	0	3	29.8518784337
273	258	2	0	2	34.490958284
273	259	3	1	2	16.3079337988
273	260	1	0	1	31.5007488635
273	262	25	7	18	14.1106532869
273	264	9	0	9	27.2088626135
273	266	10	0	10	24.3593398439
273	267	1	0	1	24.8902906543
273	268	3	1	2	28.1271968101
273	270	12	0	12	25.6384530018
273	271	18	3	15	18.7338188893
273	272	84	0	84	10.7007840298
273	274	16	2	14	11.7644543167
273	275	14	1	13	17.7257038876
273	276	21	16	5	6.43589330955
273	277	1611	337	1274	10.6100953989
273	278	2	0	2	22.3240929201
273	279	6	2	4	18.5109246606
273	280	5	1	4	13.1739980634
273	281	37	9	28	8.99310444414
273	282	41	26	15	5.17523125257
273	284	178	29	149	5.24187152282
273	285	17	0	17	11.375323109
273	286	2	0	2	10.3814029829
273	287	38	28	10	4.21599821274
273	288	2	0	2	18.9587216358
273	289	1	0	1	25.9127054133
273	291	10	0	10	14.7845410227
273	292	11	0	11	13.0736083696
273	293	66	0	66	15.1028683856
273	294	6	0	6	26.6164584537
273	295	12	1	11	9.22366589751
273	296	1	0	1	21.8102443586
273	297	3	1	2	24.9226187272
273	298	2	0	2	18.2313865426
273	302	1	0	1	12.6766987673
273	303	3	1	2	49.3280597667
273	305	9	2	7	24.869952834
273	307	14	0	14	36.587021681
273	308	1	0	1	35.5699172749
273	309	2	0	2	40.9339184307
273	345	4	0	4	40.3893892977
273	351	1	0	1	61.4751544278
273	375	0	0	0	45.0250289531
273	408	0	0	0	140.658978021
273	415	1	0	1	130.285841948
273	469	1	0	1	114.961600193
273	471	2	0	2	111.530615459
273	496	0	0	0	118.992488659
273	563	1	0	1	115.921175103
274	0	6	4	2	41.213765647
274	1	120	4	116	46.0393389233
274	3	2	0	2	39.7677408813
274	5	1	0	1	56.5174649914
274	6	1	0	1	65.6629625767
274	7	4	0	4	45.2993078995
274	9	1	0	1	38.693319716
274	13	8	1	7	45.2623876124
274	15	5	0	5	47.7617234459
274	18	2	0	2	43.1098591145
274	19	4	0	4	38.2875073122
274	22	1	0	1	50.6272965856
274	26	1	0	1	63.5060534395
274	28	3	1	2	41.1061135674
274	32	6	0	6	30.8322476859
274	33	1	0	1	49.5958859014
274	34	1	0	1	64.8570105731
274	35	0	0	0	54.0569695151
274	36	11	1	10	44.861103997
274	37	0	0	0	60.8378649785
274	38	1	0	1	57.834017528
274	39	4	0	4	34.7784660645
274	42	1	0	1	39.1124310309
274	46	2	0	2	76.8204083704
274	47	2	0	2	94.1929061836
274	49	1	0	1	66.6528046551
274	55	1	0	1	82.0835222434
274	60	1	0	1	76.3337214006
274	70	20	2	18	41.5000986861
274	71	3	0	3	51.2037526126
274	72	2	0	2	39.3878486127
274	73	209	26	183	43.9930961784
274	74	10	4	6	47.2714130846
274	75	16	1	15	46.3156004317
274	76	3	0	3	44.2485863717
274	78	18	0	18	46.8338792342
274	79	6	0	6	40.1685292273
274	81	12	1	11	41.4052593826
274	82	17	0	17	44.4821582874
274	83	4	1	3	44.5972988529
274	84	28	0	28	45.2164237978
274	85	9	1	8	47.9483860949
274	86	2	0	2	51.340075721
274	87	7	1	6	48.770388437
274	88	1	0	1	50.3481938489
274	89	9	0	9	32.2592766015
274	90	4	0	4	47.5584524833
274	92	18	11	7	36.5483000754
274	94	1	0	1	35.51097405
274	95	5	0	5	41.2187645368
274	96	3	0	3	46.3761274063
274	102	4	0	4	32.8878280308
274	103	9	2	7	47.1589052564
274	104	2	0	2	36.6197960087
274	109	1	0	1	41.809429932
274	110	1	0	1	50.2024595262
274	111	4	0	4	31.4500274289
274	112	6	0	6	45.5257214424
274	113	32	2	30	51.1906436956
274	114	1	0	1	45.9721215469
274	117	2	0	2	51.3897364361
274	118	3	0	3	48.5658295885
274	120	2	0	2	38.083268941
274	122	1	1	0	35.7347157713
274	128	1	0	1	71.2429495263
274	140	4	0	4	55.9027853684
274	142	12	0	12	65.3367488429
274	146	1	0	1	55.9042073899
274	155	1	0	1	56.2895075973
274	162	1	0	1	54.6613646781
274	168	1	0	1	61.8081957702
274	171	2	0	2	55.882835749
274	172	1	0	1	66.03021785
274	177	1	0	1	67.3654265846
274	181	2	0	2	35.0779830667
274	183	37	1	36	46.7521275429
274	184	2	0	2	40.8124058383
274	186	3	0	3	41.3127846514
274	187	0	0	0	49.9487200934
274	188	2	0	2	48.0459698906
274	190	2	0	2	47.1636884565
274	194	1	0	1	56.5221992813
274	196	2	0	2	69.364054086
274	198	1	0	1	80.9293773973
274	207	1	0	1	40.4948938592
274	208	13	2	11	46.8699626939
274	211	3	0	3	53.7829500869
274	212	3	1	2	33.8120835085
274	213	4	1	3	50.4445335399
274	214	5	0	5	41.9156006691
274	217	1	0	1	61.655208746
274	219	1	0	1	68.7345350997
274	220	9	0	9	64.3217096891
274	224	1	0	1	40.7731170887
274	225	1	0	1	44.4371635731
274	229	6	0	6	48.7958087671
274	232	2	0	2	37.4618805191
274	233	1	0	1	35.3888500961
274	234	1	0	1	38.3468348348
274	236	3	0	3	31.4525726668
274	237	5	0	5	34.2863190249
274	242	0	0	0	79.0986062066
274	243	1	0	1	73.3358025374
274	245	50	0	50	21.2648584282
274	246	2	0	2	24.7316009269
274	247	6	2	4	30.1664764332
274	250	6	1	5	12.8991782914
274	251	3	0	3	27.8599421338
274	253	10	3	7	19.63632334
274	254	10	2	8	16.9096191835
274	255	4	1	3	11.916389716
274	256	2	0	2	27.4972783906
274	257	23	4	19	19.7514274758
274	258	5	1	4	23.414478585
274	259	72	25	47	5.23449628552
274	260	5	0	5	22.412065602
274	261	3	0	3	20.3171249263
274	262	163	1	162	6.98214682427
274	263	8	0	8	11.2775447014
274	264	30	9	21	16.0435694723
274	265	6	1	5	21.393022056
274	266	17	0	17	24.0021872699
274	267	2	0	2	22.2195700485
274	268	2	0	2	30.3496877164
274	269	1	0	1	28.8399824746
274	270	23	6	17	17.2244751438
274	271	13	12	1	25.7331977413
274	272	34	27	7	21.3486171051
274	273	3	0	3	11.7644543167
274	275	34	19	15	13.0978856995
274	276	9	0	9	15.4786343952
274	277	2937	1109	1828	6.75488933858
274	278	2	0	2	26.8685032925
274	279	97	5	92	7.34552710016
274	280	9	5	4	14.3098025036
274	281	123	37	86	5.33615617734
274	282	107	26	81	9.13341395476
274	283	1	0	1	18.0409066032
274	284	34	0	34	16.9969876148
274	285	4	0	4	17.9348958532
274	286	15	0	15	11.7523813143
274	287	14	0	14	13.6461630187
274	288	4	0	4	18.4030814553
274	289	6	1	5	15.7863019393
274	290	5	0	5	19.8917611671
274	291	4	1	3	26.4000106448
274	292	6	0	6	24.7790501563
274	293	26	3	23	24.9840741729
274	294	3	0	3	35.6834515166
274	295	1	0	1	20.0016879481
274	296	2	0	2	27.6286462614
274	300	1	0	1	26.6150396512
274	302	1	0	1	19.5134013114
274	303	5	0	5	37.592154314
274	304	1	0	1	35.9886958205
274	305	58	11	47	13.1113935041
274	307	45	0	45	24.8230658856
274	308	1	0	1	24.1664260913
274	309	6	0	6	29.4071581422
274	375	1	0	1	55.3289135274
274	469	3	0	3	105.632280785
274	480	1	0	1	103.570519376
274	484	1	0	1	106.116305331
274	573	0	0	0	99.0644745333
275	0	5	2	3	47.0846259542
275	1	111	3	108	48.2594818731
275	3	3	0	3	46.7435165586
275	5	3	0	3	58.2145218449
275	7	3	2	1	50.5907919762
275	9	1	0	1	44.1053455186
275	12	1	0	1	55.4417786796
275	13	7	0	7	51.4566969527
275	16	1	0	1	43.9933989419
275	17	1	0	1	61.8019543621
275	18	1	0	1	50.0832805722
275	19	2	0	2	44.3694835949
275	21	1	0	1	57.364296761
275	23	1	0	1	57.1989009821
275	28	15	0	15	43.8416955765
275	30	1	0	1	66.3066292147
275	32	2	0	2	37.7175852994
275	34	1	0	1	72.2294645604
275	35	1	0	1	60.4989108056
275	36	16	0	16	53.4005899727
275	38	1	0	1	65.6538837294
275	39	3	0	3	42.6104505516
275	46	1	0	1	79.9732196694
275	48	1	0	1	89.1008733387
275	60	1	0	1	82.1869290601
275	70	16	0	16	53.8478098519
275	71	3	0	3	63.1522392999
275	73	132	25	107	55.5437420225
275	74	11	0	11	59.1763004388
275	75	12	0	12	57.7711823291
275	76	4	0	4	56.5916534628
275	77	1	0	1	51.6336124583
275	78	15	2	13	58.9058633235
275	79	2	0	2	51.8539870716
275	81	10	0	10	53.4051538282
275	82	18	0	18	56.618192084
275	83	3	0	3	56.3925489737
275	84	7	0	7	56.8526117528
275	85	9	0	9	60.3328993406
275	87	13	0	13	60.3763430463
275	88	2	0	2	62.083466326
275	89	3	1	2	44.1468354083
275	90	7	0	7	60.3444554155
275	92	11	0	11	48.9397941472
275	95	2	1	1	51.7019921516
275	96	4	0	4	59.3784211905
275	97	1	0	1	52.1287343944
275	100	1	0	1	47.7817424324
275	101	1	0	1	40.9286614898
275	102	1	0	1	42.3710477187
275	103	8	1	7	58.0321728041
275	106	1	0	1	38.6901612238
275	110	2	0	2	60.599684827
275	111	2	1	1	44.046836496
275	112	8	0	8	56.0212884344
275	113	18	1	17	62.3142249442
275	115	0	0	0	43.5835615122
275	116	3	0	3	57.3087642139
275	118	1	0	1	61.1396669269
275	120	2	0	2	49.4476661146
275	123	1	0	1	39.0024615962
275	128	1	0	1	81.9380210495
275	129	1	0	1	62.3148675337
275	142	9	2	7	75.6215522897
275	146	1	0	1	67.4360818886
275	151	2	0	2	89.5642297076
275	155	2	0	2	69.2116985435
275	164	2	0	2	69.7360950929
275	181	3	0	3	25.9286504033
275	183	35	5	30	35.9186856037
275	184	8	0	8	29.1614151865
275	185	1	0	1	42.9537066939
275	186	6	0	6	33.4522378195
275	188	2	0	2	40.0873180133
275	190	6	1	5	34.649925358
275	191	1	0	1	60.5905428191
275	196	2	0	2	67.1094694407
275	199	2	0	2	58.7811410556
275	200	2	0	2	58.128131983
275	202	1	0	1	60.058733219
275	206	2	1	1	41.1326795014
275	207	4	1	3	41.8704571812
275	208	14	2	12	49.2223148659
275	209	2	0	2	43.8702351989
275	210	1	0	1	43.9135398306
275	212	13	3	10	36.1865174774
275	214	2	0	2	46.0806602209
275	220	7	0	7	55.0086352822
275	225	3	0	3	42.9630453655
275	228	1	0	1	52.8197258265
275	229	11	3	8	46.2783787516
275	230	1	0	1	52.5994489944
275	231	2	0	2	29.851799261
275	234	1	0	1	34.742000079
275	235	3	1	2	24.7766246946
275	236	5	0	5	28.4680036548
275	237	6	0	6	35.0735575323
275	238	1	0	1	32.6497932677
275	242	1	0	1	71.7078889934
275	244	1	0	1	73.6691303903
275	245	29	6	23	33.5265045019
275	247	1	0	1	42.7157494553
275	250	3	1	2	25.7726173003
275	251	4	1	3	40.9446422286
275	253	2	0	2	31.4072629429
275	254	5	1	4	29.9928347768
275	255	3	2	1	22.3756895157
275	256	1	0	1	37.2932303579
275	257	7	3	4	29.6595856016
275	258	7	1	6	31.0207327765
275	259	9	8	1	16.6501703327
275	260	1	0	1	33.2563170293
275	262	36	3	33	20.0629488005
275	263	2	0	2	23.5066184937
275	264	12	0	12	24.4010597591
275	265	224	12	212	9.34002191953
275	266	285	61	224	11.6383800116
275	267	72	0	72	9.14450057944
275	268	26	2	24	18.9759870094
275	269	9	3	6	15.7451984943
275	270	240	21	219	9.35698751571
275	271	50	8	42	19.7292087648
275	272	69	1	68	21.6482052287
275	273	5	0	5	17.7257038876
275	274	42	0	42	13.0978856995
275	276	15	0	15	23.8996874183
275	277	5555	274	5281	7.76123182312
275	278	5	0	5	17.9447058669
275	279	26	0	26	11.3228574131
275	280	103	2	101	7.42579576128
275	281	53	0	53	17.4120877412
275	282	90	38	52	18.9317883566
275	283	5	0	5	17.0876829064
275	284	35	12	23	21.8272219046
275	285	28	2	26	14.3674038326
275	286	3	2	1	23.5823697586
275	287	26	10	16	16.0384261604
275	288	73	25	48	6.93729710631
275	289	21	7	14	12.2362244413
275	290	22	15	7	10.770340463
275	291	4	0	4	28.2128835767
275	292	3	0	3	29.0104491942
275	293	27	1	26	32.8074952012
275	294	4	0	4	44.3416645093
275	295	1	0	1	26.8144338899
275	296	0	0	0	38.5747903429
275	297	1	0	1	42.3255695238
275	298	1	0	1	35.157320213
275	303	33	0	33	38.6351811476
275	304	1	0	1	40.7567699754
275	305	43	1	42	17.9935282271
275	306	3	0	3	30.2011620122
275	307	25	0	25	28.0366074981
275	308	6	2	4	23.636932594
275	309	11	1	10	34.7516621607
275	323	1	0	1	93.5482395422
275	338	1	0	1	79.0479151054
275	345	1	0	1	55.4475891856
275	375	2	0	2	62.2953041545
275	394	1	0	1	134.802759272
275	429	1	0	1	169.076418691
275	466	3	0	3	126.448079223
275	471	1	0	1	107.701144523
275	475	3	0	3	111.041602724
275	476	2	0	2	95.6030315073
275	489	1	1	0	126.058874459
275	491	1	0	1	119.279551755
275	502	1	0	1	137.202059376
275	535	1	0	1	188.565245072
275	563	0	0	0	125.730369983
275	566	1	0	1	119.708639033
276	0	2	0	2	53.7261061274
276	1	40	4	36	60.4189343861
276	13	3	1	2	57.3552770699
276	15	1	0	1	60.7156659901
276	21	1	0	1	68.5104451
276	24	1	0	1	65.9403335021
276	28	4	1	3	55.3918562232
276	32	1	0	1	43.1753960581
276	36	2	1	1	54.6887037908
276	39	2	0	2	45.9984308258
276	41	1	0	1	61.3773275944
276	45	1	0	1	107.789551937
276	46	1	0	1	90.261447852
276	65	0	0	0	98.2269526651
276	70	14	1	13	44.0534629094
276	71	3	1	2	54.4599149644
276	73	125	3	122	48.788502297
276	74	5	1	4	50.8871902966
276	75	7	0	7	51.1908354976
276	76	8	0	8	46.6120437029
276	78	20	3	17	49.9649579289
276	79	1	0	1	44.9071482303
276	81	5	0	5	45.1499379205
276	82	12	0	12	47.5624157202
276	83	4	0	4	48.7032985349
276	84	12	3	9	49.7088719895
276	85	4	0	4	49.906988403
276	87	2	0	2	53.1180607518
276	88	3	0	3	54.2620718776
276	89	2	0	2	37.2296425313
276	90	2	0	2	47.6263142195
276	92	4	2	2	39.3759271386
276	95	3	0	3	48.4615390498
276	96	4	0	4	44.8208182476
276	99	1	0	1	61.3546887945
276	101	1	0	1	29.422187131
276	102	2	0	2	42.3710014653
276	103	7	0	7	53.2691884562
276	105	1	0	1	39.433278795
276	106	1	0	1	34.9019167262
276	109	1	0	1	42.3008754824
276	110	1	0	1	57.0449381871
276	111	4	0	4	33.9818605338
276	112	11	0	11	52.4573762727
276	113	10	0	10	56.5481438887
276	115	1	0	1	30.6329298486
276	116	1	0	1	46.2826750714
276	120	1	0	1	43.7933520649
276	124	1	0	1	82.8678050585
276	140	3	0	3	62.1005379777
276	142	4	1	3	71.7507348539
276	145	1	0	1	73.4291364538
276	146	1	0	1	60.0701635487
276	169	1	0	1	44.328364913
276	171	1	0	1	56.0312478922
276	175	1	0	1	61.0577079526
276	181	1	0	1	34.6998428293
276	183	14	3	11	47.6518721011
276	184	2	0	2	43.8057585953
276	186	1	0	1	38.2509460252
276	187	0	0	0	43.8908633472
276	188	1	0	1	44.3936036604
276	190	1	0	1	51.7922425711
276	196	3	1	2	58.0638869983
276	204	2	1	1	19.5803575083
276	206	3	0	3	24.3827405266
276	207	8	1	7	27.5049233185
276	208	22	3	19	32.8501363804
276	209	1	0	1	30.0314009866
276	210	2	0	2	32.1628399905
276	211	3	0	3	40.2570820214
276	212	14	6	8	20.582108915
276	213	2	1	1	37.5153765688
276	214	3	0	3	27.0606874737
276	220	2	0	2	61.556419588
276	222	2	0	2	57.739376025
276	229	9	0	9	38.7044009634
276	231	3	1	2	19.7368045111
276	232	1	0	1	27.4811387494
276	235	1	0	1	25.4537166777
276	236	4	0	4	24.1373135834
276	237	4	0	4	22.4226416474
276	242	1	0	1	73.0214200662
276	243	1	0	1	67.7767981053
276	244	1	0	1	72.6616450988
276	245	24	0	24	26.9153791689
276	246	1	0	1	26.5528774778
276	247	9	2	7	22.604691449
276	248	2	1	1	22.1340424694
276	249	1	0	1	15.901759117
276	250	3	1	2	18.6858175403
276	251	4	0	4	25.1541816998
276	252	7	1	6	13.3414330334
276	253	50	4	46	10.8261365401
276	254	6	1	5	18.6978154817
276	255	2	0	2	23.7824054564
276	256	1	0	1	37.1304791201
276	257	10	1	9	30.4057423332
276	258	2	0	2	35.8669428894
276	259	2	0	2	18.780878069
276	260	2	0	2	31.1744353645
276	261	1	0	1	34.4559481177
276	262	31	23	8	14.8499166514
276	263	1	0	1	20.310013547
276	264	5	2	3	28.9542355403
276	265	2	0	2	33.2389012399
276	266	5	0	5	30.7518196814
276	268	4	0	4	34.1615499198
276	270	4	1	3	31.2546064077
276	271	9	0	9	23.6405946856
276	272	140	3	137	13.6782237842
276	273	31	5	26	6.43589330955
276	274	18	7	11	15.4786343952
276	275	12	0	12	23.8996874183
276	277	1358	353	1005	16.4222789528
276	279	6	1	5	22.7856335807
276	280	7	0	7	19.6039048068
276	281	31	17	14	10.8403462045
276	282	135	5	130	6.36419709652
276	284	290	30	260	6.15559546669
276	285	10	1	9	17.0579042681
276	286	26	2	24	7.9001806152
276	287	13	6	7	10.0114907467
276	288	3	0	3	25.3906026256
276	289	1	0	1	30.892661347
276	290	2	0	2	23.7235165301
276	291	14	3	11	14.9541102793
276	292	45	10	35	11.1925568858
276	293	282	13	269	9.5336655197
276	294	22	0	22	20.6702029288
276	295	89	15	74	4.99568941694
276	296	6	1	5	15.4300352205
276	297	7	0	7	19.870679992
276	298	7	0	7	14.2520846031
276	299	1	0	1	10.7859560319
276	300	1	0	1	17.3388177359
276	301	4	0	4	15.1981474447
276	302	41	2	39	6.34742522191
276	303	1	0	1	52.5382247527
276	304	8	0	8	49.4545399584
276	305	12	1	11	28.1603303426
276	306	2	0	2	45.1074076961
276	307	12	1	11	39.5298762005
276	308	1	0	1	39.6072326019
276	309	1	0	1	42.8943941443
276	321	1	0	1	68.6241456006
276	328	1	0	1	67.314591772
276	345	1	0	1	37.2852699314
276	346	1	0	1	56.5916289676
276	350	2	0	2	26.2050006442
276	375	1	0	1	39.8859394528
276	466	0	0	0	126.860471027
277	0	38	0	38	46.3290159766
277	1	1276	9	1267	49.6957274126
277	2	4	0	4	56.1718385291
277	3	10	2	8	45.2821849744
277	4	1	0	1	54.7666868321
277	5	21	0	21	60.0253639528
277	6	3	0	3	69.309425617
277	7	22	4	18	50.2232181252
277	9	3	0	3	43.6070314408
277	11	1	0	1	63.0881336069
277	12	4	0	4	57.7786740816
277	13	35	2	33	50.5302138702
277	15	35	0	35	52.5400937683
277	16	3	0	3	42.7825436276
277	17	1	0	1	61.8049556863
277	18	2	0	2	48.6472063298
277	19	15	0	15	43.4573706134
277	20	3	0	3	63.0402697819
277	21	17	2	15	58.5328831619
277	23	12	1	11	57.8495046292
277	24	7	0	7	57.2949224268
277	25	2	0	2	70.5489203524
277	26	1	0	1	68.2759173268
277	28	73	9	64	44.9359502454
277	30	0	0	0	65.1187724516
277	31	1	0	1	59.4044552943
277	32	36	0	36	36.2250868899
277	33	7	0	7	55.156303794
277	34	5	0	5	70.6241314424
277	35	8	0	8	59.4643434035
277	36	165	12	153	50.9300380596
277	37	1	1	0	66.0547803022
277	38	1	1	0	63.7256585513
277	39	38	8	30	40.5545548974
277	40	1	0	1	35.4292523369
277	41	4	0	4	56.6861731819
277	42	20	11	9	45.0024981508
277	46	12	0	12	81.0418059881
277	47	1	0	1	99.1766548429
277	48	8	0	8	88.5083331987
277	49	2	1	1	71.7201922546
277	50	7	2	5	77.5907429246
277	52	1	0	1	80.9696283106
277	53	2	0	2	82.9461660296
277	55	4	0	4	86.9172662916
277	56	4	0	4	79.9158192493
277	58	3	0	3	86.2721455788
277	59	7	0	7	101.133126628
277	60	11	0	11	81.6046811037
277	65	3	0	3	89.2597885326
277	68	2	0	2	80.8696705798
277	69	1	0	1	89.4814367857
277	70	267	0	267	48.2310695768
277	71	57	3	54	57.9584336764
277	72	31	1	30	46.1425726474
277	73	3059	228	2831	50.7306136936
277	74	154	0	154	54.0262403336
277	75	223	2	221	53.0461544398
277	76	110	0	110	50.9784455049
277	77	12	9	3	46.5568997988
277	78	284	55	229	53.5860229216
277	79	62	2	60	46.9138283601
277	80	11	0	11	48.0705245794
277	81	166	32	134	48.1599480876
277	82	330	11	319	51.2317767476
277	83	128	0	128	51.3495798091
277	84	423	28	395	51.9608834352
277	85	68	17	51	54.6696539285
277	86	59	1	58	58.0872796478
277	87	112	0	112	55.5143083708
277	88	61	1	60	57.0994610968
277	89	83	4	79	39.0113369561
277	90	31	3	28	54.1528327483
277	92	195	36	159	43.2767544575
277	93	1	0	1	40.2217966179
277	94	3	0	3	41.7050919753
277	95	59	3	56	47.7888881608
277	96	43	0	43	52.7860195782
277	98	2	0	2	61.6657278225
277	99	1	0	1	60.2949302493
277	100	3	0	3	44.699032851
277	101	8	0	8	34.6172926205
277	102	16	0	16	39.1753391708
277	103	134	3	131	53.8130966369
277	104	5	0	5	43.1687817976
277	105	3	0	3	38.9828005337
277	106	4	0	4	34.2009937786
277	107	5	0	5	65.8820066657
277	108	1	0	1	47.1713721678
277	109	21	0	21	48.4134707179
277	110	34	1	33	56.7729395303
277	111	64	13	51	38.142165666
277	112	114	7	107	52.1076549827
277	113	251	13	238	57.8867965504
277	114	3	0	3	52.3343024289
277	115	7	0	7	37.0524028416
277	116	19	1	18	51.4589522078
277	117	4	0	4	58.1251803908
277	118	5	0	5	55.2442998352
277	119	8	4	4	58.4270394462
277	120	24	0	24	44.7967074376
277	121	2	0	2	59.5803949864
277	122	10	1	9	42.2695009405
277	123	4	0	4	33.2424017194
277	124	2	0	2	80.2390645117
277	128	2	0	2	77.890736559
277	129	3	0	3	59.3707703144
277	131	5	0	5	94.320135077
277	134	2	0	2	67.0031152143
277	135	2	0	2	87.1030336769
277	140	11	0	11	62.5202786093
277	141	1	0	1	100.215416456
277	142	158	2	156	71.9048766939
277	144	2	0	2	73.0696753746
277	145	2	0	2	71.5891176983
277	146	7	2	5	62.645617018
277	147	3	0	3	90.1031940564
277	150	1	0	1	96.467684234
277	151	1	0	1	87.3556647575
277	152	1	0	1	83.6759420731
277	154	1	0	1	80.0525564243
277	155	4	0	4	62.7778429719
277	156	2	0	2	58.8625454642
277	164	12	0	12	64.0600764869
277	166	7	1	6	68.0877539113
277	167	1	0	1	89.3393867866
277	168	5	0	5	68.5353722121
277	169	2	0	2	53.7747999323
277	171	10	2	8	62.5131748069
277	172	1	0	1	72.7740886577
277	175	1	0	1	67.6070453519
277	177	7	0	7	74.0607731529
277	179	1	0	1	53.062311224
277	181	37	2	35	28.4478898191
277	182	13	0	13	47.9190019992
277	183	514	22	492	40.001469624
277	184	24	0	24	34.0868390914
277	185	19	0	19	45.7062281549
277	186	52	1	51	34.9483320705
277	187	21	0	21	44.0520700439
277	188	22	1	21	41.698591794
277	189	2	0	2	45.9956803931
277	190	33	3	30	40.6061378313
277	191	7	2	5	60.9809199877
277	192	1	0	1	59.1582917596
277	193	2	0	2	53.2491268858
277	194	6	0	6	50.9000124478
277	195	2	0	2	67.6764305266
277	196	68	1	67	64.9638973392
277	198	2	0	2	76.2137914002
277	199	4	0	4	55.3360772629
277	200	4	0	4	55.5983662645
277	202	1	0	1	58.4550755795
277	204	24	2	22	33.1136771898
277	205	14	2	12	38.1248591516
277	206	11	3	8	36.0372823363
277	207	34	0	34	37.5037229269
277	208	292	226	66	44.4430820158
277	209	47	1	46	39.7274886455
277	210	4	0	4	40.4099830738
277	211	33	1	32	50.8473700597
277	212	175	38	137	31.2325381206
277	213	25	0	25	47.1696900815
277	214	37	0	37	40.4270299653
277	215	1	0	1	45.9418923642
277	216	3	1	2	55.2089201725
277	217	3	0	3	55.2862247964
277	218	2	0	2	48.7429238695
277	219	8	0	8	62.4030306144
277	220	142	8	134	57.7572175764
277	221	4	1	3	51.3169554271
277	222	15	3	12	51.5463339033
277	223	10	1	9	45.9737089138
277	224	14	3	11	36.7157178384
277	225	39	4	35	40.1871469191
277	226	5	4	1	46.2232361714
277	227	3	0	3	40.8361468018
277	228	1	0	1	50.1315567111
277	229	96	7	89	44.1633488816
277	230	3	0	3	51.2332167736
277	231	16	0	16	26.0660339346
277	232	14	11	3	33.0985384623
277	233	9	0	9	31.5335539483
277	234	24	1	23	33.1881072732
277	235	25	0	25	24.0841331447
277	236	128	1	127	26.4006898846
277	237	77	0	77	30.9123628427
277	238	12	0	12	32.5755442784
277	239	13	0	13	37.9729120167
277	241	5	0	5	79.359222498
277	242	21	4	17	72.9860055904
277	243	8	1	7	67.1475274095
277	244	7	2	5	74.2168552112
277	245	505	14	491	28.0181859028
277	246	23	7	16	31.2987330842
277	247	62	2	60	35.092494679
277	248	7	0	7	28.2270948979
277	249	14	0	14	25.5187344361
277	250	26	8	18	19.5497438913
277	251	106	9	97	33.8480646954
277	252	23	1	22	19.1069361754
277	253	90	27	63	23.6658284898
277	254	80	0	80	23.2471500646
277	255	24	12	12	18.2410188977
277	256	24	1	23	33.8375848285
277	257	190	0	190	26.04666914
277	258	27	0	27	28.965188818
277	259	93	38	55	11.6468656412
277	260	25	18	7	28.9872257712
277	261	16	1	15	24.8953798889
277	262	520	93	427	13.472133826
277	263	23	0	23	18.0255624728
277	264	193	7	186	21.7045109784
277	265	110	22	88	17.0095015785
277	266	324	156	168	17.5374417042
277	267	29	6	23	16.3717812224
277	268	65	5	60	23.6232974183
277	269	7	2	5	22.9988494508
277	270	323	39	284	15.0289867139
277	271	201	23	178	19.5904973862
277	272	749	0	749	17.3516424641
277	273	123	17	106	10.6100953989
277	274	716	155	561	6.75488933858
277	275	760	308	452	7.76123182312
277	276	172	0	172	16.4222789528
277	278	29	0	29	20.2058767961
277	279	430	61	369	9.72711938728
277	280	195	40	155	7.57918116178
277	281	552	441	111	9.94067490795
277	282	1009	11	998	11.1792641302
277	283	18	5	13	19.4610771565
277	284	519	10	509	15.3573588293
277	285	203	8	195	12.1435686982
277	286	82	18	64	15.8913866134
277	287	299	14	285	10.2052705127
277	288	52	1	51	11.8410077837
277	289	78	11	67	15.6604827091
277	290	56	1	55	13.1466050042
277	291	70	0	70	23.3578387733
277	292	133	14	119	23.048560171
277	293	395	54	341	25.63855776
277	294	86	6	80	37.0485483741
277	295	23	9	14	19.8331737161
277	296	16	6	10	30.8350279819
277	297	10	0	10	35.5306874384
277	298	5	1	4	28.712537974
277	299	4	1	3	27.0374645793
277	300	1	0	1	30.9007573974
277	301	10	0	10	31.6151291108
277	302	24	0	24	21.9314611395
277	303	94	13	81	40.6229690935
277	304	16	0	16	40.613483055
277	305	424	91	333	17.0353251363
277	306	6	0	6	32.4166533285
277	307	460	0	460	28.5644105937
277	308	22	1	21	26.1324469879
277	309	66	0	66	34.1712899265
277	310	4	1	3	48.5012861461
277	319	4	0	4	88.1547599106
277	320	1	0	1	93.9200131075
277	326	1	0	1	73.9951334713
277	329	2	0	2	69.6854232233
277	338	9	2	7	71.3149345453
277	339	1	0	1	71.4221567379
277	341	2	0	2	65.5216275395
277	345	18	2	16	50.2070210239
277	346	4	0	4	66.321213833
277	348	1	0	1	49.033927319
277	349	1	0	1	73.3918604451
277	350	1	0	1	40.9518273578
277	353	0	0	0	60.6559265231
277	369	2	1	1	60.4621283238
277	371	1	0	1	52.8277942801
277	373	1	0	1	61.6674480311
277	375	16	4	12	55.6277467144
277	378	1	0	1	40.4872951246
277	385	1	0	1	122.677273134
277	396	1	0	1	132.329642058
277	401	1	0	1	144.833109135
277	406	1	0	1	139.057307154
277	408	2	0	2	139.89552731
277	415	1	0	1	129.756251685
277	416	1	0	1	146.133588001
277	437	1	0	1	190.488213146
277	453	1	0	1	126.235348735
277	464	1	0	1	105.577463788
277	465	2	0	2	119.820213802
277	466	10	0	10	124.36842302
277	469	5	0	5	111.843836304
277	471	13	0	13	106.63210384
277	472	2	0	2	102.338647581
277	474	2	0	2	129.091150624
277	475	3	0	3	107.625516848
277	476	2	0	2	93.9731462703
277	477	1	0	1	115.851776391
277	478	2	0	2	130.424024871
277	480	5	0	5	109.531903824
277	481	1	0	1	128.92512313
277	488	3	0	3	121.399779584
277	491	3	0	3	117.696454638
277	495	1	0	1	128.614849902
277	502	1	0	1	134.207889269
277	503	1	0	1	126.471218304
277	505	3	0	3	137.089797833
277	507	2	0	2	213.872804863
277	515	1	0	1	177.599791432
277	523	0	0	0	166.741481132
277	547	1	0	1	198.53725299
277	555	1	0	1	125.655230809
277	565	1	0	1	160.129347627
277	569	0	0	0	101.559480946
277	573	5	0	5	105.709388373
277	579	1	0	1	94.6794331584
277	583	0	0	0	127.045782519
278	1	15	5	10	65.9398235846
278	6	1	0	1	85.0111263228
278	12	1	0	1	72.636489063
278	13	1	0	1	69.3330755826
278	17	2	0	2	79.739918874
278	21	1	0	1	75.0923918965
278	46	1	0	1	97.6707910398
278	59	2	0	2	119.139339464
278	70	5	1	4	67.9224600101
278	73	39	0	39	70.824997749
278	74	2	0	2	73.9752006763
278	75	5	0	5	73.1607561245
278	78	4	0	4	73.4447475855
278	80	0	0	0	68.0503624768
278	81	2	0	2	68.0866137394
278	82	6	1	5	71.0621202435
278	84	5	1	4	72.0258918886
278	85	2	0	2	74.2801070315
278	87	2	0	2	75.5799822747
278	92	4	1	3	62.9728534642
278	95	1	0	1	67.9898310297
278	102	1	0	1	59.2308668682
278	103	1	0	1	74.0126624881
278	112	2	0	2	72.310421563
278	113	3	0	3	78.0590727011
278	142	6	0	6	92.1019442229
278	152	1	0	1	103.734683438
278	181	127	5	122	8.26044543981
278	182	2	0	2	28.5980630555
278	183	134	27	107	20.2655852237
278	184	22	7	15	15.8559999283
278	185	3	0	3	25.5334271107
278	186	45	44	1	15.5105169097
278	187	4	1	3	26.0673196225
278	188	12	0	12	22.1502237615
278	190	14	5	9	24.1116335787
278	191	4	1	3	42.7918456759
278	194	1	0	1	33.6357728304
278	196	1	0	1	51.3435027
278	200	1	0	1	43.1236054684
278	202	1	0	1	43.7708425491
278	206	1	0	1	32.8200527211
278	207	1	0	1	31.564182714
278	208	2	0	2	39.2501504828
278	212	2	0	2	28.2060990818
278	214	1	0	1	38.8524653003
278	216	1	0	1	35.0044730796
278	217	1	0	1	35.5279898976
278	218	1	0	1	29.4718236293
278	219	0	0	0	42.6947640217
278	220	23	0	23	37.6078983153
278	225	1	0	1	29.1455763554
278	227	1	0	1	24.3161452183
278	228	1	0	1	38.2642619568
278	229	8	0	8	31.1300954245
278	231	1	0	1	20.2040793059
278	232	1	0	1	22.9755233618
278	234	2	0	2	19.5843151198
278	235	15	12	3	9.88852384121
278	236	19	0	19	15.3160542926
278	237	2	1	1	25.2241986222
278	238	13	4	9	15.6552090795
278	239	3	0	3	24.1607491853
278	243	2	0	2	47.7709114133
278	245	5	1	4	47.9660028492
278	246	1	0	1	50.5230107614
278	247	1	0	1	50.4724304018
278	253	1	0	1	38.5108525993
278	256	1	0	1	53.9448070236
278	257	2	0	2	46.1568691223
278	262	3	0	3	33.0621239256
278	264	5	1	4	41.4571021387
278	265	15	0	15	21.155909097
278	266	146	12	134	10.3325235773
278	267	7	4	3	14.8495979257
278	268	110	1	109	7.27894216977
278	269	5	0	5	16.7628209765
278	270	5	0	5	25.973475516
278	271	436	193	243	6.07325166805
278	272	49	0	49	16.4684882143
278	274	3	0	3	26.8685032925
278	275	19	1	18	17.9447058669
278	276	6	0	6	27.9630686956
278	277	348	68	280	20.2058767961
278	279	3	0	3	28.5062920948
278	280	19	3	16	12.6602536282
278	281	6	0	6	28.4467998558
278	282	7	0	7	26.8189710429
278	284	5	0	5	22.4624384093
278	285	22	4	18	10.9671136171
278	286	0	0	0	32.3970600609
278	287	9	1	8	18.1624373427
278	288	12	8	4	11.2454612614
278	289	1	0	1	29.8953203276
278	290	46	1	45	7.34696821042
278	291	2	1	1	21.7815070155
278	292	3	1	2	25.5899040785
278	293	6	1	5	33.2465528987
278	295	1	0	1	27.6648452949
278	296	1	0	1	42.9826278829
278	305	3	0	3	35.6602547394
278	307	4	0	4	45.978225625
278	309	0	0	0	52.6448446322
278	346	1	0	1	55.9546413414
278	375	1	0	1	57.5289769295
278	464	1	0	1	124.867630628
278	466	1	0	1	144.055683415
278	488	1	0	1	140.298971535
279	0	5	1	4	36.8269736894
279	1	160	9	151	40.0133800829
279	3	1	0	1	36.0452706037
279	5	2	0	2	50.3837039296
279	7	7	0	7	40.6271823407
279	9	2	0	2	34.0258296902
279	12	2	0	2	48.2686449967
279	13	5	0	5	41.0952683555
279	15	3	0	3	42.8931201157
279	16	1	0	1	33.4291948378
279	19	1	0	1	33.996410224
279	22	1	0	1	44.0297801651
279	23	3	0	3	48.1264596578
279	25	1	0	1	61.0448741865
279	27	2	0	2	59.2245313276
279	28	11	1	10	35.2244551004
279	32	5	1	4	26.9638856852
279	33	1	0	1	45.9074716678
279	34	1	0	1	61.510935894
279	35	2	0	2	50.0879850614
279	36	19	2	17	42.2829593699
279	39	2	0	2	31.6120083531
279	41	1	0	1	47.67707705
279	42	1	0	1	36.1538573731
279	46	2	0	2	71.3150686084
279	49	2	0	2	62.143347451
279	60	1	0	1	72.1087621162
279	65	1	0	1	79.5327465431
279	69	0	0	0	80.2990580456
279	70	10	0	10	43.1486375191
279	72	3	0	3	40.4809202053
279	73	112	0	112	44.4064307262
279	74	6	1	5	48.1677509821
279	75	11	0	11	46.5976343557
279	76	7	0	7	45.8719427567
279	77	2	1	1	40.6228265607
279	78	14	2	12	47.9870317135
279	79	1	0	1	40.7803214832
279	80	3	1	2	42.2187621991
279	81	8	5	3	42.4718164376
279	82	11	0	11	45.7490098485
279	83	13	1	12	45.3448130079
279	84	8	1	7	45.7402857329
279	85	5	1	4	49.6278917782
279	86	2	0	2	52.589768134
279	87	5	0	5	49.2424677582
279	89	6	0	6	33.2155106143
279	90	1	0	1	50.1112453359
279	92	17	6	11	38.3153447676
279	96	1	0	1	49.6569147611
279	100	1	0	1	36.5049368537
279	102	3	0	3	31.0703363789
279	103	15	4	11	46.7425964707
279	104	1	0	1	35.7494284225
279	109	3	1	2	44.3920198365
279	110	2	0	2	49.2774061407
279	111	2	0	2	33.6902627095
279	112	7	1	6	44.7033466599
279	113	23	6	17	51.0550894836
279	120	2	0	2	38.2762087746
279	123	1	0	1	28.5915566794
279	129	1	0	1	51.0844532552
279	134	1	0	1	59.25357512
279	140	1	0	1	55.1833900521
279	142	7	1	6	64.3008829937
279	146	0	0	0	56.2622004031
279	154	2	0	2	73.2729004766
279	156	1	0	1	55.8181650154
279	171	1	0	1	58.1623525929
279	183	19	1	18	47.1996158872
279	186	7	0	7	43.8008006967
279	187	1	0	1	53.4013829203
279	190	2	1	1	45.7220235218
279	194	1	0	1	60.4096303109
279	196	3	0	3	74.6821761696
279	208	11	2	9	53.4757932622
279	209	2	0	2	49.0926170298
279	211	1	0	1	60.1434818146
279	212	1	0	1	40.3017747937
279	213	4	0	4	56.59997972
279	214	1	0	1	48.8771077238
279	219	1	0	1	71.1723556323
279	220	3	0	3	65.9995470221
279	222	1	0	1	59.0430819014
279	223	1	0	1	55.6307512166
279	224	1	0	1	46.3635188212
279	227	1	0	1	50.3879251501
279	229	5	0	5	53.889578088
279	232	1	0	1	42.795473825
279	236	4	0	4	36.11987963
279	237	1	0	1	40.338516499
279	238	1	0	1	41.9947882433
279	239	1	0	1	47.6844916408
279	242	2	0	2	82.0477270533
279	244	1	0	1	83.5581811161
279	245	32	2	30	23.0106100778
279	247	4	1	3	36.1222961593
279	250	4	0	4	16.4430574277
279	251	4	0	4	32.496158931
279	252	2	0	2	19.1809339457
279	253	5	2	3	26.4272845571
279	254	6	4	2	21.2546404617
279	255	6	1	5	11.3195622989
279	256	4	0	4	25.970675411
279	257	36	13	23	18.3520613945
279	258	7	0	7	19.9594776722
279	259	44	25	19	7.00588769208
279	260	8	0	8	22.0571254632
279	261	6	1	5	15.3094555563
279	262	85	32	53	12.1130906704
279	263	10	0	10	13.4159619715
279	264	53	4	49	13.109152393
279	265	8	2	6	16.9987424339
279	266	19	0	19	22.9298083765
279	267	3	0	3	19.8335568615
279	268	7	2	5	30.2780680368
279	269	1	0	1	26.0260205825
279	270	87	1	86	11.2021319392
279	271	11	1	10	28.9013200613
279	272	20	2	18	26.9105906311
279	273	7	3	4	18.5109246606
279	274	164	38	126	7.34552710016
279	275	63	26	37	11.3228574131
279	276	14	0	14	22.7856335807
279	277	2951	910	2041	9.72711938728
279	280	8	1	7	16.1603825649
279	281	44	2	42	12.543034475
279	282	67	0	67	16.4648883644
279	283	13	0	13	10.7363287607
279	284	24	1	23	23.7206790223
279	285	4	0	4	21.7791270169
279	286	9	0	9	18.7412360642
279	287	16	3	13	19.4328302864
279	288	1	0	1	18.1117430857
279	289	47	1	46	8.67094472278
279	290	2	0	2	21.1601941446
279	291	5	2	3	32.6051787728
279	292	2	0	2	31.5711428137
279	293	23	10	13	32.3080655376
279	294	3	0	3	43.0174794216
279	295	2	0	2	27.1862792731
279	296	0	0	0	34.6410186834
279	297	1	0	1	42.651577881
279	298	2	0	2	36.5370686205
279	301	3	1	2	37.4395305756
279	302	1	0	1	26.7919593052
279	303	25	0	25	31.091091774
279	304	5	0	5	30.9505513765
279	305	367	24	343	7.37400095954
279	306	4	0	4	23.0498115399
279	307	115	44	71	18.8427656101
279	308	2	0	2	17.0598247164
279	309	12	1	11	24.5754401204
279	310	1	0	1	51.9117824425
279	329	2	0	2	68.0152056764
279	345	1	0	1	58.8952039014
279	464	1	0	1	96.4402996602
279	471	1	0	1	97.3198392751
279	472	1	0	1	93.5019145642
279	491	2	0	2	108.61264734
279	573	1	0	1	101.040355423
280	0	1	0	1	52.952479707
280	1	34	7	27	55.1257135521
280	5	0	0	0	65.2272228252
280	7	2	0	2	56.6774214742
280	13	3	0	3	57.2423118785
280	15	1	0	1	58.8662108646
280	21	1	0	1	64.1549369009
280	28	3	0	3	50.5673353968
280	35	2	0	2	66.2439526678
280	36	3	0	3	58.1980607121
280	39	2	0	2	47.6673406228
280	46	1	0	1	86.7597916241
280	50	1	0	1	84.1845980036
280	52	1	0	1	88.0688733163
280	55	1	0	1	93.1518526462
280	65	1	0	1	95.0225754839
280	70	6	0	6	55.6864095938
280	71	2	1	1	65.4861548903
280	72	1	0	1	53.672506796
280	73	70	1	69	58.301620113
280	74	8	1	7	61.5633312959
280	75	10	0	10	60.6207318935
280	76	5	1	4	58.4301202259
280	78	10	0	10	61.0971587585
280	79	1	0	1	54.4782450916
280	81	4	0	4	55.6890392787
280	82	10	1	9	58.7333753348
280	83	5	0	5	58.9016136909
280	84	10	1	9	59.5262030495
280	85	2	0	2	62.1023640575
280	87	2	0	2	63.0801870756
280	89	1	0	1	46.5646711907
280	90	2	0	2	61.3913183078
280	92	4	0	4	50.7298938028
280	95	2	0	2	55.3348431348
280	96	2	0	2	59.7953055013
280	102	1	0	1	46.5946106156
280	103	6	0	6	61.3855092429
280	104	1	0	1	50.7082751722
280	107	1	0	1	73.4050560502
280	111	1	0	1	45.5391892574
280	112	4	0	4	59.6569143167
280	113	5	0	5	65.465790862
280	120	2	0	2	52.3752139283
280	133	1	0	1	72.6457772517
280	140	1	0	1	70.0808048441
280	142	0	0	0	79.4441902568
280	144	1	0	1	80.6483623078
280	156	2	0	2	65.8134119677
280	171	1	0	1	69.7931878891
280	181	3	1	2	20.917680395
280	182	1	0	1	40.4447142922
280	183	29	3	26	32.4509406182
280	184	6	0	6	26.7386073134
280	186	2	0	2	27.6830040342
280	187	1	0	1	37.2940575823
280	188	1	0	1	34.4275966781
280	190	3	0	3	33.6787554032
280	191	0	0	0	54.2433597834
280	196	2	0	2	59.8344979411
280	199	1	0	1	51.355531174
280	204	1	0	1	32.3870837886
280	205	1	0	1	37.9510511251
280	207	1	0	1	34.5455461918
280	208	5	0	5	41.9713453906
280	209	3	0	3	36.5015709097
280	211	1	0	1	47.6292602227
280	212	4	0	4	29.0528410517
280	213	2	1	1	43.6111801009
280	214	2	1	1	39.1850187394
280	220	3	0	3	50.2571361064
280	225	2	1	1	35.5624758559
280	227	1	0	1	34.4937389704
280	229	1	0	1	38.9782532005
280	231	1	0	1	22.4758557556
280	232	1	0	1	28.5206967347
280	235	2	0	2	17.7576093581
280	236	3	0	3	21.1176349051
280	237	1	0	1	27.7342857428
280	238	1	0	1	25.963904867
280	239	1	0	1	32.4010465887
280	242	1	0	1	65.8957254558
280	245	13	0	13	35.5427872438
280	247	1	0	1	40.7291672194
280	250	1	0	1	26.945885591
280	251	2	0	2	40.5061893975
280	252	2	0	2	25.772810267
280	254	8	1	7	30.3357468392
280	255	1	0	1	25.7426629409
280	257	7	3	4	33.5037020069
280	259	2	0	2	19.2058659194
280	260	2	1	1	36.5440968064
280	262	16	0	16	20.8088236486
280	263	1	0	1	25.5872801333
280	264	7	0	7	28.9029669624
280	265	12	9	3	15.3419797112
280	266	94	15	79	11.272275362
280	267	5	0	5	11.8996569186
280	268	16	4	12	16.3127418748
280	269	1	0	1	17.9598835781
280	270	19	1	18	16.7793131437
280	271	40	0	40	12.8600257315
280	272	32	2	30	14.4881704095
280	273	3	0	3	13.1739980634
280	274	14	0	14	14.3098025036
280	275	140	86	54	7.42579576128
280	276	6	0	6	19.6039048068
280	277	1747	59	1688	7.57918116178
280	278	3	0	3	12.6602536282
280	279	4	1	3	16.1603825649
280	281	15	5	10	16.6331395125
280	282	27	9	18	16.2321870602
280	284	12	0	12	16.0611438918
280	285	34	1	33	6.95225431723
280	286	1	0	1	21.6716499764
280	287	8	3	5	10.179657372
280	288	22	15	7	5.78770680722
280	289	1	0	1	19.3960658777
280	290	37	6	31	5.59022569745
280	291	4	1	3	21.1278238767
280	292	4	0	4	22.5153870504
280	293	15	0	15	27.5413529316
280	294	3	0	3	39.1024648538
280	295	4	1	3	21.4374811548
280	296	0	0	0	34.970440741
280	302	1	0	1	25.8321772389
280	303	2	0	2	45.6518594223
280	304	1	0	1	46.9210161413
280	305	10	0	10	23.4820652455
280	306	1	0	1	37.2463152658
280	307	10	0	10	34.4338007719
280	308	1	0	1	30.7154972183
280	309	2	1	1	40.657515901
280	338	2	0	2	76.1430171258
280	348	2	1	1	54.98382437
280	408	1	0	1	147.463344232
280	465	1	0	1	127.154473093
280	475	1	0	1	115.138509701
280	488	1	0	1	128.221083665
280	507	1	0	1	220.879794978
281	1	51	4	47	49.6806157881
281	5	0	0	0	60.1893023788
281	7	3	0	3	47.8796374016
281	9	1	0	1	41.3596160633
281	13	2	0	2	47.4624758051
281	19	1	0	1	40.6834818562
281	21	1	0	1	57.906269022
281	24	1	0	1	55.6024623997
281	26	1	0	1	66.1116947745
281	28	1	0	1	44.67093309
281	31	1	0	1	54.258641836
281	32	2	0	2	33.0894703983
281	34	1	0	1	66.2481485542
281	36	2	0	2	45.8935798068
281	41	1	0	1	52.2689996658
281	42	3	1	2	40.5240020891
281	46	1	0	1	79.8682489961
281	47	1	0	1	96.4679068695
281	48	1	0	1	85.1502664106
281	50	1	0	1	74.415633671
281	59	1	0	1	98.2969428016
281	70	14	4	10	39.5197470347
281	71	3	0	3	49.5850602766
281	73	181	0	181	42.8641227836
281	74	8	0	8	45.7414918148
281	75	10	0	10	45.2437580052
281	76	1	0	1	42.2404940666
281	77	1	0	1	38.4604725374
281	78	13	1	12	45.1253548425
281	79	2	0	2	38.9672666119
281	81	6	1	5	39.8489160019
281	82	18	0	18	42.7274392061
281	83	8	2	6	43.2160890621
281	84	19	0	19	43.9869808442
281	85	3	0	3	45.8469376377
281	86	1	0	1	49.5032681575
281	87	6	0	6	47.5251193721
281	88	4	0	4	48.9583529351
281	89	12	1	11	31.00743521
281	90	1	0	1	44.841411405
281	92	9	0	9	34.5820001041
281	95	1	0	1	41.0461795686
281	98	1	0	1	52.9032586513
281	103	9	2	7	46.580153816
281	104	2	0	2	36.5783693794
281	107	1	0	1	57.4484588146
281	110	2	0	2	49.9495999539
281	111	5	0	5	29.2676372693
281	112	5	0	5	45.2677373833
281	113	16	2	14	50.3519617287
281	116	2	1	1	42.4802876294
281	122	1	0	1	32.8804402384
281	129	1	0	1	53.5560921646
281	142	11	2	9	65.0081597576
281	166	1	0	1	58.2915231542
281	168	1	0	1	59.7040576414
281	171	1	0	1	53.2716626647
281	183	14	5	9	48.6811153562
281	186	1	0	1	41.8502080206
281	187	4	0	4	49.5635705902
281	188	2	0	2	48.4774222188
281	190	2	0	2	50.263027063
281	191	1	0	1	66.1552301429
281	207	2	0	2	37.344351761
281	208	11	2	9	43.262436395
281	209	1	0	1	39.8086165965
281	212	1	0	1	30.4928241476
281	214	2	0	2	37.8111247322
281	220	5	0	5	65.2004056769
281	224	2	0	2	38.4584217796
281	225	3	1	2	42.2401100039
281	229	2	0	2	46.9066920321
281	231	1	0	1	27.7252743362
281	232	2	0	2	35.4800275084
281	235	4	0	4	29.6821668602
281	236	4	0	4	30.2993217128
281	237	3	1	2	31.5331853542
281	242	1	0	1	78.8989273647
281	245	64	0	64	19.9406389016
281	246	1	0	1	22.0806005593
281	247	3	1	2	25.321034269
281	248	1	0	1	18.6072610737
281	249	2	1	1	15.5948829828
281	250	7	2	5	10.9965419649
281	251	4	2	2	23.9719431628
281	252	9	3	6	9.20560255737
281	253	14	0	14	14.3903376089
281	254	15	0	15	13.75418858
281	255	1	1	0	13.5247680372
281	257	15	2	13	20.8614503542
281	258	1	0	1	25.6653874331
281	259	11	1	10	7.95598900043
281	262	142	27	115	5.1763268938
281	263	8	1	7	10.9958785726
281	264	6	0	6	18.4913259722
281	265	1	0	1	26.2347607627
281	266	7	1	6	27.3720942421
281	267	1	0	1	26.2867342874
281	268	4	1	3	32.9375863307
281	270	7	0	7	22.4989347756
281	271	3	0	3	26.1719510105
281	272	19	1	18	19.6085936784
281	273	8	0	8	8.99310444414
281	274	40	18	22	5.33615617734
281	275	15	5	10	17.4120877412
281	276	10	0	10	10.8403462045
281	277	1623	129	1494	9.94067490795
281	279	9	5	4	12.543034475
281	280	6	1	5	16.6331395125
281	282	178	23	155	4.6344981067
281	284	28	0	28	13.7923027436
281	285	6	0	6	18.2767548406
281	286	29	6	23	6.46313094284
281	287	15	10	5	12.2719237756
281	288	1	1	0	21.6404342138
281	289	2	0	2	21.0959758929
281	290	1	0	1	22.0944596854
281	292	1	1	0	21.161778364
281	293	19	1	18	20.1433503561
281	294	1	0	1	30.5242075558
281	295	2	1	1	15.6839442092
281	296	0	0	0	22.2977409313
281	297	2	0	2	30.550359149
281	302	3	0	3	14.2502952766
281	303	4	0	4	41.6999768163
281	304	1	0	1	38.9725862026
281	305	21	6	15	17.33734772
281	307	23	0	23	28.704584722
281	308	1	0	1	28.9327469583
281	309	4	0	4	32.3765589526
281	345	2	0	2	48.0120429546
281	408	1	0	1	132.4565574
281	463	1	0	1	125.176233655
281	466	1	0	1	118.982541357
281	480	0	0	0	104.526235845
281	494	1	0	1	105.552317736
282	0	9	1	8	48.1694661738
282	1	116	5	111	54.3102585687
282	2	1	0	1	58.2656108825
282	5	2	0	2	64.8187631983
282	7	1	0	1	52.4388548847
282	9	2	0	2	45.9387673904
282	13	2	0	2	51.9478864887
282	15	3	1	2	55.0421933319
282	23	2	0	2	61.1926598272
282	24	1	0	1	60.1983840762
282	28	7	0	7	49.3030317976
282	32	7	1	6	37.61492003
282	34	1	0	1	70.4682827174
282	35	0	0	0	60.422521647
282	36	11	1	10	50.0282057959
282	39	4	0	4	40.8097908757
282	41	2	0	2	56.5186990767
282	42	2	0	2	44.8102406996
282	46	2	0	2	84.4774370961
282	55	2	0	2	89.0633863916
282	65	0	0	0	92.5070579506
282	68	1	0	1	81.1531355171
282	70	33	0	33	41.9751735384
282	71	5	1	4	52.2330916066
282	72	5	0	5	40.6585514032
282	73	244	38	206	45.9027881758
282	74	17	10	7	48.4814880305
282	75	28	7	21	48.302171724
282	76	6	0	6	44.6468213137
282	77	1	0	1	41.3940794851
282	78	22	3	19	47.7385960246
282	79	13	3	10	41.9918859225
282	80	1	0	1	42.7374969794
282	81	21	0	21	42.6202773542
282	82	40	4	36	45.3260045213
282	83	11	0	11	46.0812879767
282	84	27	6	21	46.9500521507
282	85	8	1	7	48.1462493994
282	86	3	1	2	51.9863734027
282	87	10	1	9	50.4522388829
282	88	7	1	6	51.7758788276
282	89	8	0	8	34.0918993001
282	90	7	0	7	46.6085898685
282	92	22	3	19	37.1073262996
282	95	8	0	8	44.6615178142
282	96	6	0	6	44.4473213014
282	100	1	0	1	43.1042067348
282	101	1	0	1	27.4697228885
282	102	3	0	3	37.7172216231
282	103	20	1	19	49.9352194219
282	109	2	0	2	41.0292624437
282	110	4	0	4	53.471444797
282	111	3	0	3	31.7062307719
282	112	17	3	14	48.8114048257
282	113	21	5	16	53.5277867556
282	114	3	0	3	50.2347501617
282	115	0	0	0	29.2777581056
282	116	3	0	3	44.6539192119
282	117	1	0	1	53.2057788608
282	118	1	0	1	48.2609437203
282	120	2	0	2	40.4963141536
282	128	2	0	2	73.7725395016
282	140	2	0	2	58.8050922476
282	142	10	1	9	68.4302046895
282	146	1	0	1	57.5373110756
282	147	1	0	1	86.1790318558
282	155	1	0	1	54.6125645816
282	164	1	0	1	57.3255559467
282	166	1	0	1	59.0884744185
282	171	2	0	2	55.0731309009
282	181	1	1	0	34.3908533026
282	182	1	0	1	55.4169950899
282	183	38	13	25	47.0432909377
282	185	3	0	3	50.9371138108
282	186	5	0	5	39.1681432362
282	187	2	1	1	46.195448886
282	190	4	1	3	49.7171124175
282	193	1	0	1	55.8253129978
282	194	1	0	1	52.0261321633
282	196	1	0	1	62.7470858821
282	199	1	0	1	51.363103259
282	204	4	0	4	25.6871995506
282	205	1	0	1	29.7557082478
282	207	4	0	4	32.7843624356
282	208	28	18	10	38.6332661651
282	209	3	1	2	35.2627578988
282	211	1	0	1	45.8462139919
282	212	16	0	16	25.9106923047
282	213	4	0	4	42.8286728115
282	214	8	0	8	33.1982136805
282	216	0	0	0	60.7606257689
282	217	1	0	1	59.1139636677
282	220	5	0	5	62.6146074509
282	223	1	0	1	46.1399296223
282	225	3	0	3	37.966910492
282	229	11	0	11	42.7462732774
282	231	1	0	1	23.5238216979
282	232	1	0	1	31.330495205
282	234	2	0	2	33.4024332771
282	235	1	0	1	26.6435130582
282	236	8	0	8	26.6351267952
282	237	6	1	5	27.0978056482
282	238	2	0	2	34.9451918429
282	242	2	0	2	75.5395535847
282	243	1	0	1	70.0514194239
282	245	79	1	78	23.2130367411
282	246	3	1	2	24.3017270708
282	247	12	1	11	24.5014139759
282	248	1	0	1	20.316586998
282	249	8	0	8	15.7040951083
282	250	2	0	2	14.376357159
282	251	8	0	8	24.7980942603
282	252	10	1	9	10.622086984
282	253	24	8	16	12.7039076768
282	254	20	1	19	15.9257048985
282	255	4	0	4	18.0587072039
282	256	2	0	2	32.3541157472
282	257	20	1	19	25.1851061583
282	258	1	0	1	30.2125861418
282	259	14	4	10	12.5703507685
282	260	6	0	6	26.5583032198
282	261	3	0	3	28.3453881778
282	262	121	6	115	9.33731991518
282	263	3	0	3	15.1369310033
282	264	23	1	22	23.0928569727
282	265	4	0	4	28.1796238433
282	266	16	1	15	27.4587504144
282	267	2	0	2	27.1777738903
282	268	4	1	3	32.1114042482
282	270	20	2	18	25.4395353143
282	271	13	3	10	23.6848528206
282	272	51	0	51	15.8059025489
282	273	11	2	9	5.17523125257
282	274	62	4	58	9.13341395476
282	275	38	7	31	18.9317883566
282	276	108	74	34	6.36419709652
282	277	3755	9	3746	11.1792641302
282	278	1	0	1	26.8189710429
282	279	32	11	21	16.4648883644
282	280	14	0	14	16.2321870602
282	281	271	0	271	4.6344981067
282	284	112	27	85	9.36567112067
282	285	18	0	18	16.048444428
282	286	70	14	56	5.58827901279
282	287	22	10	12	9.17872146805
282	288	9	0	9	21.7954020739
282	290	2	0	2	21.2433421622
282	291	8	0	8	19.2302836594
282	292	15	1	14	16.5499319775
282	293	75	24	51	15.8507769423
282	294	13	0	13	26.6777397873
282	295	9	1	8	11.0859775625
282	296	4	1	3	19.6598425444
282	297	3	0	3	26.2232585848
282	298	2	0	2	20.4907431167
282	300	1	0	1	19.9430886463
282	301	2	0	2	21.1203211647
282	302	13	4	9	10.8671613316
282	303	10	0	10	46.2690497539
282	304	3	0	3	43.5896248545
282	305	37	4	33	21.8374435376
282	306	1	0	1	38.7670232232
282	307	50	1	49	33.3013931255
282	308	2	0	2	33.2431193425
282	309	6	0	6	36.9971459983
282	375	2	0	2	46.1969566681
282	469	1	0	1	109.906878773
282	471	1	0	1	106.764676519
282	475	1	0	1	104.192479678
282	476	1	0	1	93.4123665894
282	491	1	0	1	116.980302171
282	507	1	0	1	205.258426946
282	573	2	0	2	98.0821748877
283	0	1	0	1	31.0244001279
283	1	149	33	116	31.1725428399
283	7	2	0	2	34.1434491017
283	9	1	0	1	27.8883078359
283	15	3	1	2	35.9848384334
283	16	1	0	1	28.5010642385
283	17	1	0	1	45.0245222709
283	18	2	0	2	34.6444061355
283	21	2	0	2	40.2795565155
283	24	1	0	1	40.0955617116
283	26	1	0	1	51.2772080684
283	28	14	1	13	26.7834146189
283	31	1	0	1	47.2459886334
283	32	3	2	1	22.9180398492
283	36	6	3	3	39.2002856658
283	41	1	0	1	43.3760362219
283	42	1	0	1	32.8252257673
283	73	26	1	25	45.7077996312
283	74	1	0	1	49.9883980263
283	75	4	0	4	47.6119820544
283	76	0	0	0	48.7949583397
283	78	0	0	0	50.1747464083
283	81	1	0	1	44.782862342
283	82	1	0	1	48.1863542472
283	83	1	0	1	47.0751932585
283	84	5	0	5	47.1370549243
283	85	2	0	2	52.4847550939
283	92	3	0	3	41.7961254882
283	102	1	0	1	30.0024084978
283	103	4	0	4	46.7392167813
283	106	1	0	1	29.4780538656
283	110	1	0	1	48.415253247
283	111	1	0	1	38.0696001149
283	112	3	1	2	44.1955938023
283	113	2	0	2	51.2871251545
283	115	0	0	0	39.7922344508
283	120	1	0	1	39.6022055889
283	138	0	0	0	53.3129325818
283	142	3	0	3	62.8139206667
283	183	3	0	3	51.1782220557
283	184	1	0	1	43.7248829885
283	190	1	0	1	47.150738891
283	191	0	0	0	77.6283515546
283	207	1	0	1	56.9645581394
283	208	2	0	2	63.851592941
283	228	1	0	1	69.2346306077
283	245	5	2	3	27.7953465239
283	247	1	0	1	44.8696613101
283	249	0	0	0	34.8706707973
283	251	1	0	1	39.8294789432
283	252	1	0	1	28.3576052247
283	254	1	0	1	28.9992303893
283	257	12	9	3	19.9786162784
283	258	3	1	2	17.8733414034
283	259	2	0	2	16.122361308
283	261	7	1	6	11.4910194436
283	262	5	0	5	21.5285535088
283	264	19	2	17	14.2632486769
283	265	22	0	22	16.8040917038
283	266	4	0	4	26.712652391
283	270	80	4	76	9.6990331794
283	271	2	0	2	36.7552200592
283	274	2	1	1	18.0409066032
283	275	16	0	16	17.0876829064
283	276	1	0	1	33.5118399378
283	277	374	0	374	19.4610771565
283	279	19	0	19	10.7363287607
283	281	4	0	4	23.0795210537
283	282	3	0	3	27.1743118826
283	284	4	0	4	34.29458449
283	286	0	0	0	28.9798958042
283	287	2	0	2	29.6196706871
283	289	44	0	44	5.01098909081
283	290	1	0	1	27.8370205549
283	293	2	0	2	43.0248094827
283	295	1	0	1	37.9156999602
283	301	1	0	1	48.0242286244
283	303	50	18	32	21.6079634764
283	304	2	0	2	24.330974427
283	305	154	0	154	7.75083902533
283	306	16	4	12	13.2044399746
283	307	197	23	174	11.561985094
283	308	50	35	15	6.72093922137
283	309	24	10	14	18.9894176279
283	469	1	0	1	99.1680661067
283	488	1	0	1	105.962032403
283	503	1	0	1	115.773990367
284	0	3	0	3	57.4214556075
284	1	49	4	45	63.0082674547
284	13	2	0	2	61.2525793367
284	19	1	0	1	54.4717267056
284	24	2	0	2	69.3258859695
284	28	6	0	6	58.0517721169
284	32	1	0	1	46.8808088176
284	35	0	0	0	69.7696304995
284	36	8	2	6	59.368338951
284	39	1	0	1	50.1660924377
284	46	2	0	2	93.5478427215
284	49	1	0	1	82.722034065
284	53	1	0	1	96.7344880434
284	54	1	0	1	84.9743118575
284	65	1	0	1	101.62404615
284	70	11	1	10	49.994423525
284	71	1	0	1	60.3784751443
284	72	2	0	2	49.0562546918
284	73	113	0	113	54.4883016845
284	74	10	1	9	56.7510284524
284	75	7	0	7	56.8933861578
284	76	5	0	5	52.5840767275
284	78	11	0	11	55.8776584238
284	79	2	0	2	50.5885839675
284	81	8	2	6	50.9663184184
284	82	9	0	9	53.4687417547
284	83	2	0	2	54.4961609346
284	84	11	0	11	55.4565524759
284	85	3	0	3	55.9268199807
284	86	2	0	2	59.9481829304
284	87	3	0	3	58.9030099873
284	90	2	0	2	53.7503116509
284	92	8	0	8	45.2572195898
284	95	3	0	3	53.7334807551
284	96	3	0	3	50.9761125913
284	101	1	0	1	35.353510246
284	102	2	0	2	47.048645704
284	103	4	0	4	58.787953297
284	110	1	0	1	62.4509763357
284	111	4	0	4	39.845839792
284	112	4	0	4	57.8197083579
284	113	9	1	8	62.2068378726
284	118	1	0	1	55.7619241637
284	122	1	0	1	42.0206865149
284	131	1	0	1	102.303668802
284	142	4	0	4	77.2944794307
284	154	1	0	1	83.5198537144
284	177	1	0	1	74.258408923
284	181	2	0	2	28.794182586
284	182	1	0	1	50.3275164002
284	183	15	0	15	41.7740816546
284	186	4	0	4	32.1070774999
284	187	1	0	1	37.856616157
284	190	3	1	2	46.5174696462
284	191	1	0	1	53.8403974076
284	196	9	0	9	53.3814401767
284	201	1	0	1	58.3367890188
284	204	3	2	1	17.8051607074
284	205	1	0	1	22.7788986424
284	206	1	0	1	21.3174643202
284	207	6	1	5	23.6183455854
284	208	36	1	35	29.8739401799
284	209	6	2	4	26.0566137543
284	210	1	0	1	27.6452974954
284	211	3	0	3	36.8348603427
284	212	33	0	33	16.8451004186
284	213	2	1	1	33.6360740004
284	214	5	0	5	25.2071931515
284	215	1	0	1	30.597883845
284	220	2	0	2	55.4008545425
284	223	3	0	3	37.1298064321
284	224	1	0	1	24.7958921197
284	225	4	0	4	28.6190835773
284	228	3	1	2	38.1798913946
284	229	6	0	6	33.4566175248
284	231	8	0	8	14.2497543964
284	233	1	0	1	19.3358130438
284	234	1	0	1	24.6050439759
284	235	3	0	3	19.3094745433
284	236	10	1	9	18.0943150199
284	237	13	2	11	17.749181836
284	239	3	1	2	28.6284402147
284	242	0	0	0	67.0709370031
284	245	32	1	31	32.179638326
284	246	1	0	1	32.3916417401
284	247	3	0	3	28.5577716961
284	249	1	0	1	22.0286180066
284	251	1	0	1	31.2997055641
284	252	3	0	3	18.8602207811
284	253	3	0	3	16.9399470873
284	254	5	1	4	24.299062846
284	255	1	0	1	27.3170041709
284	257	6	0	6	34.5470057562
284	258	1	0	1	39.452220834
284	259	5	1	4	21.4163588307
284	260	2	0	2	35.8676807752
284	262	23	2	21	18.6998599195
284	263	1	0	1	24.5008683827
284	264	9	0	9	32.233549872
284	265	1	0	1	30.9294018706
284	266	5	2	3	26.6019605759
284	267	1	0	1	27.9486688104
284	268	3	0	3	29.0432452592
284	270	4	0	4	30.2890160896
284	271	12	3	9	17.7362809702
284	272	271	6	265	7.52305963606
284	273	52	34	18	5.24187152282
284	274	15	0	15	16.9969876148
284	275	13	4	9	21.8272219046
284	276	91	61	30	6.15559546669
284	277	1253	0	1253	15.3573588293
284	278	3	2	1	22.4624384093
284	280	4	0	4	16.0611438918
284	281	17	5	12	13.7923027436
284	282	46	0	46	9.36567112067
284	285	15	0	15	11.8876189597
284	286	4	3	1	13.2768317717
284	287	40	13	27	5.90946980691
284	288	1	0	1	21.7016159311
284	289	1	0	1	30.9155406095
284	290	1	0	1	19.1738090354
284	291	34	11	23	9.86514492236
284	292	41	7	34	7.85094591249
284	293	112	26	86	11.5423733976
284	294	16	1	15	23.0592017287
284	295	45	21	24	5.48108495658
284	296	2	1	1	20.5218034593
284	298	4	0	4	13.3968089861
284	301	4	0	4	18.1331119804
284	302	7	0	7	11.9462572184
284	303	2	0	2	54.569646842
284	304	1	0	1	52.6438568149
284	305	6	1	5	30.106672267
284	307	15	0	15	41.8144619075
284	309	2	0	2	46.0401682936
284	339	1	0	1	60.3501753792
284	345	1	0	1	35.1758575057
284	350	1	0	1	31.3902297476
284	371	1	0	1	37.5188641999
284	415	1	0	1	133.415465517
284	464	1	0	1	114.432611431
284	466	1	0	1	132.054515226
284	484	1	0	1	121.926276147
284	501	1	0	1	142.76597822
285	0	3	0	3	58.4723070271
285	1	21	0	21	61.4839400147
285	2	1	0	1	68.3087436361
285	5	1	0	1	71.6992078417
285	13	2	0	2	62.6671205531
285	19	1	0	1	55.5985004718
285	23	2	0	2	69.8682553142
285	28	1	0	1	56.817521473
285	32	1	0	1	48.337739545
285	36	6	1	5	62.7783596163
285	39	4	0	4	52.5631632952
285	46	1	0	1	92.9900625903
285	55	1	0	1	99.0304443387
285	70	16	0	16	57.724661847
285	71	1	0	1	67.8474965392
285	72	1	0	1	56.1276696441
285	73	114	37	77	61.1191011901
285	74	11	0	11	64.0143811083
285	75	4	0	4	63.491964594
285	76	8	1	7	60.4300631394
285	78	12	1	11	63.3791722022
285	79	3	0	3	57.2283468869
285	81	2	0	2	58.1227800726
285	82	20	7	13	60.9766108386
285	83	4	0	4	61.4923921547
285	84	12	0	12	62.2548154841
285	85	2	0	2	63.994153909
285	87	4	1	3	65.7960382937
285	88	1	0	1	67.2351074652
285	89	3	0	3	49.2654348006
285	90	1	0	1	62.6363704365
285	92	5	0	5	52.8041480597
285	95	4	1	3	58.9483745202
285	96	1	0	1	60.4825535595
285	101	1	0	1	43.3743492881
285	103	3	0	3	64.6908456046
285	105	1	0	1	49.9526958387
285	106	1	0	1	45.1437208519
285	109	1	0	1	57.029959455
285	112	3	0	3	63.2257011601
285	113	11	0	11	68.554371378
285	115	1	0	1	45.29727371
285	120	1	0	1	55.419354051
285	129	1	0	1	70.9926796437
285	131	1	0	1	106.186058898
285	133	1	0	1	76.8074402518
285	142	4	0	4	83.0269355502
285	169	2	0	2	60.5863177473
285	172	1	0	1	82.2610482221
285	181	7	1	6	18.3436513543
285	182	1	0	1	39.4778082027
285	183	35	0	35	31.0435774488
285	184	1	0	1	26.764709735
285	185	2	0	2	35.078666275
285	186	3	0	3	23.6084226508
285	188	5	1	4	30.2831588092
285	189	1	0	1	36.6521963784
285	190	3	0	3	34.7583128241
285	191	1	0	1	48.9243565076
285	194	1	0	1	38.7739768511
285	196	2	0	2	53.2119061225
285	204	2	0	2	26.216815145
285	205	1	0	1	31.9601142431
285	206	2	0	2	27.3205831618
285	207	2	0	2	27.6410243278
285	208	20	1	19	35.1236880133
285	209	2	0	2	29.564321035
285	211	1	0	1	40.6832271289
285	212	12	2	10	22.356642969
285	213	2	0	2	36.6591141372
285	214	1	0	1	32.7044010352
285	220	9	0	9	46.923978331
285	221	1	0	1	40.4179670506
285	222	2	0	2	41.7968323764
285	223	2	0	2	33.8524584562
285	225	3	0	3	28.7311311721
285	226	1	0	1	35.0890057915
285	227	1	0	1	28.6990120606
285	229	9	0	9	32.3491188636
285	230	1	0	1	39.1850503893
285	231	6	0	6	15.5397599163
285	232	4	1	3	21.6578012665
285	233	4	2	2	20.7417638288
285	234	1	0	1	21.1304984222
285	235	8	0	8	11.9904252923
285	236	18	2	16	14.4661812938
285	237	5	2	3	20.8238033963
285	238	2	0	2	20.5342781235
285	242	1	0	1	61.1656781008
285	245	13	0	13	38.18039035
285	246	1	0	1	40.1436576344
285	247	2	0	2	39.5107128514
285	250	4	0	4	29.2584687496
285	252	3	1	2	26.5998527855
285	253	2	1	1	27.5443083373
285	254	3	1	2	31.7393401194
285	257	2	0	2	37.6861900827
285	259	2	0	2	23.1645111737
285	260	1	0	1	40.2020943461
285	261	1	0	1	37.0284185559
285	262	15	4	11	23.2353509104
285	264	1	0	1	33.7155175314
285	265	3	0	3	21.9289525101
285	266	36	2	34	15.1861811584
285	267	4	1	3	17.4731362833
285	268	10	3	7	17.1874521784
285	269	1	1	0	22.5572081396
285	270	3	1	2	23.7243524176
285	271	154	6	148	7.91641882037
285	272	339	295	44	7.94849310917
285	273	15	0	15	11.375323109
285	274	17	7	10	17.9348958532
285	275	34	0	34	14.3674038326
285	276	9	3	6	17.0579042681
285	277	1337	92	1245	12.1435686982
285	278	10	0	10	10.9671136171
285	279	2	0	2	21.7791270169
285	280	47	4	43	6.95225431723
285	281	21	4	17	18.2767548406
285	282	32	10	22	16.048444428
285	284	38	6	32	11.8876189597
285	286	2	0	2	21.5796184342
285	287	38	21	17	7.1961577258
285	288	4	1	3	11.1852506509
285	289	1	0	1	26.1354754578
285	290	27	1	26	7.58514579325
285	291	20	2	18	14.5622845585
285	292	15	0	15	16.7671182752
285	293	10	0	10	23.2183170341
285	294	6	2	4	34.4850199235
285	295	5	0	5	17.3089731396
285	296	1	0	1	32.2657376777
285	298	1	0	1	23.3807234197
285	302	2	0	2	23.3647443837
285	303	2	0	2	52.1656805548
285	305	10	0	10	29.1376868242
285	306	1	0	1	43.8100360183
285	307	5	0	5	40.5177500997
285	309	1	0	1	46.3058069077
285	329	1	0	1	75.5174429711
285	345	2	0	2	41.589178523
285	408	0	0	0	150.678872837
285	471	1	0	1	118.72606129
285	476	1	0	1	105.971305728
285	480	1	0	1	121.467326612
286	0	1	0	1	46.2312233929
286	1	37	0	37	53.6542227282
286	6	1	0	1	72.9044744012
286	7	1	0	1	50.6053584822
286	12	1	0	1	62.9859151379
286	13	3	0	3	49.7429398927
286	17	1	0	1	62.2441581481
286	18	1	0	1	46.9370229004
286	19	2	0	2	43.3041236073
286	20	1	0	1	65.1782744051
286	21	2	0	2	61.4565464955
286	28	2	0	2	48.6028177383
286	32	2	0	2	35.7222939261
286	34	1	0	1	67.3512315245
286	36	13	7	6	46.8102253362
286	39	1	0	1	38.2895418529
286	59	1	0	1	100.226418045
286	70	16	0	16	36.8755820479
286	71	4	1	3	47.2171234796
286	72	3	0	3	35.8064553901
286	73	246	2	244	41.2135385547
286	74	12	0	12	43.5419805513
286	75	16	1	15	43.6186413691
286	76	37	0	37	39.5074032965
286	78	25	8	17	42.714833995
286	79	7	0	7	37.312602685
286	80	2	0	2	37.9126992794
286	81	15	2	13	37.7303676745
286	82	33	1	32	40.3020416482
286	83	8	1	7	41.2461560178
286	84	34	15	19	42.1904040016
286	85	2	0	2	42.9368243864
286	86	2	0	2	46.8678583619
286	87	1	1	0	45.6477681579
286	88	8	2	6	46.8810545954
286	89	7	0	7	29.5326265199
286	90	2	1	1	41.1799283801
286	92	11	4	7	32.0774980959
286	93	1	0	1	24.6456932421
286	95	9	4	5	40.608468321
286	96	1	0	1	38.9040189959
286	97	1	0	1	29.3265468007
286	98	1	0	1	49.9885868252
286	101	4	1	3	22.2672012549
286	103	5	1	4	45.5365351063
286	104	4	0	4	36.4138235704
286	106	1	0	1	27.0064730913
286	108	1	0	1	32.778882136
286	109	3	0	3	35.652940973
286	110	2	0	2	49.2483180022
286	111	6	1	5	26.6606495245
286	112	11	0	11	44.6392193854
286	113	24	2	22	48.9301374719
286	116	3	0	3	39.3923165139
286	120	3	0	3	36.0583987028
286	122	1	0	1	29.271697058
286	142	6	0	6	64.0387661371
286	143	1	0	1	72.6121714794
286	155	4	2	2	49.075990688
286	172	1	0	1	61.1804329643
286	181	2	0	2	39.9055061307
286	183	14	0	14	52.6052017876
286	186	1	0	1	44.447049848
286	188	1	0	1	50.8534126981
286	190	1	0	1	55.2556394453
286	200	1	0	1	56.2394725928
286	204	1	0	1	26.9164279203
286	207	2	0	2	35.3588027351
286	208	10	3	7	40.4500605168
286	212	7	1	6	28.4419540077
286	214	1	0	1	34.2630060937
286	220	3	0	3	67.8932730926
286	225	1	0	1	41.5187244894
286	232	1	0	1	35.2146086636
286	233	1	0	1	32.2534207101
286	238	1	0	1	39.9227148973
286	241	1	0	1	85.9108987788
286	242	0	0	0	80.2803890737
286	243	2	0	2	74.9005450403
286	245	123	18	105	19.044845191
286	246	3	0	3	19.205706795
286	247	21	14	7	19.2296773751
286	248	3	1	2	15.0122830468
286	249	27	2	25	10.1230446802
286	250	15	0	15	10.834016107
286	251	10	0	10	19.2225182538
286	252	82	0	82	5.58339273464
286	253	204	0	204	7.93488810121
286	254	25	2	23	11.0234230731
286	255	2	0	2	16.7352544878
286	256	1	0	1	29.2951591736
286	257	15	1	14	22.7874142779
286	258	3	0	3	28.550292355
286	259	12	1	11	13.0320534008
286	260	2	1	1	23.3180301789
286	261	2	0	2	27.882489351
286	262	203	32	171	8.03065122554
286	263	10	2	8	12.8164508457
286	264	5	0	5	21.9875753151
286	265	1	0	1	32.5840850706
286	266	4	0	4	32.8163758372
286	268	2	0	2	37.6739040854
286	270	1	0	1	28.956712111
286	271	1	0	1	29.1050012295
286	272	39	2	37	20.4816105008
286	273	7	0	7	10.3814029829
286	274	22	0	22	11.7523813143
286	275	12	2	10	23.5823697586
286	276	45	35	10	7.9001806152
286	277	1431	240	1191	15.8913866134
286	279	16	0	16	18.7412360642
286	280	3	1	2	21.6716499764
286	281	152	101	51	6.46313094284
286	282	237	0	237	5.58827901279
286	283	1	0	1	28.9798958042
286	284	32	0	32	13.2768317717
286	285	7	1	6	21.5796184342
286	287	12	0	12	14.5634313429
286	288	1	0	1	27.1083295294
286	289	1	0	1	27.3853569223
286	290	1	0	1	26.7916972703
286	291	2	0	2	22.7457526879
286	292	6	2	4	19.0820037534
286	293	73	2	71	15.5832898577
286	294	4	0	4	24.8948527064
286	295	8	0	8	12.7258255761
286	296	12	0	12	15.9110147549
286	297	1	0	1	25.792769824
286	298	1	0	1	21.4220250041
286	299	1	0	1	13.8848765039
286	300	2	0	2	15.0808353135
286	301	2	0	2	19.3741039879
286	302	24	3	21	8.56317144789
286	303	6	0	6	46.3099387344
286	305	21	4	17	22.5512381746
286	307	21	0	21	33.2441277487
286	309	2	0	2	35.8284324232
286	345	1	0	1	44.4792866408
286	346	1	0	1	64.3393723172
286	348	2	0	2	33.3451051138
286	353	1	0	1	44.7930028968
286	375	1	0	1	45.131738602
286	475	3	0	3	99.6934957803
287	0	2	0	2	54.850907994
287	1	53	0	53	59.3474702181
287	5	2	0	2	69.7658422626
287	6	1	0	1	78.9908543268
287	7	1	0	1	58.945453133
287	9	1	0	1	52.3390962125
287	13	2	0	2	58.8717389158
287	15	1	0	1	61.4036689659
287	20	1	0	1	72.3609474808
287	21	1	0	1	68.0169263096
287	23	1	0	1	67.0865309422
287	24	1	0	1	66.3524795547
287	28	4	1	3	54.4851364955
287	32	1	0	1	44.4348025859
287	33	1	0	1	63.0980533577
287	36	3	0	3	57.9768891309
287	39	2	0	2	48.204469439
287	41	1	0	1	64.2037659779
287	42	1	0	1	52.4349813154
287	46	1	0	1	90.3775520841
287	48	0	0	0	96.7784996982
287	50	1	0	1	85.951023521
287	52	1	0	1	88.2963972697
287	53	1	1	0	92.8373501771
287	65	1	0	1	98.5385822502
287	70	12	0	12	51.1443489158
287	71	3	1	2	61.3805627819
287	72	1	0	1	49.7628352004
287	73	105	2	103	54.9314594022
287	74	8	2	6	57.6082209754
287	75	12	1	11	57.3241874418
287	76	2	0	2	53.8207860328
287	77	2	1	1	50.4592480754
287	78	13	0	13	56.8900705533
287	79	3	0	3	51.0231064935
287	80	2	1	1	51.828992439
287	81	5	0	5	51.7354929642
287	82	9	0	9	54.4786793055
287	83	3	0	3	55.1727454372
287	84	16	0	16	56.00915537
287	85	3	0	3	57.3248379761
287	86	1	0	1	61.1561199865
287	87	11	0	11	59.5264378922
287	88	5	1	4	60.8847345849
287	89	6	3	3	43.0885937058
287	90	2	0	2	55.7340119507
287	92	7	0	7	46.2659039512
287	95	6	0	6	53.3158231107
287	96	3	0	3	53.4354287865
287	102	1	0	1	45.7833123527
287	103	4	1	3	58.7970774433
287	110	2	1	1	62.209862145
287	111	1	0	1	40.8712881997
287	112	9	0	9	57.530268434
287	113	13	2	11	62.4973261069
287	115	1	0	1	38.4200932571
287	116	3	0	3	53.8309643812
287	120	2	0	2	49.4088405165
287	129	1	0	1	65.7907908756
287	134	1	0	1	72.6011993752
287	142	13	1	12	77.2508548921
287	147	1	0	1	95.1217537767
287	154	1	0	1	84.2534881763
287	156	1	0	1	59.2266518355
287	166	1	0	1	67.8001912421
287	177	2	0	2	76.1661678896
287	181	4	0	4	25.3871575215
287	182	1	0	1	46.6505092642
287	183	15	0	15	38.1902217404
287	184	2	0	2	33.933100751
287	185	2	0	2	41.7719236531
287	186	1	0	1	29.990615759
287	188	3	1	2	36.5015902349
287	190	1	0	1	41.8097459088
287	194	1	0	1	43.440838021
287	199	1	0	1	45.4542078003
287	202	1	0	1	49.6422607204
287	204	2	0	2	23.1282403232
287	208	19	5	14	34.243757583
287	209	4	2	2	29.6636888262
287	210	1	0	1	30.5996657277
287	211	2	0	2	40.738549461
287	212	9	0	9	21.0324767766
287	213	2	0	2	37.1674163627
287	214	1	0	1	30.3300314814
287	217	0	0	0	49.9869392761
287	220	4	1	3	53.436074955
287	229	11	0	11	35.1664753821
287	231	3	0	3	16.3444576535
287	232	2	0	2	23.8164215323
287	233	1	0	1	21.808503957
287	234	2	0	2	24.9791888269
287	236	7	3	4	18.089996447
287	237	3	1	2	20.9084925694
287	242	0	0	0	66.6458327274
287	245	26	1	25	32.0930149669
287	246	2	0	2	33.4774429389
287	247	2	0	2	32.3278815175
287	248	1	0	1	29.4801446904
287	249	1	0	1	24.4579852732
287	250	0	0	0	23.1527431067
287	251	1	0	1	33.7083510438
287	252	2	1	1	19.7988742031
287	253	3	0	3	20.3530259752
287	254	4	0	4	25.0918412935
287	257	4	1	3	32.826457596
287	258	0	0	0	36.9971856827
287	259	3	1	2	18.6846974721
287	262	15	4	11	17.4408640556
287	263	2	0	2	23.2143768247
287	264	6	0	6	29.6347467646
287	265	1	0	1	25.0511394573
287	266	7	0	7	20.9679038237
287	267	1	0	1	22.078725108
287	268	4	0	4	24.1622906017
287	270	2	0	2	24.7692808076
287	271	9	1	8	14.5424667042
287	272	94	7	87	7.70257962213
287	273	14	9	5	4.21599821274
287	274	10	0	10	13.6461630187
287	275	12	0	12	16.0384261604
287	276	8	1	7	10.0114907467
287	277	1204	378	826	10.2052705127
287	278	1	0	1	18.1624373427
287	279	1	0	1	19.4328302864
287	280	1	0	1	10.179657372
287	281	12	8	4	12.2719237756
287	282	21	8	13	9.17872146805
287	284	32	30	2	5.90946980691
287	285	18	1	17	7.1961577258
287	286	2	1	1	14.5634313429
287	288	1	0	1	15.8794126633
287	289	0	0	0	25.8509458864
287	290	5	0	5	13.7524487388
287	291	8	0	8	13.2023610235
287	292	7	0	7	13.0418240737
287	293	23	0	23	17.3628508069
287	294	5	0	5	28.9233278128
287	295	3	0	3	11.2593511036
287	296	1	0	1	25.3959595158
287	298	1	0	1	19.1223483354
287	302	0	0	0	16.3580844108
287	303	1	0	1	50.5239220044
287	305	9	1	8	26.3663652739
287	307	8	1	7	38.1056039331
287	309	1	0	1	43.0360942032
287	338	0	0	0	66.6792094779
287	345	2	0	2	40.0243270778
287	371	1	0	1	42.7935634318
287	377	1	0	1	45.862286334
287	385	1	0	1	125.677034069
287	392	0	0	0	122.016754688
287	442	1	0	1	164.711149469
287	469	2	0	2	118.370261307
287	471	1	0	1	114.448994886
287	476	1	0	1	101.364066044
287	490	1	0	1	121.344724341
287	555	1	0	1	125.832207509
287	563	1	0	1	120.13717312
288	0	1	0	1	53.9782273229
288	1	19	3	16	54.6970359085
288	23	1	0	1	63.8277795794
288	28	1	0	1	50.405196987
288	32	1	0	1	44.6548214583
288	36	4	0	4	60.3110714481
288	42	1	0	1	54.1117613145
288	53	1	1	0	86.4312236164
288	70	4	3	1	59.8389376113
288	73	35	3	32	61.9305403632
288	74	3	2	1	65.4210264914
288	75	2	0	2	64.1961761074
288	76	0	0	0	62.5883519017
288	78	4	0	4	65.0665812873
288	79	2	0	2	58.1818056169
288	81	3	0	3	59.5955606873
288	82	1	0	1	62.7412908416
288	84	4	0	4	63.2091361338
288	85	2	0	2	66.3039290116
288	87	1	0	1	66.7501863022
288	88	1	0	1	68.4075678769
288	89	2	0	2	50.3713722764
288	92	1	0	1	54.8963417484
288	96	4	0	4	64.6270267031
288	97	1	0	1	56.3510550669
288	103	4	0	4	64.6307825136
288	104	1	0	1	53.7325390315
288	110	0	0	0	67.3077106278
288	112	4	0	4	62.7016713043
288	113	4	0	4	68.8525448081
288	119	1	0	1	70.1647097635
288	142	3	0	3	82.3692205167
288	181	1	0	1	19.046823914
288	182	2	0	2	36.6166620133
288	183	28	4	24	29.0967929382
288	184	7	0	7	22.5966769323
288	186	4	0	4	26.7233053577
288	188	3	0	3	33.2928657126
288	190	7	1	6	28.7773517482
288	206	1	0	1	38.4199053385
288	208	2	0	2	46.0198482782
288	212	1	1	0	33.468775888
288	220	1	0	1	48.0713853758
288	229	1	0	1	41.0092563353
288	231	1	0	1	26.28265155
288	235	1	0	1	19.1953558461
288	244	1	0	1	67.0338040414
288	245	6	0	6	39.5313042668
288	247	2	1	1	46.2795248467
288	249	1	0	1	37.0562716718
288	254	4	0	4	35.0881558945
288	257	1	0	1	36.3384506781
288	261	1	0	1	32.6823956893
288	262	10	0	10	25.2817997453
288	264	1	0	1	31.2208896144
288	265	52	12	40	11.1106910063
288	266	342	118	224	5.73465245443
288	267	44	8	36	6.34090633202
288	268	42	8	34	12.226538478
288	269	8	1	7	12.1734664802
288	270	24	1	23	14.8192946033
288	271	51	12	39	14.1184059117
288	272	19	0	19	19.1326803667
288	273	2	1	1	18.9587216358
288	274	5	2	3	18.4030814553
288	275	164	5	159	6.93729710631
288	276	1	0	1	25.3906026256
288	277	840	156	684	11.8410077837
288	278	10	0	10	11.2454612614
288	279	3	1	2	18.1117430857
288	280	71	4	67	5.78770680722
288	281	2	0	2	21.6404342138
288	282	10	0	10	21.7954020739
288	283	1	0	1	23.6316141943
288	284	8	0	8	21.7016159311
288	285	17	6	11	11.1852506509
288	287	7	0	7	15.8794126633
288	289	4	1	3	18.651472594
288	290	49	0	49	4.72292971477
288	291	2	0	2	25.7411180839
288	293	3	0	3	33.2272832786
288	294	3	0	3	44.7604571642
288	295	4	3	1	27.1287361644
288	302	1	0	1	31.6063562815
288	303	2	0	2	44.9484327756
288	304	1	0	1	47.5913272469
288	305	3	1	2	24.9263537483
288	306	2	0	2	36.5256200767
288	307	11	0	11	34.8266275607
288	308	1	0	1	29.9734454357
288	309	3	0	3	41.6518481985
288	484	1	0	1	118.261656145
288	524	1	0	1	161.028510213
288	573	1	0	1	117.467402645
289	1	66	22	44	36.0747019171
289	5	3	0	3	45.9802203922
289	11	1	0	1	48.0156679511
289	12	1	0	1	43.2274820216
289	15	2	0	2	40.9875712567
289	18	1	0	1	39.4244548374
289	23	2	1	1	45.187601754
289	28	8	0	8	31.7541589847
289	32	3	1	2	27.4717578245
289	36	2	0	2	43.6880920768
289	39	1	0	1	32.7585207221
289	48	1	0	1	77.5241814051
289	49	1	0	1	60.3726985415
289	55	1	0	1	74.7992310071
289	70	3	0	3	48.8912264027
289	73	11	0	11	49.0163573445
289	74	2	0	2	53.1425774238
289	75	2	0	2	51.0278335999
289	76	1	0	1	51.5363886012
289	78	1	0	1	53.1986968829
289	82	1	0	1	51.1077032617
289	83	1	0	1	50.2445553803
289	84	4	0	4	50.4219775901
289	86	1	0	1	57.8044811449
289	87	1	0	1	53.7966112679
289	88	1	0	1	55.6739980865
289	89	1	0	1	38.6655582014
289	101	1	0	1	38.1622096955
289	107	1	0	1	64.8346372157
289	110	1	0	1	52.4042871707
289	112	3	0	3	48.0617835013
289	113	3	1	2	54.9709625454
289	129	1	0	1	52.957575837
289	142	2	0	2	67.0195311807
289	177	1	0	1	74.5946191373
289	181	1	0	1	37.5710795939
289	183	6	0	6	46.2488382062
289	184	1	0	1	38.8555696869
289	196	2	0	2	79.2305295358
289	208	3	0	3	60.0466075238
289	209	1	0	1	55.1333782943
289	211	1	0	1	66.2867864642
289	214	1	1	0	56.0692367499
289	220	0	0	0	66.0867486234
289	229	1	0	1	58.3735531928
289	237	1	0	1	46.2925276018
289	241	0	0	0	90.2892416448
289	242	0	0	0	83.4786003632
289	245	2	0	2	29.5561781353
289	252	1	0	1	27.7331931371
289	255	1	0	1	17.6514036847
289	257	6	0	6	22.7820578622
289	258	2	0	2	21.820898483
289	259	2	1	1	15.3607548538
289	260	1	0	1	27.0385269619
289	261	2	1	1	15.6520853303
289	262	10	2	8	20.6759318467
289	264	10	3	7	16.9355813028
289	265	42	0	42	12.2063864436
289	266	17	6	11	21.7290087388
289	267	4	1	3	17.4212286299
289	268	4	2	2	29.5433752806
289	270	191	54	137	4.96825964369
289	271	2	0	2	31.96219067
289	272	5	3	2	32.6769412128
289	274	8	0	8	15.7863019393
289	275	35	5	30	12.2362244413
289	276	4	0	4	30.892661347
289	277	1059	145	914	15.6604827091
289	279	52	8	44	8.67094472278
289	280	3	0	3	19.3960658777
289	281	10	0	10	21.0959758929
289	282	7	0	7	24.7128471635
289	283	21	3	18	5.01098909081
289	284	3	0	3	30.9155406095
289	285	1	0	1	26.1354754578
289	286	1	0	1	27.3853569223
289	287	1	0	1	25.8509458864
289	288	1	0	1	18.651472594
289	290	2	0	2	22.9271929544
289	293	1	0	1	40.4139969679
289	294	1	0	1	51.3868544065
289	303	29	0	29	26.4040677519
289	305	41	9	32	9.66539409334
289	306	3	0	3	17.9685151846
289	307	28	0	28	16.4965028075
289	308	9	0	9	11.4024294842
289	309	7	1	6	23.7837616526
289	345	0	0	0	65.8669252666
289	466	1	0	1	115.781355097
290	1	14	6	8	58.9963229004
290	3	0	0	0	57.1419912974
290	7	1	0	1	61.2684236924
290	23	1	0	1	67.9691725854
290	26	1	0	1	78.896169518
290	28	5	0	5	54.6070673246
290	32	2	0	2	48.0712243453
290	35	1	0	1	71.0526398894
290	36	1	1	0	63.4089457436
290	39	3	0	3	52.7720514246
290	46	1	0	1	90.7204153322
290	48	1	0	1	99.7767657952
290	53	1	0	1	90.9886999146
290	70	2	0	2	61.2704742765
290	72	1	0	1	59.2622808792
290	73	49	2	47	63.8772158497
290	76	0	0	0	64.0133529697
290	78	2	0	2	66.687277623
290	81	4	0	4	61.2788907136
290	82	2	1	1	64.3230565991
290	83	2	0	2	64.4877471285
290	84	7	1	6	65.1064288397
290	85	2	0	2	67.6815843311
290	86	1	0	1	71.1679954603
290	87	1	0	1	68.6600650917
290	89	1	0	1	52.1501798389
290	92	3	1	2	56.3139652067
290	95	2	0	2	60.8175132087
290	99	1	0	1	73.201416089
290	103	2	0	2	66.9113604994
290	112	1	0	1	65.1429926947
290	113	7	0	7	71.0153820996
290	138	1	0	1	77.9213636732
290	142	1	0	1	84.9122002628
290	147	1	0	1	103.150089444
290	181	8	2	6	15.5661761425
290	182	2	0	2	34.8670966804
290	183	30	8	22	26.862421548
290	184	4	0	4	21.2396376929
290	186	4	0	4	22.7635379662
290	188	2	1	1	29.4518362023
290	190	4	1	3	28.4745374782
290	194	0	0	0	40.3463068592
290	196	1	0	1	56.9699685972
290	204	1	0	1	33.6213530771
290	207	3	0	3	33.9769366452
290	208	2	0	2	41.6236378527
290	209	2	0	2	35.653520811
290	211	2	0	2	46.5704851965
290	212	4	0	4	29.3119837743
290	213	2	0	2	42.3286439445
290	214	1	0	1	39.8533363483
290	220	7	0	7	44.9012110754
290	225	1	0	1	33.4829451042
290	227	1	0	1	30.667379932
290	228	1	0	1	43.1206452957
290	229	3	1	2	36.29065067
290	231	1	0	1	21.8836830384
290	235	4	0	4	14.4857645234
290	236	4	1	3	18.9145432138
290	237	1	0	1	27.2226444805
290	238	1	1	0	21.9735955355
290	244	1	0	1	62.9081475662
290	245	7	2	5	41.1326340398
290	248	1	0	1	40.6986404942
290	249	1	0	1	36.9079275423
290	251	1	0	1	45.8268413129
290	254	2	0	2	35.8359188338
290	257	3	1	2	38.9104051544
290	258	1	0	1	41.1185353708
290	259	1	0	1	24.7291977868
290	262	6	2	4	26.383547743
290	263	1	0	1	31.1686595549
290	265	17	0	17	15.7738176956
290	266	184	2	182	7.60319494222
290	267	6	0	6	10.3790411455
290	268	63	23	40	10.8968076649
290	269	9	0	9	14.9919880418
290	270	15	0	15	19.3824194431
290	271	157	50	107	9.4012519678
290	272	40	0	40	15.3450682427
290	273	1	1	0	17.4820434831
290	274	10	0	10	19.8917611671
290	275	72	0	72	10.770340463
290	276	3	0	3	23.7235165301
290	277	931	82	849	13.1466050042
290	278	36	3	33	7.34696821042
290	279	4	1	3	21.1601941446
290	280	88	14	74	5.59022569745
290	281	11	8	3	22.0944596854
290	282	15	0	15	21.2433421622
290	283	2	0	2	27.8370205549
290	284	12	0	12	19.1738090354
290	285	27	5	22	7.58514579325
290	286	1	0	1	26.7916972703
290	287	6	0	6	13.7524487388
290	288	70	34	36	4.72292971477
290	289	3	1	2	22.9271929544
290	291	1	0	1	21.7916154162
290	292	4	0	4	24.3358596319
290	293	5	1	4	30.6559815517
290	294	2	0	2	42.0155330915
290	295	1	0	1	24.6516925545
290	303	2	0	2	49.319928242
290	304	1	0	1	51.4503997332
290	305	8	0	8	28.3217689183
290	307	6	1	5	38.7753139623
290	309	1	0	1	45.3456829586
290	345	1	0	1	48.3339709909
290	471	1	0	1	118.287057607
291	0	1	0	1	67.2178478323
291	1	10	2	8	72.3937323491
291	12	1	0	1	80.8629952208
291	13	1	0	1	71.0831596608
291	15	1	0	1	73.9659179155
291	21	2	0	2	80.9574111134
291	26	0	0	0	89.6619839355
291	27	1	0	1	90.8961469466
291	28	1	0	1	67.4871594113
291	33	1	0	1	74.9788621065
291	36	6	4	2	69.2045785028
291	70	5	0	5	58.8130838044
291	73	57	0	57	63.7227426788
291	74	5	3	2	65.7243415338
291	75	3	1	2	66.1232494406
291	76	2	0	2	61.3193126887
291	78	3	0	3	64.7513295429
291	81	4	0	4	60.0308756721
291	82	7	3	4	62.3597770148
291	83	2	0	2	63.5960896863
291	84	12	0	12	64.6246421475
291	85	1	0	1	64.5126094166
291	87	3	2	1	68.0123773137
291	88	1	0	1	69.1131838696
291	92	4	1	3	54.2123708418
291	95	4	0	4	63.3526108145
291	96	1	0	1	58.6039213926
291	103	4	0	4	68.2220679869
291	104	1	0	1	59.1284885682
291	110	1	0	1	71.9814354333
291	113	8	0	8	71.4908775787
291	114	1	0	1	69.1900350391
291	138	0	0	0	83.1062756244
291	142	3	0	3	86.7048330864
291	143	1	0	1	95.2951803158
291	155	2	0	2	68.6077263828
291	181	0	0	0	25.5680061387
291	183	19	4	15	38.1129687593
291	184	2	0	2	36.4617148695
291	185	1	0	1	38.373585337
291	186	3	0	3	26.4069062309
291	187	0	0	0	29.8365303543
291	188	1	0	1	31.6774084851
291	190	2	0	2	45.1939603139
291	191	1	1	0	44.9930803602
291	192	1	0	1	40.5400157044
291	194	0	0	0	34.3747134248
291	196	2	0	2	43.5172197829
291	198	1	0	1	55.4480416353
291	199	4	0	4	32.4533227266
291	200	2	1	1	33.8298105889
291	201	2	1	1	48.5644560857
291	204	40	9	31	11.929320456
291	205	9	1	8	17.818242868
291	206	40	1	39	12.919873318
291	207	43	3	40	14.1899342717
291	208	137	0	137	21.1333799939
291	209	21	7	14	16.5063996114
291	210	3	0	3	17.8116689521
291	211	4	1	3	27.5410282833
291	212	612	290	322	7.98066628872
291	213	18	0	18	24.0550047178
291	214	12	5	7	18.1421255836
291	218	1	0	1	36.6017186535
291	220	8	1	7	48.7169219399
291	221	1	0	1	42.479856892
291	223	3	0	3	27.9543910766
291	224	2	0	2	14.965576929
291	225	13	0	13	18.8095065498
291	226	1	0	1	23.8272387211
291	229	24	0	24	23.7674874872
291	230	1	0	1	31.8511288385
291	231	142	105	37	4.95516447236
291	232	20	1	19	12.5401745709
291	233	25	3	22	9.52320458266
291	234	5	1	4	16.140832386
291	235	4	0	4	14.5503932414
291	236	55	0	55	10.8346543042
291	237	200	4	196	7.92349443513
291	238	3	0	3	20.1554309246
291	239	1	0	1	19.5204460007
291	242	1	0	1	58.5248516541
291	243	2	0	2	53.4962196718
291	244	1	0	1	57.8517286353
291	245	10	1	9	41.7855532402
291	247	3	0	3	35.0002425811
291	248	1	0	1	36.977144611
291	253	2	1	1	24.6015654584
291	254	2	1	1	33.6498869975
291	256	1	0	1	51.5444291374
291	257	4	1	3	44.4118156959
291	259	0	0	0	31.0899677985
291	262	7	0	7	28.5649678675
291	263	1	0	1	34.3628461834
291	264	5	4	1	41.9890916115
291	266	9	0	9	29.263811173
291	268	1	0	1	29.0513661489
291	270	2	0	2	37.3987420262
291	271	24	2	22	15.7907678856
291	272	633	16	617	6.65228895592
291	273	11	2	9	14.7845410227
291	274	9	2	7	26.4000106448
291	275	4	3	1	28.2128835767
291	276	12	1	11	14.9541102793
291	277	529	11	518	23.3578387733
291	278	1	0	1	21.7815070155
291	279	1	0	1	32.6051787728
291	280	7	0	7	21.1278238767
291	281	17	1	16	23.6251817373
291	282	14	0	14	19.2302836594
291	284	67	24	43	9.86514492236
291	285	13	0	13	14.5622845585
291	286	2	0	2	22.7457526879
291	287	20	3	17	13.2023610235
291	288	1	0	1	25.7411180839
291	290	2	0	2	21.7916154162
291	292	237	79	158	5.15340763155
291	293	78	19	59	13.9740117626
291	294	9	5	4	22.9185937529
291	295	13	5	8	10.9700096798
291	296	1	0	1	25.3300687673
291	297	3	0	3	17.9892229575
291	298	23	1	22	10.623925095
291	300	1	0	1	29.4504195301
291	301	2	0	2	19.7410765589
291	302	4	1	3	18.8496870965
291	303	1	0	1	63.6862737394
291	304	3	1	2	62.308613712
291	305	5	1	4	39.3958614891
291	306	2	1	1	55.6308089042
291	307	1	0	1	51.1489088597
291	329	1	0	1	70.5013446919
291	345	3	0	3	27.2356483652
291	346	1	0	1	43.3284983806
291	371	2	0	2	30.6371858639
291	375	2	0	2	36.005223076
291	377	2	1	1	39.385661674
291	466	1	0	1	141.733650319
291	487	1	0	1	137.39273383
291	497	1	1	0	130.76306563
291	503	1	0	1	141.049932291
291	506	1	0	1	166.427453012
291	543	1	0	1	187.332300982
291	573	0	0	0	111.982820588
292	0	1	0	1	64.6753430648
292	1	8	0	8	70.7066381027
292	9	1	0	1	62.4813170504
292	28	1	0	1	65.7272187687
292	32	1	0	1	54.1164783914
292	36	1	0	1	65.8812595417
292	70	2	0	2	54.3107612979
292	71	1	0	1	64.7260098753
292	73	43	1	42	59.4816723189
292	74	5	0	5	61.2943470396
292	75	4	1	3	61.872663009
292	76	2	0	2	56.7665397413
292	78	5	0	5	60.2645724149
292	79	1	0	1	55.6378893549
292	81	3	0	3	55.6742352
292	82	5	0	5	57.8886381543
292	83	3	0	3	59.2543537719
292	84	7	1	6	60.3297175486
292	85	1	0	1	59.8810788997
292	87	2	0	2	63.667060599
292	89	2	0	2	48.1092552601
292	90	1	0	1	57.0262922559
292	92	2	0	2	49.8033404319
292	95	1	0	1	59.5258412382
292	96	1	0	1	53.6707063843
292	103	3	0	3	64.1534464281
292	109	1	0	1	51.9947269544
292	111	1	0	1	44.4814461569
292	112	1	0	1	63.4638507237
292	113	4	0	4	67.2735890335
292	142	2	0	2	82.5799445448
292	147	1	0	1	99.7321890079
292	171	1	0	1	65.2693982891
292	177	1	0	1	77.4069475068
292	181	3	0	3	30.1846729186
292	183	5	3	2	42.9132064807
292	187	2	1	1	34.9023924485
292	188	3	0	3	36.8268707724
292	191	1	0	1	49.7665364348
292	196	6	2	4	46.9064121838
292	198	2	0	2	59.0285852817
292	199	1	0	1	34.9409943257
292	200	1	0	1	37.1818307258
292	204	25	11	14	10.0894022333
292	205	2	0	2	15.4471096608
292	206	10	2	8	13.5715520274
292	207	16	3	13	16.3406557003
292	208	67	0	67	22.1373647892
292	209	6	0	6	18.8570942604
292	210	1	0	1	21.0045413633
292	211	3	0	3	29.2971960885
292	212	200	19	181	9.42116620046
292	213	10	1	9	26.3751069248
292	214	8	0	8	17.3912097285
292	219	1	0	1	55.3326465318
292	220	3	2	1	53.8699048325
292	223	1	0	1	32.62127628
292	224	8	2	6	18.9095887438
292	225	4	0	4	22.7606515548
292	228	1	0	1	31.746644414
292	229	7	1	6	27.9432644227
292	231	13	5	8	9.97872406315
292	232	4	4	0	17.118895147
292	233	3	0	3	13.7139709166
292	234	1	0	1	21.1896034213
292	235	3	0	3	19.3468227597
292	236	11	2	9	15.969363073
292	237	21	0	21	11.4128059266
292	241	1	0	1	68.4659563173
292	242	0	0	0	63.3932441615
292	245	9	0	9	38.0294600735
292	247	4	0	4	29.9290476081
292	249	1	0	1	25.8080005918
292	250	1	0	1	29.8774658574
292	251	2	0	2	34.587916582
292	253	9	1	8	19.882359144
292	254	1	0	1	29.6702141394
292	255	1	0	1	34.5884992705
292	257	2	0	2	41.4897720475
292	259	1	0	1	28.9967716868
292	262	10	0	10	25.7450673907
292	264	6	1	5	39.6426609984
292	266	3	0	3	31.9377945055
292	268	1	0	1	32.7500900958
292	270	2	0	2	37.8073359612
292	271	13	0	13	19.8407429758
292	272	257	44	213	9.21718749274
292	273	10	1	9	13.0736083696
292	274	9	0	9	24.7790501563
292	275	5	0	5	29.0104491942
292	276	19	16	3	11.1925568858
292	277	323	115	208	23.048560171
292	279	1	0	1	31.5711428137
292	280	5	0	5	22.5153870504
292	281	9	1	8	21.161778364
292	282	8	0	8	16.5499319775
292	284	83	55	28	7.85094591249
292	285	7	0	7	16.7671182752
292	286	1	0	1	19.0820037534
292	287	13	4	9	13.0418240737
292	288	2	0	2	27.7359836501
292	291	75	5	70	5.15340763155
292	293	306	17	289	8.82795939116
292	294	30	2	28	18.4332988863
292	295	54	23	31	6.50582535583
292	296	3	1	2	20.1796445961
292	297	4	0	4	14.2630435423
292	298	29	14	15	6.62964826018
292	301	6	1	5	14.7869450466
292	302	3	1	2	14.0655719734
292	304	1	0	1	60.1342313308
292	305	3	0	3	37.8868177332
292	307	1	0	1	49.5585141995
292	345	1	0	1	27.3249159687
292	346	2	0	2	45.5390532755
292	350	1	0	1	30.4593782294
292	377	5	0	5	35.2523761035
292	475	0	0	0	117.992265382
292	485	0	0	0	154.283454538
293	0	2	1	1	61.6528092878
293	1	40	8	32	69.2117550575
293	7	3	1	2	66.0526338982
293	12	2	0	2	78.4751154588
293	13	4	0	4	65.0314378799
293	15	1	0	1	68.7806837981
293	16	1	0	1	57.4591893236
293	21	1	0	1	77.0375656854
293	25	1	0	1	91.0512274698
293	28	1	0	1	64.1629641466
293	32	2	0	2	51.197183078
293	35	0	0	0	72.9368279719
293	36	6	0	6	61.2989153036
293	42	1	0	1	56.9242724564
293	53	2	0	2	103.049827762
293	55	1	0	1	102.041677168
293	69	1	0	1	100.258775152
293	70	30	5	25	47.2766784948
293	71	7	0	7	57.6140419809
293	72	2	0	2	47.2606796646
293	73	430	0	430	53.0075713294
293	74	19	0	19	54.3787669518
293	75	18	0	18	55.3584510445
293	76	28	2	26	49.5950874081
293	78	40	22	18	53.2249215663
293	79	7	1	6	49.268249747
293	80	2	0	2	49.3773494713
293	81	26	0	26	48.9694025444
293	82	48	5	43	50.9011309435
293	83	21	0	21	52.554556361
293	84	36	0	36	53.7277235228
293	85	4	0	4	52.5041771395
293	86	3	0	3	56.7874198907
293	87	13	1	12	56.92813379
293	88	8	0	8	57.7917405944
293	89	5	1	4	42.1398967669
293	90	3	0	3	49.2191049962
293	92	15	0	15	43.0321041517
293	95	3	0	3	53.9604178971
293	96	8	0	8	45.5680264452
293	97	1	0	1	32.6405852521
293	98	1	0	1	59.2326020312
293	101	2	0	2	33.1746344328
293	103	12	0	12	58.0225038236
293	104	1	0	1	50.1683293784
293	109	2	0	2	44.4466662153
293	110	3	0	3	62.073017194
293	111	4	2	2	37.8901494573
293	112	16	0	16	57.6653813375
293	113	25	7	18	60.7956549699
293	116	1	0	1	48.7977492043
293	120	2	0	2	48.7093686942
293	123	1	0	1	35.1681111431
293	131	1	0	1	102.847132915
293	133	1	0	1	72.596707491
293	140	1	0	1	66.6536568982
293	142	6	0	6	76.2197903721
293	146	1	0	1	63.5551005978
293	154	1	0	1	80.8303934832
293	155	1	0	1	55.3779647589
293	162	1	0	1	50.5796913891
293	169	1	0	1	43.9901423686
293	177	0	0	0	69.4149762209
293	181	2	1	1	38.5874920528
293	183	20	2	18	51.4498540685
293	185	6	0	6	52.3072982796
293	186	1	1	0	40.2839125649
293	187	2	0	2	43.5317081491
293	188	1	0	1	45.6514199077
293	190	5	0	5	57.3392696482
293	196	8	0	8	52.9810424999
293	198	1	0	1	65.2646565631
293	199	1	0	1	39.9479526662
293	200	1	0	1	43.367490464
293	202	1	0	1	49.0269471876
293	204	33	0	33	12.0006858839
293	205	37	2	35	14.4850562419
293	206	8	3	5	17.936782097
293	207	20	3	17	22.0533109911
293	208	132	0	132	25.7418466105
293	209	18	1	17	24.5464247142
293	210	1	0	1	27.5395598319
293	211	10	2	8	33.476677
293	212	116	73	43	15.6671813888
293	213	9	0	9	31.5020131862
293	214	25	0	25	18.9615875406
293	215	2	1	1	22.7350059967
293	216	1	0	1	61.9731313492
293	220	8	0	8	62.6739323621
293	221	2	0	2	56.4526930493
293	222	1	0	1	60.3405925618
293	224	2	1	1	26.3906246875
293	225	8	0	8	30.1063541323
293	229	17	0	17	35.4306128394
293	231	4	0	4	18.6887139541
293	232	2	0	2	25.3088003999
293	233	5	2	3	21.6798556511
293	234	1	0	1	29.8338250299
293	235	1	0	1	27.9781415721
293	236	12	0	12	24.797298379
293	237	23	9	14	18.9936548693
293	239	1	0	1	32.590935848
293	242	2	1	1	71.6435389547
293	244	1	0	1	70.3647106254
293	245	57	7	50	33.0078065013
293	246	1	0	1	30.9006416603
293	247	15	4	11	21.5204069286
293	248	2	0	2	26.3605300404
293	249	4	0	4	19.1510701193
293	250	4	0	4	25.9840127572
293	251	18	0	18	27.1305940764
293	252	6	0	6	19.8510861092
293	253	88	36	52	13.0521751084
293	254	2	0	2	24.428075636
293	257	8	0	8	38.1785959087
293	258	2	0	2	44.1026176994
293	259	4	0	4	27.9574224437
293	262	19	6	13	23.4780269656
293	264	5	0	5	37.5567430435
293	266	9	1	8	38.1310473104
293	267	1	0	1	39.440979706
293	268	1	0	1	40.1499763711
293	270	3	0	3	40.6152902318
293	271	8	1	7	27.8667311002
293	272	109	23	86	16.8988635697
293	273	12	3	9	15.1028683856
293	274	7	4	3	24.9840741729
293	275	10	2	8	32.8074952012
293	276	106	3	103	9.5336655197
293	277	1087	26	1061	25.63855776
293	279	3	0	3	32.3080655376
293	280	1	0	1	27.5413529316
293	281	18	1	17	20.1433503561
293	282	50	15	35	15.8507769423
293	284	148	13	135	11.5423733976
293	285	4	0	4	23.2183170341
293	286	12	0	12	15.5832898577
293	287	20	1	19	17.3628508069
293	288	1	0	1	33.2272832786
293	289	1	0	1	40.4139969679
293	291	30	2	28	13.9740117626
293	292	119	42	77	8.82795939116
293	294	322	2	320	11.5809697613
293	295	164	40	124	6.10388871704
293	296	42	0	42	11.4383898419
293	297	120	0	120	10.4071926162
293	298	130	39	91	6.58157205792
293	299	22	13	9	5.68609548211
293	300	3	0	3	16.0559611692
293	301	72	11	61	6.6360938443
293	302	48	12	36	7.69351087952
293	303	1	0	1	61.6624475765
293	304	1	0	1	57.8808384401
293	305	5	1	4	37.4585093289
293	307	13	0	13	48.6041759034
293	308	1	0	1	49.0517262238
293	309	1	0	1	51.4116532064
293	315	1	0	1	15.7643344443
293	316	1	0	1	13.5652780573
293	317	0	0	0	19.0833942735
293	319	0	0	0	74.8838228239
293	338	2	0	2	51.0098857295
293	345	12	1	11	29.0875480459
293	350	3	0	3	21.640055947
293	356	0	0	0	82.802425258
293	369	1	0	1	34.8310076067
293	371	1	0	1	29.7867816035
293	373	1	0	1	36.2649845505
293	375	3	1	2	30.3542690765
293	377	10	3	7	28.5025946381
293	378	3	0	3	15.2212805805
293	408	1	0	1	140.792007455
293	469	1	0	1	118.716415987
293	471	1	0	1	117.809595671
293	475	1	0	1	111.234209161
293	488	1	0	1	132.435837454
293	494	1	0	1	117.231357632
293	503	1	0	1	129.862607824
293	507	1	0	1	202.582363821
293	524	1	0	1	141.304561516
293	573	1	0	1	98.4871394305
294	0	2	0	2	68.9700317579
294	1	24	5	19	77.8548650487
294	5	1	1	0	88.2035267893
294	7	1	0	1	73.4079020277
294	12	0	0	0	87.4152246855
294	13	2	0	2	71.924783797
294	21	1	0	1	85.1405815319
294	31	1	0	1	74.0071271253
294	34	1	0	1	86.864335671
294	36	2	0	2	66.7727263706
294	41	1	0	1	73.8417715372
294	55	1	0	1	108.353027201
294	60	1	0	1	100.681948338
294	66	1	0	1	96.78592944
294	70	25	0	25	48.9945352579
294	71	7	0	7	58.8050814782
294	73	182	9	173	55.6811581281
294	74	10	1	9	56.1047078621
294	75	13	1	12	57.8805381679
294	76	22	1	21	50.9070408612
294	77	1	0	1	51.2426058444
294	78	18	1	17	54.7133339455
294	79	4	0	4	52.2709209849
294	80	1	0	1	51.9175628473
294	81	15	1	14	51.3262225563
294	82	13	1	12	52.5851194428
294	83	12	0	12	54.7942698712
294	84	22	7	15	56.1269113139
294	85	7	0	7	53.2144288422
294	86	6	0	6	57.5941222231
294	87	10	1	9	58.9522257801
294	88	5	0	5	59.4393441877
294	89	4	0	4	46.158887338
294	90	6	1	5	48.8637246317
294	92	8	4	4	45.5060695797
294	96	8	1	7	44.3877321983
294	101	2	0	2	36.5068828681
294	102	1	0	1	55.1838006962
294	103	4	0	4	61.1849146638
294	104	3	0	3	54.9970076366
294	109	1	0	1	45.0256920027
294	110	2	0	2	65.4653155231
294	111	1	0	1	41.0045804096
294	112	8	0	8	61.412092841
294	113	14	1	13	63.2387299309
294	114	1	0	1	64.9180497307
294	116	2	0	2	49.5815238396
294	118	2	0	2	51.9625321754
294	119	1	0	1	53.9338464677
294	120	2	2	0	52.4148028745
294	123	1	0	1	39.6113296578
294	142	8	1	7	78.5753609689
294	156	1	0	1	48.2815132049
294	164	1	0	1	60.3579169755
294	166	2	0	2	53.828193653
294	168	1	0	1	64.7076240879
294	169	4	1	3	41.5840380724
294	172	2	0	2	69.4908799543
294	177	0	0	0	67.9540692581
294	181	3	1	2	48.4732887911
294	183	8	0	8	61.0056077596
294	185	4	0	4	60.5350196743
294	188	1	0	1	53.4593239969
294	190	3	0	3	67.8790589402
294	191	1	0	1	62.3625114393
294	195	1	0	1	62.9665763644
294	196	1	0	1	53.3794808174
294	202	1	0	1	51.1038032322
294	204	29	1	28	14.0651277664
294	205	51	0	51	11.2740331759
294	206	8	2	6	19.8667742358
294	207	9	0	9	24.6265445962
294	208	70	0	70	24.7708256343
294	209	7	0	7	26.6276902861
294	210	3	0	3	30.4331081884
294	211	1	0	1	32.2277858242
294	212	86	18	68	20.5375073883
294	213	8	1	7	31.818911187
294	214	14	5	9	17.0439231656
294	215	1	0	1	17.365645923
294	216	1	0	1	69.8459686654
294	219	1	0	1	69.9599307389
294	220	3	0	3	69.9253022433
294	222	0	0	0	68.8790148618
294	223	0	0	0	45.5038724918
294	225	4	0	4	34.0763219845
294	228	1	0	1	39.9102983351
294	229	4	0	4	39.2622571103
294	231	3	0	3	26.6776109991
294	232	1	0	1	31.3561037873
294	233	2	0	2	27.6670483763
294	234	2	0	2	36.8410269688
294	235	1	0	1	37.4668566116
294	236	0	0	0	33.2966264844
294	237	21	2	19	24.7551394609
294	239	3	0	3	38.3678706773
294	242	1	0	1	76.2249641704
294	245	23	0	23	38.9795404022
294	247	23	0	23	21.1225394839
294	249	1	0	1	24.1103592685
294	251	11	3	8	29.1975017997
294	252	2	0	2	27.5993643236
294	253	44	1	43	19.1254453332
294	254	3	1	2	30.832764746
294	256	1	0	1	50.7273710167
294	257	2	0	2	45.8600591043
294	258	1	0	1	52.2216693073
294	262	7	0	7	32.8782718138
294	264	1	0	1	46.3727491569
294	266	2	0	2	49.5534531194
294	268	1	0	1	51.0778510481
294	270	1	0	1	51.9243033471
294	271	2	1	1	38.2740285312
294	272	33	4	29	27.5226385952
294	273	2	1	1	26.6164584537
294	274	3	1	2	35.6834515166
294	275	4	0	4	44.3416645093
294	276	16	0	16	20.6702029288
294	277	268	18	250	37.0485483741
294	281	5	0	5	30.5242075558
294	282	18	4	14	26.6777397873
294	284	22	1	21	23.0592017287
294	285	1	0	1	34.4850199235
294	286	2	0	2	24.8948527064
294	287	3	1	2	28.9233278128
294	289	1	0	1	51.3868544065
294	291	19	1	18	22.9185937529
294	292	42	0	42	18.4332988863
294	293	695	31	664	11.5809697613
294	295	30	5	25	17.6756935197
294	296	46	0	46	11.8620750142
294	297	134	12	122	6.3982562431
294	298	35	1	34	12.3248428464
294	299	1	0	1	11.0160247614
294	300	2	0	2	17.2610947241
294	301	78	38	40	5.57904945477
294	302	6	0	6	16.3713858149
294	305	4	0	4	47.4399262067
294	306	1	0	1	64.2603263025
294	307	5	0	5	57.9870462528
294	308	0	0	0	59.3044151586
294	310	26	0	26	16.9214788251
294	311	1	0	1	24.8312469329
294	313	1	0	1	24.5902237052
294	314	4	1	3	23.4277357137
294	315	14	1	13	7.20587298167
294	316	18	0	18	8.73831989504
294	317	33	3	30	7.50307414415
294	319	1	0	1	68.9032602165
294	323	1	0	1	71.981406023
294	332	2	0	2	38.3560560163
294	335	1	0	1	35.7090574078
294	336	1	0	1	32.4456979882
294	338	8	1	7	41.8901473109
294	341	1	0	1	32.2251812413
294	345	14	2	12	25.1365055856
294	347	0	0	0	40.5148278943
294	348	1	0	1	30.8169199156
294	349	1	0	1	49.4504411657
294	350	36	5	31	16.40699844
294	352	1	0	1	27.1886008303
294	353	1	0	1	36.6011902591
294	367	1	0	1	56.0944918431
294	369	2	0	2	23.7376997903
294	370	2	0	2	12.275625035
294	371	1	0	1	23.5064733829
294	372	3	0	3	19.0605922799
294	373	8	1	7	24.6915688946
294	375	106	21	85	20.4538099408
294	377	31	3	28	17.0207688128
294	378	40	39	1	7.36193181319
294	471	1	0	1	122.207551008
294	472	1	0	1	113.919172303
294	475	2	0	2	112.40201752
294	482	1	0	1	148.450796733
294	505	1	0	1	147.374025071
294	551	0	0	0	97.5927576227
294	568	1	0	1	92.4829002925
294	573	0	0	0	94.9180699492
294	586	0	0	0	94.8004798418
295	1	16	0	16	65.3447473195
295	12	2	0	2	74.3619111568
295	13	3	0	3	62.3354831104
295	16	1	0	1	54.6145001671
295	36	4	2	2	59.5241240911
295	41	2	0	2	66.2568463641
295	47	1	0	1	111.169724167
295	65	0	0	0	103.222605479
295	70	1	0	1	47.9055385755
295	72	1	0	1	47.3809386156
295	73	56	6	50	52.9925484088
295	74	4	1	3	54.8583213988
295	75	4	0	4	55.385633724
295	76	8	0	8	50.3893806968
295	77	1	0	1	48.3666268217
295	78	4	0	4	53.8530550842
295	79	1	0	1	49.1432428252
295	81	1	0	1	49.2115149973
295	82	6	0	6	51.4693330937
295	83	4	0	4	52.7880836315
295	84	5	1	4	53.8516403553
295	85	3	0	3	53.5565946218
295	86	1	0	1	57.7144681492
295	87	1	0	1	57.2026722812
295	90	1	0	1	50.8806766933
295	92	5	1	4	43.3564455448
295	103	2	0	2	57.648054361
295	112	2	0	2	56.9630423999
295	113	6	1	5	60.7816328348
295	120	2	0	2	48.1939452632
295	142	0	0	0	76.0783794605
295	181	3	1	2	33.5504002195
295	183	4	0	4	46.5154583904
295	186	1	0	1	36.0947857761
295	187	1	0	1	40.661567261
295	188	2	0	2	41.8912563319
295	190	1	0	1	51.7708947015
295	196	1	0	1	53.3745493739
295	198	1	0	1	65.5180397694
295	204	3	0	3	14.6291742733
295	205	5	0	5	18.7607238549
295	206	6	1	5	19.4033341757
295	207	3	1	2	22.6441231338
295	208	26	2	24	27.8564508642
295	209	3	0	3	25.180343162
295	211	3	0	3	35.285449187
295	212	19	13	6	15.7374308853
295	220	1	0	1	59.0562446371
295	225	1	0	1	29.2521997009
295	227	1	0	1	35.8933057884
295	229	5	0	5	34.4071447923
295	231	2	0	2	15.9170286476
295	232	0	0	0	23.4218943726
295	236	4	0	4	21.144094346
295	237	4	1	3	17.9131492273
295	238	1	0	1	30.4275117754
295	242	0	0	0	69.486800692
295	245	14	3	11	31.5655613881
295	247	3	0	3	24.4289889463
295	251	2	0	2	28.3731252119
295	253	13	11	2	13.6359026782
295	254	1	0	1	23.1731575499
295	257	2	1	1	35.3787922806
295	258	1	0	1	40.8624533526
295	259	1	0	1	23.6395679545
295	261	1	0	1	39.3753600347
295	262	4	3	1	19.8426328244
295	264	3	1	2	33.9332681739
295	265	1	0	1	36.0473404596
295	266	3	0	3	32.0805590832
295	270	2	0	2	34.8602025808
295	271	2	0	2	22.595806335
295	272	81	0	81	11.7533469324
295	273	10	6	4	9.22366589751
295	274	8	0	8	20.0016879481
295	275	6	1	5	26.8144338899
295	276	112	7	105	4.99568941694
295	277	514	61	453	19.8331737161
295	279	2	0	2	27.1862792731
295	281	9	0	9	15.6839442092
295	282	23	7	16	11.0859775625
295	284	154	13	141	5.48108495658
295	285	2	1	1	17.3089731396
295	286	8	1	7	12.7258255761
295	287	12	6	6	11.2593511036
295	291	12	0	12	10.9700096798
295	292	58	4	54	6.50582535583
295	293	430	132	298	6.10388871704
295	294	27	0	27	17.6756935197
295	296	10	2	8	15.5491340637
295	297	2	0	2	15.7099530781
295	298	14	5	9	9.41496138699
295	299	1	0	1	9.8852051778
295	301	3	1	2	12.6574008213
295	302	15	5	10	7.93279894842
295	303	1	0	1	57.3545752868
295	304	2	0	2	54.4389906215
295	305	3	0	3	32.9078827734
295	307	2	0	2	44.3833395085
295	309	1	0	1	47.8732181506
295	317	1	0	1	25.1786571406
295	328	2	0	2	69.1646854928
295	415	1	0	1	131.301455485
296	1	29	1	28	66.7976808634
296	7	1	0	1	61.8246924541
296	13	1	0	1	60.2268745518
296	15	1	0	1	64.6394552601
296	28	4	0	4	61.7864533958
296	32	1	0	1	47.429713387
296	33	1	0	1	62.4949570865
296	36	2	1	1	54.9132001955
296	39	1	0	1	48.5971080694
296	41	1	0	1	61.9846647581
296	48	1	0	1	95.1829343456
296	64	3	0	3	93.8968248422
296	70	43	0	43	37.7566070997
296	71	7	1	6	47.8354301819
296	72	3	0	3	38.3733195546
296	73	480	30	450	44.1681635525
296	74	17	1	16	44.9051337346
296	75	18	0	18	46.4205856587
296	76	96	22	74	39.8420581525
296	77	1	0	1	39.6611484329
296	78	36	4	32	43.5988142989
296	79	14	2	12	40.657565996
296	80	0	0	0	40.4246550333
296	81	20	4	16	39.8848875301
296	82	44	9	35	41.3822992037
296	83	10	0	10	43.4079467905
296	84	40	0	40	44.6965129693
296	85	10	0	10	42.4332583035
296	86	5	0	5	46.7915692696
296	87	10	0	10	47.6578818744
296	88	4	2	2	48.2857592876
296	89	7	3	4	34.3435943207
296	90	11	0	11	38.6212002809
296	91	1	0	1	15.6320751511
296	92	9	3	6	33.9945359327
296	93	2	1	1	16.9365280034
296	95	3	1	2	46.3813974962
296	96	18	6	12	34.6331107541
296	97	2	0	2	21.3110558376
296	99	1	0	1	58.5538297924
296	100	1	0	1	47.700476069
296	101	6	0	6	24.7388046427
296	102	2	0	2	43.3802820216
296	103	12	2	10	49.5670650682
296	104	1	0	1	43.1391058963
296	107	1	0	1	54.5680493268
296	109	7	0	7	34.2497130446
296	110	6	0	6	53.8081590681
296	111	7	0	7	29.3058095281
296	112	10	6	4	49.6766689181
296	113	23	2	21	51.8234808967
296	115	5	1	4	24.2531401228
296	117	2	0	2	50.4039145837
296	119	1	0	1	43.7268542649
296	120	2	0	2	40.661301357
296	122	3	0	3	28.5683868959
296	131	1	0	1	94.7179340728
296	134	1	0	1	63.6399201293
296	142	5	0	5	67.2326068401
296	146	3	0	3	53.9299233087
296	154	1	0	1	70.8271456008
296	155	1	0	1	44.2388081781
296	166	2	0	2	46.2172424762
296	168	1	0	1	54.6873177117
296	169	2	0	2	32.7200422884
296	171	1	0	1	46.472369074
296	177	2	1	1	58.5013466769
296	183	4	1	3	62.0642230514
296	187	1	0	1	54.9700474417
296	190	1	0	1	67.0059322102
296	191	1	0	1	69.1752505687
296	196	2	0	2	62.9509790538
296	204	2	1	1	21.6746273835
296	205	1	0	1	21.5302865545
296	207	1	0	1	32.4980336352
296	208	22	0	22	34.6929621367
296	209	2	0	2	34.8704996258
296	212	9	0	9	26.6506455694
296	213	1	0	1	41.2196830823
296	214	3	0	3	27.1281507951
296	216	1	0	1	73.2322849943
296	220	5	0	5	74.0446191169
296	222	2	0	2	71.4083488459
296	224	2	0	2	37.5242505749
296	229	2	0	2	46.476729307
296	232	0	0	0	36.6862727202
296	236	2	0	2	36.0967618106
296	241	1	0	1	87.6284452603
296	242	0	0	0	82.9642883602
296	243	1	0	1	78.2673288494
296	245	65	15	50	27.2462153805
296	246	8	4	4	23.2640964932
296	247	226	108	118	10.469784756
296	248	1	0	1	19.1363965791
296	249	17	1	16	12.4224930808
296	250	6	2	4	22.8746150995
296	251	87	0	87	17.628144277
296	252	6	0	6	16.9580727711
296	253	208	6	202	8.44694474541
296	254	19	0	19	19.3540749474
296	256	1	0	1	39.0303538769
296	257	9	0	9	34.5835761009
296	259	1	0	1	28.5958738057
296	262	19	0	19	23.2351466896
296	264	3	0	3	35.7404713348
296	265	0	0	0	47.8394325986
296	266	2	1	1	46.1672730142
296	268	2	0	2	49.4485791698
296	270	3	0	3	44.7575068972
296	271	3	0	3	38.1141007755
296	272	25	7	18	27.3010970962
296	274	3	0	3	27.6286462614
296	275	2	0	2	38.5747903429
296	276	26	5	21	15.4300352205
296	277	370	88	282	30.8350279819
296	279	2	0	2	34.6410186834
296	280	1	0	1	34.970440741
296	281	16	4	12	22.2977409313
296	282	23	4	19	19.6598425444
296	284	18	9	9	20.5218034593
296	285	2	0	2	32.2657376777
296	286	9	3	6	15.9110147549
296	291	2	1	1	25.3300687673
296	292	23	0	23	20.1796445961
296	293	490	0	490	11.4383898419
296	294	264	10	254	11.8620750142
296	295	6	0	6	15.5491340637
296	297	15	1	14	16.1628947522
296	298	9	8	1	17.1297704226
296	299	13	9	4	5.85976074889
296	300	53	11	42	5.58749609007
296	301	15	5	10	8.22732342014
296	302	35	13	22	9.13831168467
296	303	2	0	2	60.4873315634
296	305	1	0	1	37.8614559845
296	307	4	0	4	47.6116888002
296	310	3	0	3	17.6673807879
296	315	2	0	2	9.54756603942
296	316	9	1	8	5.27445243416
296	324	0	0	0	58.9213277629
296	338	3	1	2	41.2837184599
296	345	1	0	1	36.3127547133
296	348	2	0	2	23.3621610468
296	349	1	0	1	45.7464789904
296	350	20	2	18	10.8701278599
296	351	1	0	1	40.5954735281
296	353	1	0	1	32.4823703086
296	377	1	0	1	24.1024509954
296	385	0	0	0	108.2271423
296	405	1	0	1	137.177937729
296	471	2	0	2	110.436575244
296	480	1	0	1	110.210919631
296	495	0	0	0	125.00065378
296	501	1	0	1	132.948822319
296	505	1	0	1	136.049346875
296	507	1	0	1	191.229695751
296	573	0	0	0	87.1392535443
296	581	0	0	0	72.3078249061
297	1	8	4	4	79.4360612807
297	7	1	0	1	75.8569527118
297	15	1	1	0	78.6180024083
297	35	2	0	2	82.2836482365
297	36	5	0	5	70.2410979052
297	43	0	0	0	125.041758106
297	46	1	0	1	108.239236622
297	70	5	0	5	53.9147247174
297	73	26	1	25	60.3019585963
297	74	3	0	3	61.0615205989
297	75	2	0	2	62.5675749139
297	76	1	0	1	55.9723990825
297	78	8	0	8	59.7419115426
297	79	0	0	0	56.7494780698
297	81	1	0	1	56.0386340587
297	82	2	0	2	57.5378871691
297	84	4	3	1	60.8500333789
297	85	1	0	1	58.479179052
297	87	1	0	1	63.820727516
297	89	2	0	2	50.1884441944
297	92	1	1	0	50.1370174133
297	96	2	0	2	50.1118959878
297	105	1	0	1	53.8382004397
297	109	1	0	1	50.2808919182
297	111	3	0	3	45.3561822144
297	112	1	0	1	65.639886182
297	113	4	0	4	67.9770572515
297	118	1	0	1	57.3809061916
297	119	1	0	1	59.5029649608
297	142	2	0	2	83.3923474856
297	171	0	0	0	61.9747918912
297	183	3	1	2	55.6852986773
297	191	1	0	1	55.9651760234
297	193	0	0	0	52.5232026816
297	196	3	0	3	47.3578804467
297	200	1	0	1	38.2193321431
297	204	42	35	7	7.79359358556
297	205	92	37	55	5.38178283618
297	206	15	0	15	13.4685188185
297	207	17	0	17	18.2284067116
297	208	63	6	57	18.8011258766
297	209	9	3	6	20.2479919477
297	211	1	0	1	26.4443648841
297	212	71	60	11	14.4115470735
297	213	6	0	6	25.6812162021
297	214	53	13	40	11.0984673436
297	215	1	0	1	12.9764479578
297	224	3	0	3	24.6237025402
297	225	6	0	6	27.6871553675
297	226	1	0	1	28.6493978265
297	228	1	0	1	33.622799796
297	229	3	0	3	32.8646727085
297	230	1	0	1	40.7655058052
297	231	2	0	2	21.1581748549
297	232	1	0	1	25.2044400301
297	233	1	0	1	21.5626756712
297	236	2	1	1	27.79333873
297	237	11	2	9	18.6708171884
297	242	0	0	0	69.8270870517
297	244	1	0	1	67.5478491737
297	245	6	0	6	42.0446295129
297	247	3	0	3	26.3107177624
297	249	1	0	1	27.3982391027
297	251	1	0	1	33.7777263622
297	253	9	4	5	21.6966116054
297	262	2	0	2	33.774923435
297	266	1	0	1	46.1736086313
297	271	1	0	1	33.7342943237
297	272	7	1	6	23.4542834716
297	273	1	0	1	24.9226187272
297	274	3	0	3	35.3488671878
297	275	2	0	2	42.3255695238
297	276	8	2	6	19.870679992
297	277	105	12	93	35.5306874384
297	279	2	0	2	42.651577881
297	281	3	0	3	30.550359149
297	282	6	1	5	26.2232585848
297	284	17	0	17	20.507403139
297	285	1	0	1	30.9885130915
297	286	1	0	1	25.792769824
297	287	1	0	1	26.3770944804
297	291	4	0	4	17.9892229575
297	292	23	2	21	14.2630435423
297	293	277	4	273	10.4071926162
297	294	246	106	140	6.3982562431
297	295	6	1	5	15.7099530781
297	296	4	2	2	16.1628947522
297	298	33	7	26	7.63633406579
297	299	1	1	0	12.9538529807
297	301	17	16	1	8.00011713587
297	302	3	1	2	17.4190090163
297	303	2	0	2	72.0225960411
297	307	1	0	1	58.957587124
297	309	1	0	1	61.5396294698
297	310	1	0	1	23.1611706422
297	317	1	0	1	11.9129992924
297	338	0	0	0	47.9344076197
297	341	1	0	1	37.7298682784
297	345	4	0	4	20.2055557025
297	346	1	0	1	42.2966594307
297	350	3	1	2	22.6050445993
297	370	1	0	1	10.1873520625
297	371	3	0	3	19.8425942081
297	373	2	0	2	27.9363264619
297	375	8	0	8	20.1115685251
297	377	6	1	5	21.4516366108
297	378	11	10	1	4.95814318621
297	402	1	0	1	148.376333427
297	472	2	0	2	118.458891978
297	505	1	0	1	152.206192383
297	583	1	0	1	106.544715225
298	1	5	0	5	74.6658069491
298	7	1	0	1	72.0256285815
298	28	1	0	1	69.6353440039
298	29	1	0	1	96.5268964546
298	70	4	1	3	53.8019058047
298	71	2	0	2	64.1154477119
298	73	58	7	51	59.5843421773
298	74	6	0	6	60.9157054215
298	76	1	1	0	56.0925777907
298	78	5	0	5	59.7434919582
298	81	3	0	3	55.5333266749
298	82	7	3	4	57.4302546981
298	83	2	0	2	59.1170217908
298	84	11	2	9	60.2972581444
298	85	2	0	2	58.9486155657
298	87	1	0	1	63.4847252881
298	88	4	0	4	64.3277996062
298	89	1	0	1	48.7112741999
298	92	1	0	1	49.5940270435
298	95	1	0	1	60.508044272
298	96	1	0	1	51.6981912772
298	102	1	0	1	55.5091423915
298	103	2	0	2	64.6035435313
298	111	1	0	1	44.4670566761
298	113	3	1	2	67.3703717567
298	140	1	0	1	73.2340955312
298	142	2	0	2	82.7971382517
298	166	1	0	1	63.1751351044
298	171	1	0	1	63.5016972401
298	181	1	0	1	36.1916722359
298	183	2	0	2	48.6815371611
298	184	1	0	1	47.0515660899
298	185	1	0	1	48.3986659439
298	186	1	0	1	36.6357514283
298	187	0	0	0	38.5127061869
298	188	0	0	0	41.4314934325
298	191	0	0	0	52.1254389795
298	196	2	1	1	46.4322614653
298	198	0	0	0	58.7239530723
298	200	1	0	1	36.8455397323
298	204	98	49	49	5.53131175446
298	205	19	6	13	9.43668518093
298	206	10	5	5	11.3574046185
298	207	12	0	12	15.5644068331
298	208	59	3	56	19.2515303766
298	209	7	1	6	18.0290962874
298	210	1	0	1	21.1673560838
298	211	4	0	4	26.9484581381
298	212	224	74	150	9.53205657696
298	213	7	2	5	24.9209760701
298	214	22	0	22	12.8593405845
298	220	0	0	0	58.1534242947
298	223	1	0	1	34.9506526685
298	224	2	1	1	20.4240739159
298	225	2	0	2	24.0082958563
298	227	1	0	1	33.366550476
298	228	1	0	1	31.7037121943
298	229	6	1	5	29.3478615884
298	231	3	1	2	14.4315071697
298	232	1	0	1	19.9187452981
298	233	4	1	3	16.1945429415
298	234	1	0	1	25.0173935388
298	236	6	0	6	21.0132058714
298	237	30	8	22	13.3357253986
298	238	0	0	0	30.0559163332
298	239	2	0	2	27.1669545062
298	242	1	0	1	65.9496335328
298	245	2	0	2	39.4459377084
298	247	5	0	5	27.5354135802
298	251	3	0	3	33.6101300165
298	252	1	0	1	26.1059328111
298	253	8	1	7	19.6309266683
298	257	0	0	0	44.2017110668
298	262	1	0	1	29.0037936383
298	264	1	0	1	43.1422737015
298	266	1	0	1	38.5598662245
298	268	2	0	2	39.2820834609
298	270	1	0	1	43.6820029983
298	271	3	0	3	26.2161134906
298	272	35	1	34	15.8199664734
298	274	1	0	1	29.4009998498
298	275	1	0	1	35.157320213
298	276	11	0	11	14.2520846031
298	277	139	7	132	28.712537974
298	279	1	0	1	36.5370686205
298	281	2	1	1	25.0650241251
298	282	5	1	4	20.4907431167
298	284	18	1	17	13.3968089861
298	285	1	0	1	23.3807234197
298	287	4	0	4	19.1223483354
298	291	22	1	21	10.623925095
298	292	47	11	36	6.62964826018
298	293	519	3	516	6.58157205792
298	294	39	6	33	12.3248428464
298	295	11	5	6	9.41496138699
298	296	1	0	1	17.1297704226
298	297	21	4	17	7.63633406579
298	299	2	0	2	11.8610430329
298	301	8	0	8	9.92268134587
298	302	3	1	2	14.151326496
298	304	1	0	1	63.6075448982
298	305	2	0	2	42.3213559418
298	307	1	0	1	53.7691521821
298	345	5	0	5	23.0899109827
298	350	1	0	1	26.2615591027
298	375	2	0	2	27.1571833665
298	378	1	0	1	12.3671559182
298	466	0	0	0	138.607350593
298	470	1	0	1	116.19146087
298	488	1	0	1	138.938392877
298	505	1	0	1	151.391271834
298	573	0	0	0	104.193390791
299	1	4	0	4	67.0256855549
299	15	1	0	1	65.7975022017
299	24	1	0	1	71.1614708437
299	32	1	0	1	48.3058212565
299	36	1	0	1	57.3124949802
299	39	1	0	1	50.0958706789
299	70	4	0	4	42.0445190044
299	73	35	0	35	48.0280171674
299	74	1	0	1	49.1778344526
299	76	7	0	7	44.2912748143
299	78	4	0	4	47.9700556702
299	79	2	0	2	44.3611917915
299	83	1	0	1	47.4637126284
299	84	4	0	4	48.6807283213
299	87	1	0	1	51.8028754119
299	88	1	0	1	52.5857045916
299	94	1	0	1	28.7727138188
299	95	2	0	2	49.4626987174
299	96	1	0	1	39.9284801782
299	103	2	0	2	53.1980245167
299	112	1	0	1	53.0188816742
299	113	2	1	1	55.7848458651
299	166	1	0	1	51.9677272455
299	183	3	0	3	56.3483851901
299	185	1	0	1	57.653598715
299	196	1	0	1	58.2099714071
299	202	2	1	1	54.5079506467
299	204	1	0	1	16.8997550894
299	205	1	0	1	17.9943275369
299	207	0	0	0	27.4202590972
299	208	11	3	8	30.4289708828
299	212	6	0	6	21.2403264855
299	214	1	0	1	23.1804684489
299	226	1	0	1	38.5482773555
299	229	1	0	1	41.0516286883
299	236	1	0	1	30.2371032616
299	242	0	0	0	77.3289671444
299	245	8	4	4	29.092216756
299	247	5	2	3	15.8409786198
299	249	2	1	1	14.5391040734
299	252	3	0	3	16.8213127916
299	253	28	13	15	8.74282186072
299	254	1	0	1	20.6279806572
299	258	1	0	1	41.4971606779
299	262	1	0	1	21.8625118623
299	271	1	0	1	32.4756726454
299	272	6	0	6	21.5847628893
299	273	2	1	1	17.1922391715
299	275	1	0	1	34.6283800943
299	276	4	0	4	10.7859560319
299	277	74	2	72	27.0374645793
299	281	5	0	5	19.6760979454
299	282	8	0	8	16.1508768647
299	284	1	0	1	15.1101067388
299	286	3	1	2	13.8848765039
299	287	1	0	1	20.3825938378
299	291	1	0	1	19.4781886118
299	292	6	0	6	14.3315764747
299	293	161	107	54	5.68609548211
299	294	22	7	15	11.0160247614
299	295	7	0	7	9.8852051778
299	296	18	13	5	5.85976074889
299	297	5	0	5	12.9538529807
299	298	7	0	7	11.8610430329
299	300	3	0	3	10.4087025611
299	301	6	2	4	5.56623473482
299	302	13	5	8	5.4271991289
299	307	1	0	1	46.9945471011
299	350	2	0	2	16.4887514016
300	0	2	0	2	52.7260789938
300	1	9	0	9	62.6931705295
300	6	1	0	1	80.8824628995
300	7	1	0	1	57.1439359466
300	13	1	0	1	55.381360435
300	15	1	0	1	59.9703842994
300	24	1	0	1	65.364355369
300	28	3	0	3	57.7313160599
300	36	10	0	10	49.6771095556
300	39	2	0	2	43.809434616
300	70	28	2	26	32.1799038123
300	71	3	0	3	42.2931447478
300	72	3	0	3	32.7926559651
300	73	299	91	208	38.5862567421
300	74	17	2	15	39.329669984
300	75	6	0	6	40.8347966207
300	76	65	7	58	34.2893790517
300	77	3	1	2	34.0883560937
300	78	28	0	28	38.0351503312
300	79	9	1	8	35.0920873083
300	80	0	0	0	34.8403322349
300	81	19	0	19	34.2978252622
300	82	34	0	34	35.807938213
300	83	13	0	13	37.820523987
300	84	35	1	34	39.1094328349
300	85	10	0	10	36.9381380489
300	86	1	0	1	41.2850925892
300	87	7	0	7	42.0734626044
300	88	6	0	6	42.7144216026
300	89	4	0	4	28.9057362166
300	90	2	0	2	33.2983272926
300	91	2	1	1	12.5110580333
300	92	8	0	8	28.4106190823
300	93	4	1	3	12.1556586711
300	94	2	0	2	18.4305322039
300	95	0	0	0	40.9348274819
300	96	32	0	32	29.5202910177
300	97	4	1	3	16.8151557385
300	101	5	2	3	19.245932841
300	102	1	0	1	38.3659928661
300	103	7	0	7	44.0046667837
300	106	1	0	1	29.7975353671
300	109	4	0	4	28.7738147457
300	111	2	0	2	23.7668347892
300	112	6	0	6	44.1624078427
300	113	18	0	18	46.2363343133
300	115	5	1	4	18.6694523475
300	118	1	0	1	36.0334323974
300	120	1	0	1	35.1581369359
300	122	4	0	4	23.0090652637
300	133	1	0	1	59.147174788
300	142	4	0	4	61.645232705
300	146	1	0	1	48.3726510626
300	156	4	0	4	34.4738690316
300	169	1	0	1	28.0248739298
300	171	2	0	2	41.291926858
300	183	1	0	1	64.9311422137
300	187	0	0	0	59.2797554024
300	190	1	0	1	69.0187570369
300	204	2	0	2	27.0302953318
300	205	1	0	1	27.1123672446
300	207	1	0	1	37.7382439414
300	208	11	2	9	40.2168017707
300	212	2	0	2	31.6467206301
300	214	2	0	2	32.6875173969
300	220	0	0	0	77.9465360481
300	229	0	0	0	51.4602368804
300	236	1	0	1	39.9924771029
300	237	2	0	2	35.0485076841
300	238	1	0	1	49.3085714227
300	245	73	3	70	22.4772334485
300	246	10	0	10	17.9734512623
300	247	256	36	220	5.55090127031
300	248	9	1	8	14.0939041056
300	249	11	1	10	8.22024300927
300	251	83	25	58	12.0438236273
300	252	6	2	4	14.226214263
300	253	140	122	18	7.24737792057
300	254	11	1	10	15.2369587577
300	257	2	0	2	30.4442873284
300	258	1	0	1	37.0200942809
300	259	1	0	1	26.5573753241
300	260	1	0	1	28.7217667698
300	261	1	0	1	38.6207669571
300	262	12	2	10	21.1463404928
300	264	2	0	2	32.2974084053
300	266	2	0	2	47.3108632702
300	271	1	0	1	40.89319974
300	272	3	0	3	30.4453079227
300	273	2	0	2	23.2402337027
300	275	1	0	1	38.6322014023
300	276	2	2	0	17.3388177359
300	277	156	18	138	30.9007573974
300	280	1	0	1	36.0405803852
300	281	2	1	1	21.4738128457
300	282	3	1	2	19.9430886463
300	284	3	1	2	23.1705343479
300	285	2	0	2	34.3633537676
300	286	6	0	6	15.0808353135
300	287	1	0	1	27.2236068379
300	288	1	0	1	41.6975601301
300	292	3	0	3	24.3854827159
300	293	72	1	71	16.0559611692
300	294	49	2	47	17.2610947241
300	295	1	0	1	18.9023218199
300	296	86	53	33	5.58749609007
300	297	1	0	1	21.7487247473
300	301	3	1	2	13.792319941
300	302	9	6	3	11.2314394267
300	305	3	0	3	35.3303388928
300	306	1	0	1	51.1270069356
300	307	3	0	3	44.2568273504
300	308	1	0	1	47.1993962847
300	309	1	0	1	44.6786472171
300	310	3	0	3	19.0184209555
300	313	1	0	1	22.7355169404
300	316	1	0	1	9.37784722558
300	345	1	0	1	41.8975234038
300	348	1	0	1	19.6944247057
300	350	10	1	9	10.3488220691
300	353	1	0	1	30.18723192
300	459	1	0	1	109.844015771
300	466	1	0	1	117.744280354
300	469	1	0	1	104.3022735
300	494	0	0	0	102.440494448
300	503	1	0	1	114.51581946
300	581	1	0	1	67.5467986952
301	0	1	0	1	64.034635255
301	1	14	5	9	72.5864066105
301	7	1	0	1	68.4696658178
301	36	4	0	4	62.4094232016
301	70	5	0	5	45.9722056765
301	71	1	0	1	56.0627142533
301	73	58	5	53	52.3089014639
301	76	1	0	1	48.0688297303
301	78	5	0	5	51.8230177454
301	79	3	1	2	48.749941822
301	81	8	2	6	48.0565016922
301	82	9	0	9	49.600159249
301	83	5	1	4	51.5922834366
301	84	8	6	2	52.8672103634
301	87	1	0	1	55.8597946883
301	88	1	0	1	56.5060388983
301	89	1	0	1	42.2139626114
301	92	1	0	1	42.1483712882
301	95	2	1	1	54.2360097049
301	96	2	0	2	42.6276935672
301	98	1	0	1	57.0849332344
301	102	1	0	1	50.5996434322
301	103	3	0	3	57.6455432313
301	109	3	1	2	42.4621661812
301	112	1	0	1	57.6495028834
301	113	4	0	4	59.9937103644
301	142	3	0	3	75.4156293874
301	146	1	0	1	62.1561190296
301	183	5	1	4	57.6963393323
301	185	1	0	1	58.0368554033
301	190	1	0	1	63.8879391503
301	196	1	0	1	54.819025785
301	204	8	0	8	13.7287798539
301	205	10	0	10	13.33271026
301	206	3	1	2	20.0218645499
301	207	2	0	2	24.6575119937
301	208	27	5	22	26.4772731271
301	211	1	0	1	34.2140427913
301	212	27	0	27	19.3088551515
301	213	4	0	4	33.0796834886
301	214	2	0	2	18.9010457336
301	229	3	0	3	38.9540023161
301	231	1	0	1	24.0805525371
301	232	1	0	1	29.839381511
301	233	2	0	2	26.1133468479
301	236	1	0	1	30.5101595338
301	237	1	0	1	23.242858396
301	242	0	0	0	75.7398751679
301	245	7	0	7	34.3209591367
301	246	1	0	1	31.0016224762
301	247	7	3	4	18.5745979457
301	249	3	0	3	19.5455548255
301	251	3	0	3	25.7972056562
301	252	1	0	1	22.3599081951
301	253	22	0	22	14.0910340273
301	254	2	0	2	25.9649295289
301	257	1	0	1	40.76130604
301	262	5	1	4	27.3827107086
301	264	0	0	0	41.0164136048
301	266	2	0	2	44.7349899341
301	268	1	0	1	46.7647431924
301	271	3	0	3	34.3458295547
301	272	18	1	17	23.405002498
301	273	0	0	0	21.2969443859
301	274	4	0	4	30.1071858751
301	275	2	0	2	39.0046624557
301	276	14	0	14	15.1981474447
301	277	190	0	190	31.6151291108
301	280	2	0	2	34.0412302092
301	281	1	0	1	24.9456722719
301	282	9	0	9	21.1203211647
301	284	16	2	14	18.1331119804
301	285	3	0	3	29.8541406013
301	286	1	0	1	19.3741039879
301	287	1	0	1	23.8840457389
301	288	1	0	1	39.7634580216
301	291	5	5	0	19.7410765589
301	292	18	3	15	14.7869450466
301	293	553	203	350	6.6360938443
301	294	379	263	116	5.57904945477
301	295	18	0	18	12.6574008213
301	296	31	19	12	8.22732342014
301	297	40	14	26	8.00011713587
301	298	19	5	14	9.92268134587
301	299	5	0	5	5.56623473482
301	302	10	1	9	10.824094714
301	304	1	0	1	60.8616582489
301	305	2	1	1	41.9006006339
301	306	1	0	1	58.7515207787
301	307	2	0	2	52.5448602091
301	310	0	0	0	19.6617995003
301	315	3	0	3	9.24279259855
301	316	4	0	4	7.87487669037
301	317	1	0	1	12.8626553891
301	338	1	0	1	44.7017792015
301	345	2	0	2	28.204420148
301	348	1	0	1	30.3454630433
301	370	1	0	1	16.911332377
301	371	1	0	1	27.5472916365
301	373	1	1	0	30.0525383816
301	375	5	0	5	25.8035373623
301	377	1	0	1	22.0294192927
301	378	1	0	1	11.5093130018
301	412	0	0	0	148.307386753
301	415	1	0	1	127.838975678
301	469	1	0	1	118.067534274
301	471	2	0	2	118.318462597
301	503	1	0	1	128.241549096
301	573	1	0	1	94.5337520223
302	1	18	4	14	62.0579922288
302	3	1	0	1	51.4173455203
302	7	2	0	2	58.5148667154
302	15	1	0	1	61.2609242713
302	32	1	0	1	43.6959498688
302	36	8	2	6	53.6075130358
302	46	1	0	1	90.8918925424
302	49	1	0	1	78.5865766019
302	57	1	0	1	98.3901821692
302	65	1	0	1	98.6877714105
302	70	25	3	22	40.3164438033
302	71	5	0	5	50.719635685
302	72	1	0	1	40.0311207251
302	73	209	36	173	45.7271434004
302	74	9	0	9	47.3457370388
302	75	4	1	3	48.1004625341
302	76	40	0	40	42.7397674104
302	77	3	0	3	41.0968620475
302	78	25	3	22	46.2747189125
302	79	6	2	4	41.9344024917
302	81	10	0	10	41.8022592938
302	82	37	12	25	43.912329529
302	83	7	3	4	45.3896095721
302	84	19	1	18	46.5117021695
302	85	4	1	3	45.8229254482
302	86	6	0	6	50.0277865321
302	87	4	1	3	49.7905021309
302	89	4	0	4	34.6419452938
302	92	3	0	3	35.8936981732
302	96	2	1	1	39.7835312775
302	97	1	0	1	27.8940195424
302	102	1	0	1	41.4639645776
302	103	5	0	5	50.6060105919
302	105	1	0	1	37.5991406884
302	109	1	0	1	37.9305044191
302	110	3	0	3	54.597463132
302	111	4	0	4	30.6393540177
302	112	3	0	3	50.1430267148
302	113	21	0	21	53.5267829267
302	115	1	0	1	26.5891909028
302	140	1	0	1	59.3070489677
302	142	6	1	5	68.9116937029
302	146	1	0	1	56.5504392415
302	147	1	0	1	85.8411605708
302	171	2	0	2	51.2839731923
302	177	2	0	2	63.4228803882
302	183	3	0	3	53.7187634376
302	187	1	0	1	48.5938270007
302	190	3	0	3	58.1172471901
302	196	2	0	2	60.2475512448
302	198	1	0	1	72.4906990462
302	204	2	0	2	19.648569815
302	205	3	1	2	21.995682437
302	207	1	0	1	29.2812336046
302	208	15	0	15	33.3924579587
302	212	19	0	19	22.5890878029
302	214	2	0	2	26.6487225057
302	218	1	0	1	55.1875554262
302	220	5	0	5	66.9037939969
302	223	1	0	1	46.678662853
302	224	2	0	2	32.8690601249
302	225	0	0	0	36.690384678
302	229	2	0	2	41.934773717
302	231	1	0	1	23.8047955474
302	232	1	0	1	31.1777267504
302	236	3	0	3	29.0518127039
302	237	8	0	8	25.3517958184
302	243	2	0	2	72.3343662839
302	245	45	11	34	25.3205840683
302	246	7	0	7	23.473375243
302	247	14	4	10	16.6708873725
302	248	1	0	1	18.9186024729
302	249	17	0	17	11.851580044
302	250	1	0	1	18.4198815561
302	251	13	4	9	20.5266521412
302	252	8	3	5	12.2203383328
302	253	209	73	136	5.82520461923
302	254	7	0	7	16.7409213492
302	255	1	0	1	25.1599688096
302	257	5	2	3	30.647381286
302	259	1	0	1	21.5306713871
302	262	18	0	18	16.5893036135
302	263	1	0	1	21.0122400701
302	264	3	0	3	30.4049523357
302	265	1	0	1	38.9296200607
302	266	5	1	4	37.0360166628
302	268	2	0	2	40.4986019786
302	270	1	0	1	36.2835684038
302	271	2	0	2	29.6797481755
302	272	17	0	17	19.2331324518
302	273	6	0	6	12.6766987673
302	274	6	1	5	19.5134013114
302	275	5	0	5	29.6171797388
302	276	83	2	81	6.34742522191
302	277	414	93	321	21.9314611395
302	278	1	0	1	34.2213354159
302	279	3	0	3	26.7919593052
302	281	17	0	17	14.2502952766
302	282	46	0	46	10.8671613316
302	284	38	7	31	11.9462572184
302	285	4	2	2	23.3647443837
302	286	19	5	14	8.56317144789
302	287	1	0	1	16.3580844108
302	290	1	0	1	30.0652475341
302	291	4	2	2	18.8496870965
302	292	21	6	15	14.0655719734
302	293	383	95	288	7.69351087952
302	294	35	0	35	16.3713858149
302	295	30	1	29	7.93279894842
302	296	44	25	19	9.13831168467
302	297	9	7	2	17.4190090163
302	298	10	1	9	14.151326496
302	299	15	14	1	5.4271991289
302	300	4	1	3	11.2314394267
302	301	10	2	8	10.824094714
302	304	1	0	1	50.5277535144
302	305	4	0	4	31.0766404072
302	307	2	0	2	41.7915249101
302	319	1	0	1	71.3191483388
302	333	1	0	1	54.6667738789
302	338	1	0	1	50.3758314036
302	345	3	0	3	36.7437491069
302	349	1	1	0	54.2803130219
302	375	1	0	1	36.5691608878
302	471	1	1	0	110.1480566
302	475	1	0	1	104.138755185
303	0	67	1	66	16.8301474658
303	1	4304	221	4083	9.91685778428
303	2	6	2	4	21.8545389494
303	3	20	5	15	20.0405401771
303	4	4	0	4	18.8431092814
303	5	27	0	27	19.5831434679
303	6	10	0	10	28.9306450911
303	7	63	0	63	17.408261719
303	8	1	0	1	27.2442099249
303	9	28	1	27	14.0723986046
303	10	1	0	1	20.7956019598
303	11	3	1	2	23.072645087
303	12	17	5	12	17.1777429034
303	13	41	3	38	20.4052736333
303	14	1	0	1	22.9484638635
303	15	80	0	80	17.9377837677
303	16	1	0	1	17.5228883005
303	17	12	0	12	25.6422270651
303	18	6	2	4	21.8336637863
303	19	13	8	5	16.2068022507
303	20	6	2	4	24.1483479348
303	21	44	1	43	19.0894149886
303	22	22	14	8	13.0502006769
303	23	27	2	25	19.7982368166
303	24	35	3	32	20.412664689
303	26	4	0	4	31.281699161
303	27	2	1	1	30.2985858621
303	28	966	212	754	6.86366284687
303	29	6	5	1	33.6303307884
303	30	1	0	1	33.4860038596
303	31	2	0	2	34.7687997424
303	32	88	2	86	17.3796699426
303	33	33	0	33	26.0793097997
303	34	4	0	4	40.289742517
303	35	7	0	7	27.9038387557
303	36	107	0	107	29.0012042148
303	38	1	0	1	35.8351266377
303	39	73	0	73	21.2407979105
303	40	1	0	1	22.2942389393
303	41	8	0	8	29.7568009467
303	42	29	0	29	23.8784709454
303	46	8	0	8	41.5354444977
303	47	2	0	2	61.7857707791
303	48	5	0	5	53.1082040266
303	49	1	0	1	36.0352394807
303	50	26	0	26	42.4517713896
303	52	1	0	1	50.6105823702
303	53	5	1	4	42.3273009973
303	54	1	0	1	45.4375046078
303	55	2	1	1	49.252619197
303	56	1	0	1	41.731118421
303	57	1	0	1	60.1590459618
303	58	1	0	1	46.1159503391
303	59	1	0	1	63.94947732
303	60	4	0	4	46.4045633419
303	65	6	4	2	49.8137068462
303	68	4	0	4	47.9271873455
303	69	1	0	1	57.0358442814
303	70	9	1	8	47.1818340797
303	71	5	0	5	51.1247616838
303	72	1	0	1	43.2335820246
303	73	155	15	140	43.240369925
303	74	21	0	21	47.8855929345
303	75	31	0	31	44.2541477818
303	76	8	3	5	49.0605384272
303	78	18	4	14	48.7791506503
303	79	2	0	2	41.5834509727
303	80	0	0	0	43.6687573936
303	81	8	2	6	44.4766108738
303	82	9	0	9	47.5779769475
303	83	4	0	4	45.2347432081
303	84	19	0	19	44.6212251956
303	85	16	0	16	52.1188705296
303	86	2	0	2	52.6995693659
303	87	10	1	9	46.9651519374
303	88	3	0	3	48.9884796049
303	89	4	1	3	38.3222472579
303	90	1	0	1	55.9416125846
303	92	7	0	7	44.3031134728
303	95	9	1	8	35.5433266492
303	96	4	0	4	58.4216896902
303	99	2	0	2	41.3476623546
303	100	2	0	2	28.8182464561
303	101	1	0	1	43.9806140622
303	102	3	0	3	26.961937841
303	103	22	1	21	41.4726475712
303	104	3	0	3	32.7949204052
303	105	0	0	0	33.4142647343
303	106	1	0	1	32.3823633818
303	107	1	0	1	57.3475853737
303	109	2	0	2	51.6272427586
303	110	3	0	3	41.134636376
303	112	36	2	34	38.3527924517
303	113	27	2	25	45.8082291434
303	116	4	1	3	51.199508796
303	118	5	1	4	54.3527140108
303	120	7	1	6	38.3913128657
303	122	0	0	0	49.0068972685
303	125	1	0	1	47.0405543512
303	131	2	0	2	64.5442397922
303	133	2	0	2	42.7576826245
303	134	2	0	2	47.5996764985
303	138	1	0	1	40.1068288901
303	140	5	0	5	46.5191126102
303	142	33	0	33	52.6525165783
303	144	1	1	0	57.4823224072
303	146	1	0	1	51.9371410458
303	154	1	0	1	64.5900630991
303	163	1	0	1	72.8336497897
303	168	1	0	1	62.4491761108
303	169	1	0	1	62.5264234909
303	171	2	0	2	61.4147336138
303	172	1	0	1	64.6595301954
303	177	2	0	2	68.646241711
303	183	13	1	12	70.9203222378
303	188	1	0	1	77.9623004654
303	190	2	0	2	64.8804193169
303	192	0	0	0	98.5658030984
303	194	1	1	0	89.6645188409
303	195	1	0	1	106.934605187
303	199	1	0	1	95.9349530387
303	201	1	0	1	111.639268462
303	207	1	0	1	77.8720490157
303	208	4	0	4	84.4368585248
303	212	4	1	3	71.3158851034
303	213	2	0	2	87.6908986364
303	214	1	0	1	79.4363495352
303	220	0	0	0	91.2565583188
303	225	1	0	1	80.7522981797
303	229	5	0	5	84.5146410402
303	232	1	0	1	73.6546850124
303	234	1	0	1	73.1728318743
303	237	1	0	1	71.4283147611
303	241	1	0	1	116.322925332
303	242	0	0	0	109.393823243
303	245	7	0	7	36.0481302673
303	247	1	1	0	57.3672664666
303	248	2	0	2	44.1617413533
303	251	3	0	3	49.9824277409
303	252	1	0	1	43.5902406154
303	253	3	2	1	52.1895244747
303	254	4	0	4	41.6886309967
303	255	1	0	1	29.8560183327
303	256	4	0	4	26.7776909526
303	257	18	0	18	26.8766344144
303	258	23	2	21	20.4097811141
303	259	1	0	1	33.7616766225
303	260	2	0	2	29.9284962887
303	261	23	10	13	18.5183680488
303	262	3	0	3	38.2829693627
303	264	11	0	11	24.748637942
303	266	3	2	1	47.2707472561
303	268	1	0	1	54.9584445556
303	270	6	1	5	30.2586223803
303	271	4	0	4	58.345911587
303	272	4	1	3	57.9547054784
303	274	2	1	1	37.592154314
303	275	6	1	5	38.6351811476
303	276	2	0	2	52.5382247527
303	277	161	27	134	40.6229690935
303	279	4	0	4	31.091091774
303	281	2	0	2	41.6999768163
303	282	6	0	6	46.2690497539
303	283	9	0	9	21.6079634764
303	284	1	0	1	54.569646842
303	285	1	0	1	52.1656805548
303	286	1	0	1	46.3099387344
303	287	1	0	1	50.5239220044
303	289	1	0	1	26.4040677519
303	290	2	0	2	49.319928242
303	291	1	0	1	63.6862737394
303	292	1	0	1	62.3708229093
303	293	5	0	5	61.6624475765
303	294	0	0	0	71.0171320586
303	304	228	23	205	11.1553252423
303	305	81	70	11	24.4939698284
303	306	135	35	100	8.43591959685
303	307	1385	100	1285	13.0680457922
303	308	63	48	15	15.0028117165
303	309	229	53	176	13.3334621702
303	338	0	0	0	90.7801673322
303	396	1	0	1	109.233596989
303	411	1	0	1	116.171682602
303	415	1	0	1	108.562698985
303	464	3	0	3	72.8494129753
303	466	7	0	7	93.5087406002
303	469	1	0	1	82.8207430266
303	471	3	0	3	72.3744253194
303	472	3	0	3	72.0872099136
303	474	1	0	1	96.1698895879
303	475	2	1	1	83.6315339638
303	476	1	0	1	62.2147487755
303	484	1	0	1	74.3781079211
303	487	1	0	1	80.9060350551
303	493	1	0	1	105.84409831
303	495	0	0	0	100.121615729
303	573	0	0	0	98.7365296955
304	0	41	15	26	6.95819909202
304	1	1619	531	1088	12.3446352587
304	2	2	0	2	15.722109342
304	3	12	0	12	9.12045475102
304	4	2	0	2	14.1623158864
304	5	6	0	6	22.2755619694
304	6	2	0	2	30.6775793105
304	7	38	16	22	9.84518829569
304	8	2	0	2	34.6204322299
304	9	40	1	39	3.72571141487
304	10	2	0	2	13.3453969569
304	11	3	0	3	29.4892982693
304	12	3	1	2	22.255050332
304	13	21	7	14	11.3251753057
304	14	1	0	1	14.7788577731
304	15	28	4	24	11.9486979532
304	16	2	0	2	6.40478457534
304	17	3	0	3	21.2029378124
304	18	5	1	4	11.4982817966
304	19	6	3	3	5.30305836924
304	20	2	0	2	22.9664797851
304	21	11	2	9	19.1722519795
304	22	7	2	5	19.8572443638
304	23	13	2	11	17.6039109208
304	24	4	0	4	16.7473081674
304	26	3	0	3	27.6629073193
304	28	273	204	69	7.74079422065
304	29	1	0	1	33.0076752503
304	30	1	0	1	26.0513358702
304	31	1	0	1	24.7458111565
304	32	60	28	32	7.73916783882
304	33	12	3	9	16.994355406
304	35	3	0	3	20.1745967558
304	36	54	3	51	18.1432953143
304	37	1	0	1	25.952613625
304	39	61	0	61	10.2795697325
304	40	1	0	1	12.6049159506
304	41	1	0	1	20.1108388776
304	42	11	0	11	12.7381084141
304	43	1	0	1	58.6535786462
304	46	2	0	2	40.905044746
304	48	5	0	5	48.3454742362
304	50	6	1	5	37.3871634856
304	53	2	0	2	45.4432369608
304	59	0	0	0	60.6000567091
304	60	1	0	1	41.4330010892
304	64	1	0	1	39.7188207445
304	65	4	0	4	48.9918642583
304	68	1	0	1	41.5892872871
304	69	1	0	1	50.5905190382
304	70	8	4	4	36.5819221
304	71	2	0	2	40.0161746698
304	73	52	0	52	32.2198288214
304	74	5	1	4	36.848777501
304	75	1	0	1	33.1517250195
304	78	5	0	5	37.8034617723
304	79	4	1	3	30.7859047647
304	81	3	0	3	33.7181221979
304	83	3	1	2	34.2539153569
304	84	9	1	8	33.5800344095
304	85	1	0	1	41.2257289849
304	86	3	0	3	41.6296223239
304	87	2	0	2	35.8413673805
304	89	1	0	1	28.3817057884
304	92	2	0	2	34.1208908105
304	95	1	0	1	24.4415784235
304	96	1	0	1	48.1503315325
304	102	4	1	3	16.4157836436
304	103	10	3	7	30.3173758173
304	105	1	0	1	23.1907239638
304	106	1	0	1	23.0818352632
304	110	1	0	1	30.0602460676
304	111	1	0	1	33.5471566798
304	112	6	2	4	27.197964253
304	113	21	0	21	34.6602319714
304	114	2	0	2	23.0498427414
304	120	1	0	1	27.6391322719
304	122	1	0	1	39.3650964592
304	129	3	0	3	27.2887494262
304	133	0	0	0	32.576511038
304	141	1	0	1	70.1414454772
304	142	11	2	9	42.1849231479
304	183	0	0	0	75.5054773466
304	188	1	0	1	80.8440698041
304	208	1	0	1	82.2128320305
304	211	0	0	0	89.419535938
304	214	1	0	1	76.4650406727
304	220	1	0	1	95.374128768
304	229	1	0	1	84.6364256902
304	245	4	1	3	28.3767930985
304	251	1	0	1	42.0145876865
304	253	2	0	2	46.8993175169
304	256	1	0	1	17.4821846778
304	257	10	1	9	20.1947024382
304	258	12	4	8	13.8310893045
304	259	1	0	1	31.2336453771
304	260	2	0	2	22.0028330742
304	261	4	0	4	15.7533560161
304	262	4	0	4	34.6144981318
304	263	1	0	1	29.5324211763
304	264	9	0	9	20.5116773064
304	266	1	0	1	51.0234977546
304	270	2	0	2	34.0043424322
304	272	1	0	1	57.2944283599
304	275	4	0	4	40.7567699754
304	277	52	0	52	40.613483055
304	281	0	0	0	38.9725862026
304	282	5	1	4	43.5896248545
304	283	1	0	1	24.330974427
304	289	1	0	1	29.2949818648
304	292	1	0	1	60.1342313308
304	293	1	0	1	57.8808384401
304	303	324	128	196	11.1553252423
304	305	25	1	24	23.5865411079
304	306	10	1	9	14.4477805221
304	307	277	46	231	12.8070658307
304	308	4	0	4	19.3146460135
304	309	272	81	191	6.60374326371
304	329	1	0	1	67.8732649128
304	379	0	0	0	98.2528330795
304	464	1	0	1	66.733057774
304	465	0	0	0	83.3628885939
304	471	2	0	2	67.0625455829
304	476	3	0	3	55.5132394044
304	480	1	0	1	71.3757207563
304	483	1	0	1	102.43811087
304	493	0	0	0	100.137762593
304	495	0	0	0	92.5246762248
304	573	1	0	1	87.6580139132
305	0	12	5	7	29.4724270578
305	1	725	310	415	32.9999810672
305	3	3	0	3	28.823197813
305	5	3	0	3	43.4515378024
305	7	23	1	22	33.2533287591
305	9	3	0	3	26.6535967743
305	12	3	2	1	41.6065826862
305	13	12	1	11	33.7624793551
305	15	11	1	10	35.5245533239
305	16	2	0	2	26.1455285386
305	17	4	0	4	44.7864462667
305	18	1	0	1	32.178592265
305	19	3	0	3	26.6592258661
305	21	5	0	5	41.6587926258
305	23	14	0	14	40.8443096599
305	24	4	0	4	40.2601671511
305	27	1	0	1	51.937765976
305	28	55	0	55	28.1191831779
305	30	0	0	0	48.5233141607
305	32	35	4	31	19.7617360378
305	33	3	1	2	38.6584522935
305	34	1	0	1	54.3149707477
305	35	2	0	2	42.7729729614
305	36	41	12	29	35.4426354532
305	38	1	0	1	47.6744376826
305	39	29	3	26	24.6202502261
305	41	4	0	4	40.5653854265
305	42	10	1	9	29.2012830198
305	44	1	0	1	73.7516244364
305	46	2	0	2	64.0837301669
305	47	2	0	2	82.1787953386
305	48	8	0	8	71.6613157071
305	50	4	0	4	60.7182335947
305	53	2	0	2	66.6370959458
305	55	1	0	1	69.8929855144
305	59	3	0	3	84.1517596117
305	62	1	0	1	81.3348751845
305	68	2	0	2	64.2908895
305	70	22	0	22	39.2367744173
305	71	3	0	3	47.4674538149
305	72	1	0	1	36.1488920924
305	73	292	0	292	39.4268751494
305	74	22	4	18	43.506293752
305	75	17	8	9	41.4769158994
305	76	16	8	8	41.8755533706
305	78	15	0	15	43.5418851552
305	79	2	0	2	36.0378287462
305	80	1	0	1	37.6821123954
305	81	17	0	17	38.0674987753
305	82	14	3	11	41.4436509004
305	83	11	0	11	40.6138671889
305	84	38	0	38	40.8226891843
305	85	7	1	6	45.6079882047
305	86	5	1	4	48.1498987153
305	87	3	0	3	44.2255210378
305	88	2	0	2	46.0822486341
305	89	10	0	10	29.0028789964
305	90	3	0	3	46.8928255197
305	92	8	3	5	34.6468027312
305	95	11	1	10	34.5697194722
305	96	1	0	1	47.1813648276
305	98	2	0	2	52.0873540433
305	100	1	0	1	30.0765444809
305	102	6	0	6	24.809228128
305	103	19	0	19	41.1092255013
305	104	3	0	3	30.0041117653
305	106	1	0	1	22.7371943418
305	107	0	0	0	55.2346777724
305	110	3	0	3	43.2734448734
305	111	1	0	1	30.645274443
305	112	13	0	13	38.8236638066
305	113	25	0	25	45.5612740469
305	115	1	0	1	32.1161341229
305	120	4	0	4	33.2606085714
305	122	0	0	0	36.2572870398
305	123	1	0	1	25.6544695195
305	129	1	0	1	44.4602609711
305	131	1	0	1	78.4344334003
305	134	1	0	1	52.9807268431
305	140	1	0	1	49.251066492
305	142	13	2	11	58.1085246307
305	145	1	0	1	56.5607162196
305	147	1	0	1	76.4274625286
305	155	1	0	1	56.1867718898
305	168	1	0	1	58.9162980108
305	177	2	0	2	64.9317703886
305	183	25	1	24	53.8231411714
305	184	4	0	4	46.8186471292
305	185	1	0	1	60.9219042648
305	186	1	0	1	51.0469484308
305	187	1	0	1	60.7566337832
305	188	2	0	2	57.7606147512
305	190	1	0	1	51.3796774525
305	191	1	0	1	77.7089060271
305	192	1	0	1	76.1644098748
305	202	1	0	1	75.4784717169
305	204	1	0	1	47.4416763428
305	207	3	0	3	53.5438405389
305	208	10	0	10	59.9804930507
305	209	3	0	3	55.8995986752
305	211	1	0	1	66.8569408221
305	212	7	1	6	46.9044840998
305	213	2	0	2	63.4495945095
305	220	8	0	8	72.9879982115
305	222	0	0	0	65.7340036801
305	224	1	0	1	53.4696804832
305	229	0	0	0	61.147432829
305	230	1	0	1	68.2685216225
305	232	0	0	0	49.9790284271
305	233	1	0	1	48.1640737402
305	236	3	0	3	43.4316205699
305	238	1	0	1	49.3626247088
305	239	1	0	1	55.0072414505
305	242	0	0	0	89.3210712593
305	243	2	0	2	83.3743715111
305	245	61	11	50	20.1982439909
305	247	6	2	4	37.3275584765
305	248	2	0	2	25.5241547881
305	249	2	0	2	27.4366371305
305	250	8	2	6	16.408287112
305	251	5	0	5	32.0870654216
305	252	1	0	1	21.1393542001
305	253	4	1	3	29.4170761098
305	254	7	0	7	21.3383928557
305	255	53	34	19	8.65695854916
305	256	19	2	17	20.0809799603
305	257	250	0	250	13.1302200385
305	258	77	12	65	13.0776236138
305	259	29	6	23	9.55433155838
305	260	10	2	8	17.3731353959
305	261	94	9	85	7.94730167747
305	262	81	34	47	14.6732692761
305	263	14	0	14	12.7513342409
305	264	517	198	319	7.29353639606
305	265	9	1	8	21.3546271807
305	266	10	0	10	29.2589099453
305	268	5	0	5	36.8736861783
305	270	70	2	68	14.306315191
305	271	2	0	2	36.2636711937
305	272	14	1	13	33.9778540759
305	273	5	1	4	24.869952834
305	274	55	0	55	13.1113935041
305	275	29	14	15	17.9935282271
305	276	7	1	6	28.1603303426
305	277	1622	109	1513	17.0353251363
305	279	283	7	276	7.37400095954
305	280	4	1	3	23.4820652455
305	281	22	0	22	17.33734772
305	282	35	7	28	21.8374435376
305	283	50	42	8	7.75083902533
305	284	15	0	15	30.106672267
305	285	7	0	7	29.1376868242
305	286	10	0	10	22.5512381746
305	287	10	0	10	26.3663652739
305	288	2	0	2	24.9263537483
305	289	48	26	22	9.66539409334
305	290	1	0	1	28.3217689183
305	292	3	0	3	37.8868177332
305	293	12	0	12	37.4585093289
305	294	4	1	3	47.4399262067
305	295	4	0	4	32.9078827734
305	296	0	0	0	37.8614559845
305	297	1	0	1	47.8632368677
305	303	180	61	119	24.4939698284
305	304	24	6	18	23.5865411079
305	306	46	1	45	16.9622479041
305	307	946	0	946	11.7532879305
305	308	35	9	26	11.9718230113
305	309	119	9	110	17.2029665805
305	310	0	0	0	54.3480276474
305	321	1	0	1	76.1089043011
305	345	3	0	3	65.0957152196
305	349	1	0	1	72.4746536023
305	375	3	0	3	67.5730400795
305	464	3	0	3	89.2095463616
305	466	0	0	0	108.472644273
305	469	1	0	1	96.277940121
305	471	3	0	3	90.0131669848
305	472	1	0	1	86.4287651677
305	475	1	0	1	93.2728105773
305	482	1	0	1	116.691057869
305	488	2	0	2	104.747255967
305	491	1	0	1	101.402928282
305	494	1	0	1	96.6435960047
305	505	1	0	1	121.104844211
305	583	0	0	0	125.11734404
305	585	1	0	1	106.622482126
306	0	10	1	9	21.3474444793
306	1	1023	0	1023	18.2059767796
306	2	2	0	2	28.6313652457
306	3	4	0	4	23.2910757982
306	5	7	0	7	28.0136229179
306	6	3	1	2	37.361758855
306	7	4	1	3	23.3553825127
306	9	2	0	2	18.141245488
306	10	1	0	1	26.9390473915
306	12	10	2	8	25.4096105825
306	13	10	0	10	25.583631714
306	15	15	1	14	24.6127868779
306	16	3	1	2	20.3312476504
306	17	2	0	2	33.128278409
306	18	1	1	0	25.9245631352
306	19	5	1	4	19.6328925556
306	20	1	0	1	32.3551898748
306	21	5	3	2	27.385358716
306	22	4	2	2	21.0386036856
306	23	11	0	11	27.7234421026
306	24	5	0	5	27.9879313901
306	26	2	0	2	39.0930425877
306	27	1	0	1	38.4950536927
306	28	138	19	119	14.2563043934
306	30	3	1	2	39.8662465317
306	31	1	0	1	39.1668150856
306	32	43	1	42	17.2415033013
306	33	2	0	2	31.3317594239
306	35	5	1	4	34.0549560214
306	36	32	1	31	32.1594048442
306	39	36	11	25	22.3842564121
306	41	2	0	2	34.5547122054
306	42	7	2	5	26.1654795007
306	43	1	0	1	68.2534521199
306	46	2	0	2	49.9194716882
306	47	1	0	1	69.8743646202
306	48	1	0	1	60.7541872984
306	50	2	0	2	49.9398165521
306	53	6	0	6	50.5803346661
306	57	1	0	1	67.5870272532
306	60	2	0	2	53.9491991526
306	61	1	0	1	62.4399713373
306	65	2	1	1	58.2008942203
306	68	3	0	3	54.9524409481
306	70	4	0	4	46.1845043263
306	72	1	0	1	42.384757762
306	73	36	0	36	43.520161933
306	74	2	0	2	48.1388005857
306	75	2	0	2	44.9310912855
306	76	4	1	3	48.3860846818
306	78	5	1	4	48.7660861819
306	79	2	0	2	41.1943062906
306	80	1	0	1	43.2161140637
306	81	3	0	3	43.9102912022
306	82	3	0	3	47.2175763175
306	83	7	1	6	45.3131453322
306	84	5	1	4	44.9600430981
306	86	1	0	1	53.0352340853
306	87	4	0	4	47.7511365846
306	88	1	0	1	49.7816547663
306	89	8	0	8	36.4714049192
306	90	1	0	1	54.8068570783
306	92	1	0	1	42.6120786785
306	95	2	0	2	36.4368505339
306	96	1	0	1	56.5739803388
306	99	2	0	2	44.5046012373
306	102	2	0	2	26.7177347833
306	103	8	0	8	42.8732886547
306	104	1	0	1	32.8608420474
306	105	2	1	1	32.2168984388
306	106	1	0	1	30.01842561
306	107	1	0	1	58.6247677023
306	109	1	0	1	49.9502580976
306	112	6	0	6	39.9046452264
306	113	17	2	15	47.4105664539
306	114	1	0	1	36.5790565748
306	115	1	0	1	43.6227693409
306	117	1	0	1	49.3164484898
306	118	2	0	2	53.7364375343
306	122	0	0	0	46.4039955446
306	131	1	0	1	71.0301272938
306	137	0	0	0	59.8556124081
306	140	1	0	1	49.1605225274
306	141	1	0	1	84.5257779686
306	142	10	0	10	56.3593330956
306	164	1	0	1	59.9733385275
306	166	1	0	1	71.9280275377
306	183	5	0	5	62.8644397253
306	187	0	0	0	73.7860719445
306	188	1	0	1	69.5977238509
306	207	1	0	1	69.8194176848
306	208	5	1	4	76.5224677882
306	212	1	0	1	63.3515670186
306	220	1	0	1	83.1137446765
306	224	1	0	1	69.0695769302
306	229	1	0	1	76.1517191039
306	236	2	0	2	58.2626704883
306	242	1	0	1	101.075103529
306	243	1	0	1	94.9830206191
306	245	11	1	10	31.868609384
306	251	1	0	1	45.5720519391
306	255	1	0	1	23.5975555112
306	256	1	0	1	24.843809267
306	257	19	7	12	22.5503624083
306	258	15	0	15	16.9163680684
306	259	0	0	0	26.484477973
306	260	1	0	1	26.3591351152
306	261	21	0	21	12.7069896877
306	262	4	0	4	31.3833039951
306	264	13	0	13	18.943980015
306	266	1	0	1	38.9724736522
306	267	1	0	1	34.3312082287
306	268	1	0	1	46.7045739116
306	270	9	1	8	21.8849203646
306	271	1	0	1	49.9166495638
306	272	2	0	2	49.7682323136
306	274	2	0	2	29.8568249923
306	275	7	3	4	30.2011620122
306	276	1	0	1	45.1074076961
306	277	148	14	134	32.4166533285
306	279	1	0	1	23.0498115399
306	280	0	0	0	37.2463152658
306	281	3	1	2	34.2967463837
306	282	2	0	2	38.7670232232
306	283	8	1	7	13.2044399746
306	284	1	1	0	46.7183103685
306	287	2	0	2	42.4348769501
306	289	4	1	3	17.9685151846
306	292	1	0	1	54.5574191075
306	293	2	0	2	54.4200102423
306	295	1	0	1	49.8088915853
306	297	1	0	1	64.8237464707
306	302	1	0	1	47.9354655067
306	303	588	262	326	8.43591959685
306	304	34	3	31	14.4477805221
306	305	72	0	72	16.9622479041
306	307	1330	498	832	7.24167087061
306	308	162	0	162	6.56689476316
306	309	171	0	171	12.3161916108
306	345	1	0	1	81.8577069793
306	465	0	0	0	97.4022391734
306	466	1	0	1	100.443064317
306	469	1	0	1	89.3059498521
306	471	1	0	1	79.8962134305
306	472	1	0	1	78.7536196841
306	475	1	0	1	89.0265704784
306	476	1	0	1	69.1266717721
306	487	1	0	1	88.8580698086
306	503	1	0	1	107.05414234
306	555	0	0	0	123.488905358
307	0	41	6	35	19.463405469
307	1	2754	75	2679	21.2472831524
307	2	5	0	5	28.480435101
307	3	27	2	25	20.0791362724
307	4	1	0	1	26.6056405246
307	5	32	0	32	31.7017579408
307	6	5	0	5	40.8897750083
307	7	48	4	44	22.6469851859
307	9	17	0	17	16.3289559385
307	10	1	0	1	26.1500798923
307	11	1	0	1	36.1338495104
307	12	9	0	9	29.980230542
307	13	57	15	42	23.8967870606
307	14	1	0	1	27.4906616102
307	15	61	14	47	24.6084476119
307	16	3	0	3	17.0926519142
307	17	6	0	6	33.7667442937
307	18	6	0	6	23.1997060001
307	19	15	1	14	17.0155698818
307	20	5	2	3	34.4988335774
307	21	19	4	15	29.9727643493
307	22	6	1	5	26.0729926022
307	23	29	2	27	29.3661605534
307	24	18	1	17	28.9957529293
307	25	1	0	1	42.6878153794
307	26	1	0	1	40.1275385166
307	27	1	0	1	40.458119598
307	28	292	37	255	16.3921438472
307	29	1	0	1	44.495158694
307	30	2	0	2	38.7555744153
307	31	3	0	3	36.0430080004
307	32	274	0	274	12.1421135409
307	33	13	0	13	29.3390573874
307	34	1	0	1	45.0218835929
307	35	8	3	5	32.8854048903
307	36	141	27	114	28.267056835
307	37	0	0	0	38.7549312104
307	39	191	12	179	17.6159776926
307	40	6	0	6	15.2552187562
307	41	10	1	9	31.9686471206
307	42	50	0	50	21.9408846967
307	43	3	0	3	70.5917599785
307	46	8	1	7	52.485301649
307	47	1	0	1	71.1484714278
307	48	10	0	10	61.1155874352
307	49	3	0	3	44.010163176
307	50	11	1	10	50.1619287541
307	53	3	0	3	54.9226945196
307	55	5	0	5	58.7438883314
307	56	1	0	1	51.5700782533
307	58	1	0	1	57.7375472147
307	59	2	0	2	73.1826426721
307	60	3	0	3	54.208806785
307	61	1	0	1	64.744878218
307	62	1	0	1	69.6221500737
307	65	7	1	6	60.7155746794
307	68	1	0	1	54.3701991752
307	70	25	1	24	39.5141483769
307	71	7	0	7	45.7021834161
307	72	1	0	1	35.8067703302
307	73	396	101	295	37.4373057551
307	74	21	0	21	41.9848018464
307	75	55	2	53	39.0337760071
307	76	1	0	1	41.821116449
307	77	3	0	3	35.22107576
307	78	29	0	29	42.4799381199
307	79	4	1	3	34.8253626604
307	80	2	0	2	36.7937848779
307	81	34	5	29	37.4315600353
307	82	22	10	12	40.7925103562
307	83	27	4	23	39.1079168258
307	84	57	9	48	38.8870129972
307	85	6	1	5	45.3039329135
307	86	6	0	6	46.8720837607
307	87	17	2	15	41.873501365
307	88	11	3	8	43.8829110788
307	89	13	3	10	29.5965233577
307	90	4	1	3	48.03322757
307	92	11	2	9	35.7345630698
307	95	24	7	17	30.824250645
307	96	4	1	3	49.585220874
307	99	4	0	4	40.2148087351
307	102	18	0	18	20.7732225434
307	103	34	3	31	37.4225236881
307	104	5	0	5	26.8764485619
307	105	2	1	1	25.642051346
307	106	3	0	3	23.0600513716
307	109	2	0	2	43.0334191367
307	110	10	4	6	38.4745519292
307	111	5	2	3	33.2190207425
307	112	42	14	28	34.6090300038
307	113	74	2	72	42.004792828
307	114	4	0	4	31.9991663549
307	115	1	0	1	36.3997104614
307	116	5	1	4	43.5967721118
307	119	2	0	2	50.2982244808
307	120	6	2	4	31.6619502681
307	122	1	0	1	39.2830259382
307	124	1	0	1	56.333396947
307	129	2	0	2	37.6982327277
307	131	4	0	4	69.5320132708
307	134	1	0	1	47.0598301956
307	140	4	0	4	44.4057528675
307	142	68	12	56	52.2887325592
307	144	1	0	1	55.7639155229
307	145	1	0	1	49.2105507891
307	146	2	1	1	48.0009139628
307	147	1	0	1	70.3142210954
307	148	1	0	1	46.958609648
307	151	2	0	2	62.8898168456
307	153	1	0	1	67.5186571538
307	154	1	0	1	63.0916021706
307	156	1	0	1	55.3403338459
307	163	1	0	1	71.6327119447
307	164	0	0	0	53.8024895995
307	169	1	0	1	53.1003730147
307	171	1	0	1	54.6675775885
307	172	1	0	1	60.389541727
307	175	1	0	1	59.0917691176
307	177	0	0	0	63.5989920234
307	182	3	0	3	69.1009842339
307	183	19	0	19	62.7335381376
307	184	1	0	1	55.2858221757
307	185	1	0	1	70.6185479786
307	186	2	0	2	61.4878649368
307	187	1	0	1	71.6416290085
307	188	2	0	2	68.1069186617
307	190	1	1	0	58.5379981158
307	191	1	0	1	88.560490482
307	196	3	0	3	93.5249237694
307	201	1	0	1	99.4473295076
307	206	1	0	1	63.1145364
307	208	12	1	11	71.6788505564
307	209	1	0	1	67.6519874939
307	212	3	2	1	58.6346163531
307	213	1	0	1	75.2028552234
307	214	2	0	2	66.4976433674
307	220	8	0	8	82.5675990063
307	222	1	0	1	74.661015729
307	223	0	0	0	74.3143545741
307	225	4	0	4	68.7078943485
307	229	3	0	3	72.7264466876
307	232	1	0	1	61.6331232532
307	233	1	0	1	59.8885937533
307	234	1	1	0	61.6482435636
307	236	3	0	3	54.9270457877
307	239	2	1	1	66.4704195847
307	242	2	0	2	99.7263409501
307	244	1	0	1	101.678639503
307	245	50	2	48	24.6274409006
307	247	1	0	1	45.1611563512
307	249	1	0	1	36.0516406245
307	250	1	0	1	24.8532740607
307	251	6	0	6	38.355653122
307	252	3	0	3	30.6657415825
307	253	2	0	2	39.2553419574
307	254	1	1	0	29.1786807266
307	255	7	0	7	16.8988243677
307	256	16	0	16	18.1385330529
307	257	183	9	174	15.309454268
307	258	152	7	145	9.89365780543
307	259	3	1	2	20.7508468024
307	260	12	1	11	19.1675729134
307	261	149	18	131	5.63700544726
307	262	22	6	16	25.2158947451
307	263	4	0	4	21.4042221932
307	264	116	1	115	11.9599635868
307	265	2	0	2	28.3031235857
307	266	9	1	8	38.2212299513
307	267	1	0	1	33.8934872176
307	268	1	0	1	46.033767574
307	270	20	4	16	21.2590672317
307	271	7	0	7	47.2930657796
307	272	9	0	9	45.6890022159
307	273	0	0	0	36.587021681
307	274	9	0	9	24.8230658856
307	275	14	0	14	28.0366074981
307	276	3	0	3	39.5298762005
307	277	692	98	594	28.5644105937
307	278	1	1	0	45.978225625
307	279	20	7	13	18.8427656101
307	280	2	0	2	34.4338007719
307	281	7	2	5	28.704584722
307	282	24	0	24	33.3013931255
307	283	14	3	11	11.561985094
307	284	13	0	13	41.8144619075
307	285	2	0	2	40.5177500997
307	286	1	0	1	33.2441277487
307	287	2	0	2	38.1056039331
307	288	1	0	1	34.8266275607
307	289	14	0	14	16.4965028075
307	290	1	0	1	38.7753139623
307	291	1	0	1	51.1489088597
307	292	2	0	2	49.5585141995
307	293	12	1	11	48.6041759034
307	294	3	0	3	57.9870462528
307	295	1	0	1	44.3833395085
307	297	1	0	1	58.957587124
307	302	1	0	1	41.7915249101
307	303	1061	28	1033	13.0680457922
307	304	139	3	136	12.8070658307
307	305	562	72	490	11.7532879305
307	306	276	203	73	7.24167087061
307	308	203	39	164	7.67813542803
307	309	1165	304	861	7.64414910009
307	319	1	0	1	85.835787855
307	329	1	0	1	69.4578400905
307	332	1	0	1	84.8684271734
307	345	1	0	1	76.6778714969
307	371	1	0	1	78.2335708316
307	381	1	0	1	120.162684756
307	392	0	0	0	102.567672745
307	408	1	0	1	119.665898822
307	409	1	0	1	118.212668796
307	411	0	0	0	117.697164658
307	414	1	0	1	120.333521291
307	416	2	0	2	124.757309101
307	464	2	0	2	79.4991126466
307	465	0	0	0	95.7772116018
307	466	1	0	1	99.3648231053
307	469	1	0	1	87.6755986277
307	471	4	0	4	79.869611412
307	472	2	0	2	77.4265437317
307	473	1	0	1	83.0016928252
307	475	1	0	1	86.1673055442
307	480	1	0	1	84.0620785209
307	488	3	0	3	94.4963044171
307	491	1	0	1	91.7547603352
307	494	1	0	1	88.6203882373
307	503	2	0	2	104.540850903
307	505	1	0	1	111.827382644
307	507	1	0	1	204.230701005
307	573	0	0	0	94.9732833197
308	0	19	2	17	26.24370771
308	1	765	119	646	24.7282106171
308	2	1	0	1	34.4215334294
308	3	7	0	7	27.4034397283
308	4	1	0	1	32.0701528503
308	5	8	2	6	34.5779247848
308	6	1	0	1	43.9259874575
308	7	7	5	2	28.8605808507
308	9	2	1	1	23.0189702245
308	11	1	0	1	36.96099667
308	12	7	0	7	31.8904408623
308	13	12	0	12	30.6383474355
308	14	1	0	1	34.057198065
308	15	23	0	23	30.423824032
308	17	1	0	1	39.2262493561
308	18	3	0	3	30.3811667169
308	19	5	0	5	24.0791899023
308	20	1	0	1	38.8131205844
308	21	1	0	1	33.8921163426
308	22	1	0	1	27.44163466
308	23	10	0	10	34.0648466516
308	24	5	0	5	34.1676062036
308	28	103	27	76	20.5761419763
308	29	1	0	1	48.5123694739
308	32	52	1	51	19.8073519721
308	36	31	8	23	35.8266962071
308	39	28	3	25	25.2733278783
308	40	4	0	4	22.8169131233
308	41	3	0	3	39.1555725464
308	42	11	5	6	29.5401496042
308	46	4	0	4	56.4573712609
308	48	2	0	2	66.8406691808
308	49	1	0	1	49.6495088522
308	50	3	0	3	55.958845679
308	53	1	0	1	57.0405889222
308	54	1	0	1	57.1667899795
308	55	2	0	2	63.7117570523
308	59	1	0	1	78.3367521273
308	60	4	0	4	59.9897850127
308	65	2	0	2	64.7393171523
308	69	1	0	1	69.7358122659
308	70	3	0	3	46.4733009015
308	73	64	0	64	44.856433396
308	74	8	0	8	49.3512164075
308	75	19	1	18	46.5297313778
308	76	2	0	2	48.8807904325
308	78	3	0	3	49.7636681796
308	79	1	0	1	42.0839883059
308	81	2	0	2	44.5910142174
308	82	5	0	5	47.9808893945
308	84	5	1	4	46.3060800144
308	86	2	0	2	54.2191043458
308	87	8	0	8	49.3698375053
308	88	1	0	1	51.3662122468
308	89	3	0	3	36.3523440877
308	92	1	0	1	42.4330357784
308	95	6	0	6	38.4290234904
308	96	3	0	3	55.9875985629
308	100	1	0	1	32.5068745815
308	102	2	0	2	28.3296770098
308	103	6	1	5	45.0472388885
308	104	5	0	5	34.3836698638
308	109	1	0	1	49.6157685683
308	110	3	2	1	46.1516915139
308	111	1	0	1	39.401962026
308	112	6	0	6	42.2615621811
308	113	11	0	11	49.6313685644
308	114	2	0	2	39.665728072
308	116	1	0	1	50.5301813058
308	120	1	0	1	38.9664686732
308	129	1	1	0	45.2638655345
308	134	1	0	1	54.690006969
308	142	9	0	9	59.9184486554
308	147	0	0	0	77.8870958544
308	154	1	0	1	70.769347788
308	156	1	0	1	61.8900973832
308	171	1	0	1	61.7581962251
308	181	1	0	1	48.7347608388
308	183	4	0	4	56.6672455573
308	188	1	0	1	63.0983299402
308	190	1	0	1	51.6751148484
308	191	0	0	0	84.0055192966
308	207	1	1	0	63.6224069214
308	208	0	0	0	70.4484969488
308	214	1	0	1	65.936732568
308	220	1	0	1	76.816490787
308	222	1	0	1	68.5231286139
308	225	2	0	2	66.0186911375
308	227	0	0	0	64.9403005822
308	229	1	0	1	69.6550289594
308	232	0	0	0	58.924477358
308	235	1	0	1	48.3823115031
308	242	1	0	1	94.6123628656
308	243	1	0	1	88.5293153754
308	245	7	1	6	29.8934902101
308	247	1	0	1	48.9078064426
308	251	1	0	1	42.9873175207
308	253	1	0	1	41.3869134201
308	255	3	0	3	19.8802890472
308	257	25	0	25	20.9978715493
308	258	11	3	8	16.8356615626
308	260	2	1	1	25.2452710979
308	261	15	3	12	10.90423393
308	262	6	0	6	26.6377220533
308	264	24	3	21	16.1310567262
308	265	7	0	7	21.9265881563
308	266	2	0	2	32.5598736285
308	268	3	0	3	40.3295401773
308	270	34	1	33	15.4119152081
308	271	1	0	1	43.3571238542
308	272	3	0	3	43.4639541977
308	274	3	0	3	24.1664260913
308	275	6	2	4	23.636932594
308	276	1	0	1	39.6072326019
308	277	293	6	287	26.1324469879
308	279	6	1	5	17.0598247164
308	281	1	0	1	28.9327469583
308	282	3	0	3	33.2431193425
308	283	31	14	17	6.72093922137
308	284	2	0	2	40.7720240878
308	285	1	0	1	37.3320234902
308	287	1	0	1	36.25048538
308	289	9	2	7	11.4024294842
308	293	3	0	3	49.0517262238
308	294	3	0	3	59.3044151586
308	296	1	0	1	49.8322050154
308	297	1	0	1	59.4501905742
308	299	1	0	1	48.3217451211
308	303	322	63	259	15.0028117165
308	304	31	4	27	19.3146460135
308	305	136	23	113	11.9718230113
308	306	231	19	212	6.56689476316
308	307	1219	152	1067	7.67813542803
308	309	145	19	126	15.1686389675
308	345	1	0	1	75.9477607044
308	375	2	0	2	79.3132756704
308	382	1	0	1	143.310176415
308	464	3	0	3	85.8252687612
308	466	0	0	0	105.99596207
308	471	2	0	2	85.872320574
308	475	1	0	1	93.5436168019
308	488	1	0	1	100.360640888
309	0	41	10	31	12.3361622571
309	1	1344	540	804	18.0797431549
309	3	20	5	15	12.4689398112
309	4	1	0	1	20.7074851772
309	5	13	2	11	28.4089410281
309	6	3	0	3	37.0774594645
309	7	7	0	7	16.0557192589
309	9	25	0	25	9.45063436958
309	10	1	0	1	19.3617834751
309	12	4	1	3	27.8118799623
309	13	21	0	21	16.7084926989
309	14	2	0	2	20.4094811592
309	15	23	6	17	18.3952039461
309	16	5	0	5	9.51209597376
309	17	3	0	3	27.6576451953
309	18	10	2	8	15.6556400622
309	19	8	1	7	9.64464134264
309	20	1	0	1	29.5581917231
309	21	14	1	13	25.6384946982
309	22	4	1	3	24.7620541479
309	23	16	7	9	24.2034202206
309	24	3	0	3	23.3285093412
309	25	1	0	1	39.963896071
309	26	3	1	2	34.1486768122
309	28	189	16	173	13.0695795296
309	30	1	0	1	31.5775510143
309	31	2	0	2	28.4008788
309	32	314	99	215	4.92820230888
309	33	8	0	8	21.9332468134
309	34	5	0	5	37.6622284677
309	35	3	1	2	25.7519034939
309	36	108	2	106	20.6608724224
309	37	1	0	1	32.0108021466
309	39	231	66	165	10.2252977966
309	40	7	4	3	9.28225061703
309	41	7	2	5	24.3922667664
309	42	55	4	51	14.3765176324
309	44	1	0	1	57.90204121
309	46	6	0	6	47.508277597
309	48	4	0	4	54.4767949389
309	49	4	0	4	37.5684148816
309	50	5	0	5	43.5270891285
309	52	0	0	0	48.2628660403
309	53	2	1	1	51.7211810391
309	55	1	0	1	52.7723090292
309	57	1	0	1	60.5823657386
309	60	3	0	3	47.560818359
309	65	1	0	1	55.5935602523
309	68	0	0	0	47.303090567
309	70	9	1	8	34.3735247682
309	71	2	0	2	39.4421158094
309	72	1	0	1	30.4869634406
309	73	164	4	160	31.2708124891
309	74	12	0	12	35.9065449606
309	75	18	2	16	32.6314993789
309	76	4	0	4	36.4378239158
309	78	17	3	14	36.5964284171
309	79	10	0	10	29.1088447513
309	80	2	0	2	31.1617979527
309	81	13	4	9	31.9011188754
309	82	12	3	9	35.1469023036
309	83	8	0	8	33.1106054245
309	84	17	0	17	32.7041945752
309	85	3	1	2	39.7072083532
309	86	2	0	2	40.79777402
309	87	12	0	12	35.4462463338
309	88	7	0	7	37.478346691
309	89	4	1	3	25.1280643531
309	90	2	0	2	43.0946637639
309	92	2	0	2	31.1857372397
309	95	10	0	10	24.1207769363
309	96	5	1	4	45.295369269
309	99	2	0	2	32.7325178425
309	100	1	0	1	17.7642200142
309	102	16	0	16	14.4926931245
309	103	21	8	13	30.5754842619
309	104	2	0	2	20.6108238343
309	105	2	0	2	20.4292177264
309	106	2	1	1	19.0630075755
309	107	2	0	2	46.3087640888
309	110	3	1	2	31.2566565916
309	111	1	0	1	29.6756498551
309	112	23	5	18	27.633921998
309	113	33	1	32	35.1249771278
309	114	3	0	3	24.6009690628
309	115	0	0	0	33.7384326467
309	116	1	0	1	38.4425607413
309	120	3	1	2	25.8919341788
309	122	1	0	1	35.6966187999
309	124	1	0	1	48.7619068569
309	131	1	0	1	62.0942732209
309	133	1	0	1	35.7820280924
309	138	0	0	0	34.4257197506
309	142	28	11	17	44.7633233418
309	144	1	0	1	48.4555138098
309	146	1	0	1	41.2088030515
309	151	0	0	0	55.3927371215
309	152	1	0	1	53.6595031291
309	163	0	0	0	64.2794596699
309	164	3	0	3	47.7294840994
309	168	1	0	1	51.0454578533
309	175	2	0	2	53.2516721523
309	177	3	0	3	57.2836992215
309	179	0	0	0	51.6153017319
309	183	7	0	7	69.991274512
309	184	1	0	1	62.6386484743
309	187	0	0	0	77.9474729922
309	190	0	0	0	66.1049630547
309	208	5	0	5	75.625945895
309	209	1	0	1	72.0934679082
309	214	2	0	2	69.9258980933
309	220	3	0	3	89.631771399
309	225	3	1	2	73.8324012927
309	229	1	0	1	78.105731713
309	230	1	0	1	85.3616578027
309	236	1	0	1	60.5089420108
309	238	1	0	1	66.5644480971
309	242	2	0	2	106.394359917
309	245	21	0	21	23.0401035037
309	246	2	0	2	29.318183204
309	251	3	0	3	36.9311271701
309	256	11	4	7	13.4902343866
309	257	61	8	53	14.2376203425
309	258	93	33	60	7.66123990155
309	259	1	0	1	24.6302297639
309	260	3	1	2	16.772685473
309	261	42	17	25	9.27747661402
309	262	9	0	9	28.0695031899
309	263	3	0	3	23.1155870063
309	264	34	2	32	13.9402726264
309	265	1	0	1	35.792689243
309	266	3	0	3	45.3904284345
309	267	1	0	1	41.196557102
309	268	1	0	1	53.1778152554
309	270	7	2	5	28.6595814174
309	271	2	0	2	53.4627382778
309	272	3	0	3	50.7309355822
309	274	2	0	2	29.4071581422
309	275	1	0	1	34.7516621607
309	276	3	0	3	42.8943941443
309	277	149	4	145	34.1712899265
309	279	3	0	3	24.5754401204
309	280	0	0	0	40.657515901
309	281	0	0	0	32.3765589526
309	282	4	0	4	36.9971459983
309	284	2	0	2	46.0401682936
309	286	1	1	0	35.8284324232
309	287	2	0	2	43.0360942032
309	291	3	0	3	55.7083590344
309	293	3	0	3	51.4116532064
309	294	1	0	1	59.8005357092
309	297	1	0	1	61.5396294698
309	303	328	0	328	13.3334621702
309	304	235	2	233	6.60374326371
309	305	133	0	133	17.2029665805
309	306	28	0	28	12.3161916108
309	307	1465	606	859	7.64414910009
309	308	32	11	21	15.1686389675
309	329	1	0	1	65.211946821
309	375	1	0	1	80.2530329223
309	378	1	0	1	65.9223039721
309	464	3	2	1	72.3540928538
309	465	1	0	1	88.2791819398
309	466	5	0	5	92.0072293725
309	469	2	0	2	80.1828476993
309	471	1	0	1	72.9537806248
309	475	4	0	4	78.5235726646
309	491	1	0	1	84.5903034455
309	492	1	0	1	94.1792816912
309	495	1	0	1	97.3655849675
309	585	1	0	1	102.296397868
310	1	4	1	3	80.5202043721
310	13	1	0	1	71.5864920274
310	21	1	0	1	86.5205920776
310	25	1	0	1	101.976139872
310	36	3	0	3	64.3343587547
310	70	135	14	121	42.2523589005
310	71	24	6	18	50.5508598381
310	72	4	0	4	44.4093839999
310	73	797	53	744	49.7271047261
310	74	73	10	63	48.7726546916
310	75	40	13	27	51.5482467006
310	76	107	0	107	43.4129778301
310	77	6	0	6	45.9220940412
310	78	113	1	112	47.1530734059
310	79	12	2	10	47.0749519429
310	80	4	0	4	46.0806652251
310	81	62	5	57	45.2778771912
310	82	111	1	110	45.4687070158
310	83	25	9	16	48.2865266789
310	84	73	16	57	49.7452353035
310	85	49	0	49	44.6969028554
310	86	17	0	17	48.89660283
310	87	47	4	43	51.8412626769
310	88	17	3	14	51.7719975663
310	89	5	0	5	43.0882838454
310	90	10	2	8	39.2658037358
310	91	2	0	2	13.7482453258
310	92	5	0	5	40.2297914432
310	94	1	0	1	27.6614207441
310	95	1	0	1	54.3538706545
310	96	21	4	17	34.1125164961
310	97	3	0	3	20.7821911727
310	98	1	0	1	49.6417148271
310	103	13	1	12	55.5577620307
310	104	2	0	2	52.311521501
310	109	6	0	6	37.0963004999
310	111	2	0	2	37.2637427442
310	112	12	2	10	56.6304420327
310	113	21	0	21	56.4552358695
310	116	9	2	7	41.4717361207
310	117	1	0	1	54.2445417515
310	118	4	2	2	42.796863395
310	119	1	0	1	43.9310883177
310	120	2	0	2	48.2436238344
310	121	1	0	1	55.4870814737
310	122	3	0	3	33.6338245496
310	137	1	0	1	61.412960514
310	140	1	0	1	62.54493278
310	142	2	0	2	70.9796203088
310	155	22	7	15	41.2035266861
310	156	5	1	4	36.3245690037
310	162	1	0	1	34.1942783816
310	163	0	0	0	77.2692277414
310	164	1	0	1	49.9367223431
310	165	1	0	1	59.9953899233
310	166	17	2	15	39.7497598034
310	167	1	0	1	71.7344817815
310	168	7	0	7	53.8196822025
310	169	24	1	23	29.981005032
310	171	8	3	5	45.1359785504
310	172	12	2	10	58.4397644115
310	175	1	0	1	48.7988316736
310	176	2	0	2	84.1107363035
310	177	9	0	9	55.9050211099
310	179	4	0	4	25.456181025
310	183	3	0	3	77.3429952585
310	196	1	0	1	68.126343545
310	208	2	0	2	40.0141410141
310	214	1	0	1	32.6272450799
310	220	1	0	1	86.8454232564
310	225	1	0	1	50.7401747355
310	235	1	0	1	53.7685607458
310	239	0	0	0	55.2605597403
310	244	1	0	1	90.049575724
310	246	1	0	1	34.0259917433
310	247	6	2	4	18.1325516346
310	251	2	0	2	26.4200373973
310	252	2	0	2	33.2369220662
310	272	2	0	2	43.0010980162
310	273	1	0	1	39.2204295421
310	276	2	0	2	32.7847739349
310	277	4	0	4	48.5012861461
310	293	3	0	3	26.1054053848
310	294	23	0	23	16.9214788251
310	297	3	1	2	23.1611706422
310	301	1	0	1	19.6617995003
310	311	38	1	37	13.2910129727
310	312	11	4	7	18.801868348
310	313	99	59	40	7.84361607807
310	314	111	16	95	7.62310304919
310	315	22	3	19	10.4298336964
310	316	36	0	36	13.0285455081
310	317	34	2	32	13.0513049828
310	319	52	0	52	52.7117689351
310	320	1	0	1	59.4565656973
310	322	1	0	1	59.2731612942
310	325	1	0	1	62.5129420953
310	326	3	0	3	36.6638480687
310	328	3	0	3	45.1845527297
310	329	9	0	9	36.0689777439
310	332	27	1	26	23.6824405242
310	333	1	0	1	28.0471476268
310	334	11	0	11	28.8767097561
310	336	17	0	17	15.600498689
310	337	5	0	5	12.4260792816
310	338	277	10	267	25.1010907136
310	339	8	1	7	23.2230399898
310	341	48	2	46	17.0351124839
310	342	3	1	2	26.4471124055
310	343	1	0	1	32.1983808502
310	344	1	0	1	32.9456034808
310	345	23	10	13	38.3239951781
310	346	3	0	3	60.6596804944
310	347	17	7	10	26.2008375261
310	348	76	2	74	18.6262929459
310	349	37	0	37	32.7930112847
310	350	351	198	153	9.17606479971
310	351	1	0	1	27.7526539314
310	352	36	10	26	13.167643789
310	353	55	2	53	20.4340369601
310	355	1	0	1	43.6084574482
310	356	1	0	1	57.167373607
310	357	3	1	2	38.4137635136
310	367	1	0	1	39.5288332948
310	369	5	1	4	23.5823948568
310	370	3	1	2	23.9239543026
310	371	3	1	2	34.5740833159
310	372	5	1	4	29.7717823529
310	373	43	19	24	19.1642830816
310	374	1	0	1	33.6879543075
310	375	326	0	326	25.8776417819
310	376	4	0	4	29.4566212781
310	377	118	7	111	11.1956678974
310	378	3	0	3	21.8646883682
310	385	0	0	0	103.483478435
310	401	1	0	1	131.496356174
310	408	5	0	5	128.222214358
310	411	0	0	0	123.134146455
310	412	1	0	1	138.146750791
310	424	1	0	1	173.267077002
310	435	1	0	1	143.073823678
310	442	2	0	2	147.911344618
310	453	1	0	1	114.924601566
310	466	1	0	1	126.418144067
310	475	1	0	1	102.472188326
310	505	0	0	0	138.820348775
310	507	2	0	2	179.551805296
310	524	2	0	2	121.150235869
310	551	1	0	1	81.6113249756
310	559	1	0	1	100.714057661
310	561	0	0	0	112.608590643
310	566	1	0	1	92.3623412821
310	567	1	0	1	91.1570643797
310	568	0	0	0	79.3418155014
310	569	2	0	2	73.1081078378
310	573	10	0	10	80.2266445246
310	576	2	0	2	59.9242507285
310	577	1	0	1	63.6525509391
310	579	3	1	2	66.4976526984
310	581	3	0	3	66.773498838
310	583	2	0	2	83.6789063621
310	585	4	2	2	74.4019885141
311	1	2	0	2	93.7695334769
311	70	29	4	25	53.861303454
311	71	3	1	2	61.1955329532
311	72	1	0	1	56.4162160875
311	73	139	0	139	61.4367110477
311	74	8	1	7	59.9270703948
311	75	10	1	9	63.0652646511
311	76	17	3	14	54.6608312607
311	78	22	1	21	58.2488199563
311	79	5	1	4	59.1173722878
311	80	1	0	1	57.9245699044
311	81	16	0	16	57.0653103511
311	82	22	7	15	56.8183142308
311	83	7	1	6	59.8133428756
311	84	13	5	8	61.2859543946
311	85	14	0	14	55.3943844933
311	86	2	0	2	59.3507468632
311	87	4	0	4	63.0143606456
311	88	4	0	4	62.6826350822
311	89	1	0	1	55.7945343075
311	90	1	0	1	49.5801922377
311	96	6	0	6	44.2897579251
311	103	4	1	3	67.266198732
311	108	1	0	1	40.0339249168
311	109	3	0	3	48.3915680831
311	110	1	0	1	71.5833396922
311	112	5	1	4	68.6217584477
311	113	6	2	4	67.667719171
311	116	1	0	1	52.499560703
311	119	1	0	1	53.7776647758
311	121	1	0	1	66.3413795307
311	155	7	1	6	49.5573496071
311	159	1	0	1	54.889389213
311	164	1	0	1	59.2578493555
311	166	11	6	5	46.0215423821
311	167	1	0	1	78.5749841443
311	169	2	0	2	39.5203776166
311	171	5	0	5	54.1573753124
311	172	2	0	2	67.0003201617
311	175	1	0	1	57.0488286566
311	177	1	0	1	63.6765305969
311	182	1	0	1	93.6655550594
311	196	1	0	1	68.1037564991
311	199	1	0	1	54.2244708101
311	208	1	0	1	42.1933495832
311	211	2	0	2	47.4939245461
311	212	1	0	1	43.7101240558
311	220	1	0	1	92.3672897149
311	277	2	0	2	60.3307819767
311	293	2	0	2	36.0220831844
311	294	7	1	6	24.8312469329
311	296	0	0	0	29.9254558798
311	297	1	0	1	29.6891485683
311	310	239	36	203	13.2910129727
311	312	85	61	24	5.89800590206
311	313	8	1	7	14.7936669492
311	314	57	1	56	7.98361173147
311	315	2	0	2	20.9382189754
311	316	2	0	2	24.7727938485
311	317	15	3	12	17.7953875013
311	319	46	0	46	54.2303090502
311	320	1	0	1	60.9090807972
311	322	1	0	1	61.7029929678
311	323	4	0	4	60.3796736638
311	326	2	0	2	39.1073171721
311	329	10	0	10	40.6291466063
311	330	1	0	1	64.4454278642
311	331	1	0	1	53.7005508698
311	332	38	3	35	14.0999063196
311	333	15	1	14	17.5780342778
311	334	10	1	9	21.1415835475
311	335	7	0	7	10.8960285953
311	336	4	1	3	15.0487675503
311	337	1	0	1	16.2920783964
311	338	319	0	319	21.9257840742
311	339	10	4	6	15.9822975139
311	340	10	1	9	15.2254480399
311	341	145	133	12	9.39617998929
311	342	13	0	13	17.8655690172
311	343	2	0	2	20.2897766914
311	345	26	0	26	38.3130496921
311	346	1	0	1	58.7833778193
311	347	3	0	3	33.3727829056
311	348	5	0	5	29.0036759889
311	349	22	3	19	33.7386755272
311	350	64	0	64	22.4663778548
311	351	0	0	0	29.6573228163
311	352	1	0	1	23.0499950117
311	353	10	1	9	24.9912078188
311	356	1	0	1	52.6774105287
311	357	2	0	2	37.21874436
311	359	2	0	2	40.7742802556
311	360	1	0	1	62.1000942713
311	363	1	0	1	69.9060556316
311	367	1	0	1	40.3847478496
311	368	1	0	1	55.5730702945
311	369	9	1	8	15.9873751207
311	370	6	1	5	25.4742938895
311	371	3	0	3	33.1090442246
311	372	4	2	2	28.932953844
311	373	236	173	63	8.83186737656
311	374	2	0	2	26.1140063186
311	375	266	8	258	21.9121434499
311	376	2	1	1	20.770001598
311	377	136	103	33	8.35978541086
311	408	3	0	3	134.762179459
311	409	1	1	0	139.358317534
311	411	0	0	0	129.246688366
311	415	1	0	1	124.174244207
311	417	2	0	2	124.022417978
311	432	1	0	1	164.826587114
311	438	1	0	1	154.24412261
311	439	1	0	1	161.139578428
311	442	1	0	1	154.012045123
311	453	1	0	1	121.842493657
311	484	1	0	1	136.973521567
311	524	1	0	1	122.782786542
311	536	1	0	1	124.299573444
311	537	2	0	2	129.966668603
311	563	1	0	1	91.6526333487
311	568	1	0	1	85.37340283
311	573	7	0	7	84.1435302931
311	581	0	0	0	72.1639921242
311	583	0	0	0	78.7158425042
312	0	1	0	1	87.5154183392
312	28	1	0	1	94.1708522533
312	38	1	0	1	92.2059813402
312	41	1	0	1	88.1821265416
312	48	0	0	0	118.994007942
312	70	16	2	14	57.7922386292
312	71	2	0	2	64.5239307536
312	72	1	0	1	60.5683513071
312	73	97	2	95	65.3720842649
312	74	6	0	6	63.5479050611
312	75	9	1	8	66.874065805
312	76	26	4	22	58.3790295222
312	78	10	0	10	61.8504217958
312	79	1	0	1	63.2750924517
312	81	8	0	8	61.0774100356
312	82	24	1	23	60.5751244605
312	83	6	2	4	63.6499703226
312	84	9	0	9	65.120613861
312	85	12	0	12	58.805512963
312	86	3	0	3	62.5934161446
312	87	1	0	1	66.6226530297
312	88	2	0	2	66.145169729
312	89	1	0	1	60.4351307167
312	90	2	0	2	52.8615325476
312	92	1	1	0	56.7208102409
312	96	4	0	4	47.5848842039
312	100	1	1	0	74.9035994248
312	103	4	0	4	71.1669177749
312	109	1	0	1	52.2001588355
312	111	1	0	1	54.5954447212
312	112	4	1	3	72.696393893
312	113	7	0	7	71.2679479088
312	114	1	0	1	77.6908126317
312	116	4	1	3	56.1180999052
312	121	1	0	1	69.7455774916
312	142	1	0	1	84.6582204294
312	146	1	0	1	70.281422118
312	155	7	0	7	51.8890816827
312	156	2	0	2	47.7198621768
312	157	1	0	1	74.5758178591
312	159	2	0	2	56.2992562141
312	160	1	0	1	76.7527685887
312	166	12	0	12	47.4741213531
312	168	2	0	2	65.0364401942
312	169	5	0	5	42.6123963973
312	171	1	0	1	56.7346960145
312	172	2	0	2	69.2004550586
312	177	4	1	3	65.5269070935
312	179	1	0	1	37.9305229543
312	199	1	0	1	57.6862636363
312	205	1	0	1	37.0119524009
312	208	4	0	4	46.4515004981
312	211	1	0	1	51.1998564124
312	214	1	0	1	40.7483556824
312	232	1	1	0	59.2590182288
312	237	1	0	1	53.1464980107
312	245	1	0	1	58.3304469023
312	253	1	0	1	43.9860660311
312	272	1	0	1	58.0750588639
312	277	0	0	0	66.228080326
312	293	2	0	2	41.8562543415
312	294	3	0	3	30.5704624987
312	310	70	0	70	18.801868348
312	311	88	56	32	5.89800590206
312	313	2	0	2	18.6811265974
312	314	16	0	16	12.305604843
312	316	1	0	1	30.6490207096
312	317	4	0	4	23.3709295424
312	318	3	0	3	42.5865000358
312	319	38	0	38	53.3771788079
312	320	2	0	2	59.9120622958
312	321	2	0	2	46.3336802852
312	322	1	0	1	61.1263818354
312	326	8	0	8	39.0739432447
312	329	14	4	10	41.475662647
312	331	1	0	1	54.1520326094
312	332	57	25	32	9.89508166086
312	333	24	7	17	12.476570776
312	334	15	2	13	17.3033146323
312	335	5	0	5	5.22233020334
312	336	2	0	2	16.0207825983
312	337	2	1	1	18.8454636036
312	338	323	7	316	20.4270187249
312	339	15	0	15	13.0368265902
312	340	16	9	7	9.36637018607
312	341	161	106	55	8.14174316275
312	342	14	3	11	13.8409629458
312	343	5	0	5	14.4880205976
312	344	2	0	2	22.7591258997
312	345	11	1	10	41.9716715334
312	346	1	0	1	61.3537007152
312	347	3	0	3	35.6291253143
312	348	3	0	3	32.7798991015
312	349	32	6	26	33.2751898031
312	350	26	0	26	27.9094281454
312	351	2	0	2	29.8578255992
312	352	1	0	1	26.9232747376
312	353	12	0	12	26.6806355189
312	355	1	0	1	41.8790300535
312	356	1	0	1	49.2588466023
312	357	5	0	5	35.6337058563
312	358	0	0	0	66.6022443847
312	364	3	1	2	47.5141670668
312	365	1	0	1	31.4007711597
312	367	2	0	2	39.599531116
312	369	8	2	6	17.8003325929
312	371	1	0	1	36.4235104986
312	373	186	0	186	10.3033036355
312	374	1	0	1	26.9281698838
312	375	169	10	159	24.8803993497
312	376	1	0	1	21.2885259335
312	377	57	3	54	13.7244792228
312	378	1	0	1	31.5034607755
312	385	1	0	1	108.790288769
312	387	1	0	1	114.276956062
312	406	1	0	1	137.450799632
312	408	3	0	3	135.602315567
312	426	1	0	1	172.991259155
312	451	2	0	2	123.448422902
312	465	0	0	0	131.068478962
312	466	1	0	1	138.405534753
312	475	1	0	1	113.108925871
312	482	0	0	0	155.340752703
312	514	1	0	1	158.077761144
312	524	2	0	2	121.402899692
312	555	1	0	1	92.7538523337
312	563	1	0	1	90.5519973868
312	568	0	0	0	86.1919774565
312	573	5	1	4	83.9903305234
312	576	1	0	1	65.0182138321
312	581	1	0	1	72.7965247516
312	585	1	0	1	71.5728366347
313	70	17	2	15	39.1937376911
313	71	1	0	1	46.4049136556
313	72	2	0	2	41.8989275977
313	73	71	24	47	46.7766685146
313	74	4	1	3	45.1530121897
313	75	4	0	4	48.3477383203
313	76	16	2	14	39.9072050047
313	77	1	0	1	43.4366635761
313	78	5	0	5	43.4705013301
313	79	1	0	1	44.6056393723
313	81	6	0	6	42.4471983184
313	82	3	1	2	42.0780946162
313	83	1	0	1	45.1051488745
313	84	9	1	8	46.5778577726
313	85	6	0	6	40.6008881589
313	86	3	0	3	44.570474314
313	87	3	0	3	48.2392081984
313	88	2	0	2	47.8903217548
313	90	1	0	1	34.8007157098
313	96	4	0	4	29.5134006542
313	103	6	1	5	52.5916023632
313	108	1	0	1	25.3159644832
313	109	2	0	2	33.663125786
313	113	6	1	5	52.8927740598
313	116	2	0	2	37.721433469
313	117	1	0	1	50.426169353
313	120	1	0	1	46.2418715005
313	135	1	0	1	73.7774997861
313	147	1	0	1	79.2099890174
313	155	3	0	3	35.2942268869
313	156	1	0	1	30.6490443757
313	166	4	0	4	32.8308542187
313	168	2	0	2	48.2658191662
313	169	4	1	3	24.8192408516
313	177	1	0	1	49.7506128709
313	179	2	0	2	20.1034660609
313	208	1	0	1	47.8309415352
313	229	1	0	1	63.6401768899
313	250	1	0	1	40.8661376791
313	277	1	0	1	53.4717433687
313	310	151	49	102	7.84361607807
313	311	3	1	2	14.7936669492
313	314	26	23	3	6.81301634316
313	315	1	0	1	17.7351785055
313	316	1	1	0	19.3721507979
313	319	9	2	7	44.8995800335
313	320	1	0	1	51.6508585059
313	326	1	0	1	28.8715572509
313	329	2	0	2	28.5977400004
313	332	5	0	5	20.0378471889
313	333	1	0	1	24.5433947915
313	334	2	0	2	23.6288405739
313	336	8	3	5	8.87747608398
313	337	8	6	2	4.70300264368
313	338	75	25	50	18.2115956755
313	339	3	0	3	18.2781211071
313	341	5	1	4	13.6015353008
313	342	4	1	3	21.8726346794
313	345	3	0	3	45.9347386993
313	347	3	0	3	19.4903208321
313	348	4	1	3	14.2353836473
313	349	5	0	5	24.956854762
313	350	30	1	29	12.5203075109
313	351	2	1	1	19.9090492015
313	352	10	2	8	8.29906537691
313	353	27	2	25	12.7301676916
313	354	1	0	1	22.4836439734
313	363	0	0	0	71.1698206335
313	373	3	2	1	22.8988305145
313	375	23	0	23	32.4550363452
313	377	7	0	7	16.8410537109
313	406	1	0	1	123.001411289
313	408	2	0	2	121.659849337
313	524	1	0	1	113.41592174
313	573	1	0	1	72.805932473
313	581	1	0	1	59.7012137072
314	0	1	0	1	75.2099561548
314	23	1	0	1	89.4803543022
314	32	1	0	1	66.6302994909
314	70	27	4	23	45.9180618401
314	71	2	0	2	53.2179218797
314	73	139	5	134	53.4978129061
314	74	9	0	9	51.9466220886
314	75	10	0	10	55.1042563036
314	76	16	0	16	46.6864237412
314	78	7	0	7	50.2672227807
314	79	3	0	3	51.238734921
314	80	4	0	4	50.0094495477
314	81	11	0	11	49.1422793226
314	82	22	0	22	48.848574961
314	83	1	0	1	51.8555262391
314	84	18	0	18	53.3283318898
314	85	8	0	8	47.4131533178
314	86	6	0	6	51.3812633633
314	87	5	0	5	55.0336725689
314	89	2	0	2	48.165108623
314	90	3	0	3	41.6110590556
314	92	1	0	1	44.5947887951
314	96	5	0	5	36.3225008815
314	103	4	0	4	59.3223114162
314	104	1	0	1	57.2759358697
314	112	6	0	6	60.7209381181
314	113	3	1	2	59.6871661008
314	116	1	0	1	44.5179021232
314	122	2	0	2	37.9626529302
314	155	1	0	1	41.8549618794
314	166	6	2	4	38.8276857894
314	169	4	0	4	31.5939976313
314	171	1	0	1	46.3467507435
314	172	4	0	4	59.3085088816
314	177	1	0	1	56.1574171969
314	183	1	0	1	84.352664417
314	208	1	0	1	44.5831980765
314	214	1	0	1	37.6362740557
314	245	1	0	1	46.1292106906
314	247	0	0	0	24.6851234454
314	294	3	1	2	23.4277357137
314	296	1	0	1	25.2856428059
314	310	286	152	134	7.62310304919
314	311	28	0	28	7.98361173147
314	312	5	1	4	12.305604843
314	313	28	15	13	6.81301634316
314	315	1	0	1	17.665659524
314	316	6	0	6	20.6152824585
314	317	5	0	5	17.8911243617
314	319	15	2	13	48.9767447851
314	320	1	0	1	55.7325599483
314	322	1	1	0	56.0789587423
314	326	1	0	1	33.2664855105
314	329	3	1	2	33.9525705863
314	332	15	2	13	16.0621230746
314	333	3	1	2	20.4469475535
314	334	5	1	4	21.4207390204
314	335	4	1	3	15.8552475501
314	336	9	5	4	9.74511760298
314	337	7	0	7	9.00911293695
314	338	127	0	127	18.7425161557
314	339	3	1	2	15.7489617172
314	340	3	1	2	20.3342010358
314	341	64	3	61	9.4135116964
314	342	2	0	2	18.8675950776
314	343	1	0	1	24.7903782791
314	344	1	0	1	25.7606183046
314	345	7	0	7	41.8272483992
314	347	3	0	3	25.8070839992
314	348	4	0	4	21.0228613697
314	349	11	0	11	28.505604811
314	350	39	3	36	16.0986483099
314	351	2	1	1	23.869318824
314	352	4	0	4	15.0708587547
314	353	17	1	16	17.9867342511
314	354	1	0	1	27.9628686586
314	357	1	0	1	33.1854366511
314	369	5	0	5	22.5456207095
314	372	1	0	1	32.6871176311
314	373	27	5	22	16.2237952935
314	375	70	0	70	27.0121206595
314	377	28	0	28	11.3312207165
314	408	1	0	1	127.715389228
314	411	0	0	0	122.337109243
314	438	1	0	1	147.719361857
314	442	1	0	1	147.126925508
314	443	0	0	0	165.964552754
314	507	1	0	1	174.569751889
314	512	1	0	1	153.506322115
314	530	1	0	1	125.720186458
314	566	1	0	1	90.566493172
314	568	1	0	1	78.4249994895
314	573	3	0	3	77.9773342408
314	581	0	0	0	65.3985743682
314	585	2	0	2	69.6697024265
315	0	1	0	1	66.2476266524
315	1	4	1	3	76.0823319014
315	35	1	0	1	75.6341928362
315	70	16	2	14	43.4808504185
315	71	5	0	5	52.9483805716
315	72	2	0	2	44.7895658892
315	73	103	2	101	50.4836743843
315	74	6	1	5	50.4907343122
315	75	7	1	6	52.5850878064
315	76	15	7	8	45.1951200456
315	77	2	0	2	46.1990068467
315	78	13	2	11	49.0202262729
315	79	2	0	2	47.2800211427
315	80	2	0	2	46.7169254566
315	81	6	0	6	46.0523804754
315	82	17	2	15	47.0008952148
315	83	3	0	3	49.4156063668
315	84	10	0	10	50.8000011939
315	85	8	2	6	47.2395510518
315	86	5	0	5	51.6061998121
315	87	5	1	4	53.4281122215
315	88	3	0	3	53.7549210886
315	90	5	0	5	42.5699346637
315	92	2	0	2	40.3977497732
315	96	1	0	1	37.8908692811
315	103	1	0	1	56.1417312893
315	109	1	0	1	39.1209349423
315	112	1	0	1	56.6496641511
315	113	4	0	4	57.8467938251
315	116	3	0	3	43.6821948785
315	118	0	0	0	45.8054160961
315	119	1	0	1	47.5834825276
315	123	1	0	1	35.6892568138
315	142	0	0	0	73.0224102979
315	155	3	0	3	46.49867216
315	157	1	0	1	69.9473091071
315	166	5	1	4	46.7143350479
315	168	1	0	1	58.2077529872
315	169	5	1	4	34.7886388035
315	171	2	0	2	49.6308531431
315	177	1	0	1	61.2114450134
315	185	1	0	1	67.0202382246
315	188	1	0	1	60.0587000477
315	204	1	0	1	21.1437815456
315	205	2	0	2	18.4043460724
315	206	1	0	1	27.0543705006
315	208	4	0	4	31.8231402481
315	212	2	0	2	27.4585555093
315	214	1	0	1	24.1295765833
315	220	1	0	1	76.7127821253
315	245	1	0	1	35.998731331
315	247	4	0	4	15.8523856169
315	251	1	0	1	24.5017308736
315	253	3	0	3	17.9902242457
315	257	1	0	1	43.8224461632
315	264	1	0	1	45.2296516633
315	266	1	0	1	53.5512915303
315	272	3	0	3	32.6288306708
315	277	14	2	12	39.393596661
315	281	0	0	0	31.4844236056
315	283	1	0	1	54.1605024861
315	287	1	0	1	32.5905515367
315	291	1	0	1	28.8781378196
315	292	2	0	2	24.0011491356
315	293	27	5	22	15.7643344443
315	294	198	5	193	7.20587298167
315	295	1	0	1	21.5684049395
315	296	7	1	6	9.54756603942
315	297	7	0	7	13.5922963593
315	299	1	0	1	12.4036015009
315	301	2	1	1	9.24279259855
315	302	1	0	1	17.5064044715
315	310	101	1	100	10.4298336964
315	311	3	0	3	20.9382189754
315	312	1	0	1	26.8360701679
315	313	4	2	2	17.7351785055
315	314	4	0	4	17.665659524
315	316	55	5	50	4.32057541989
315	317	31	3	28	8.12767775659
315	319	6	0	6	61.7288715713
315	321	1	0	1	53.068808939
315	323	1	0	1	64.7865011241
315	326	1	0	1	45.6853571373
315	329	1	0	1	44.1811379954
315	332	1	0	1	33.4077036423
315	333	1	0	1	37.5849776498
315	336	1	0	1	25.9997894583
315	337	1	0	1	22.4381289525
315	338	23	9	14	35.5107169525
315	340	1	0	1	36.1211277477
315	341	2	0	2	26.9353841203
315	345	6	0	6	31.5886026075
315	346	1	0	1	54.2192383664
315	348	10	0	10	23.806905096
315	349	2	0	2	42.4149372887
315	350	140	35	105	9.48388310024
315	352	0	0	0	19.9911907524
315	353	2	0	2	29.4638383528
315	369	1	0	1	24.6064136045
315	370	3	1	2	17.7044510923
315	371	1	0	1	29.1515668742
315	372	3	1	2	24.424611284
315	373	6	1	5	23.3018058714
315	374	1	0	1	33.1586595826
315	375	88	30	58	23.5768488291
315	377	24	0	24	14.5850482599
315	378	2	0	2	13.8265033259
315	408	2	0	2	133.680157631
315	433	1	0	1	168.552215447
315	438	1	0	1	155.541433283
315	479	0	0	0	110.881948508
315	505	1	0	1	141.683533621
315	524	1	0	1	129.587196617
315	573	1	0	1	87.7758486278
315	581	0	0	0	73.6158335462
315	583	1	0	1	94.0340979184
316	1	2	0	2	71.7895103699
316	41	1	0	1	66.0702529697
316	65	0	0	0	106.015267649
316	70	16	10	6	40.354257556
316	71	2	0	2	50.0922669442
316	72	1	0	1	41.4095582788
316	73	82	0	82	47.158240632
316	74	3	0	3	47.4426483011
316	75	3	0	3	49.321925772
316	76	11	0	11	42.2176883512
316	78	12	10	2	46.0307855899
316	79	6	1	5	43.8321822286
316	81	4	0	4	42.7688122366
316	82	6	1	5	43.9283234051
316	83	3	0	3	46.202898623
316	84	9	0	9	47.5550985814
316	85	15	2	13	44.4842417137
316	86	4	0	4	48.8638051213
316	87	3	2	1	50.3174638536
316	88	1	0	1	50.7616725432
316	89	1	0	1	38.046562588
316	90	2	2	0	40.1353752251
316	95	1	0	1	50.0304367288
316	96	2	0	2	35.7080700482
316	106	1	0	1	39.1708118776
316	109	1	0	1	36.2999241117
316	110	1	0	1	57.0445390972
316	111	1	0	1	32.6968651252
316	112	1	0	1	53.0948434446
316	113	2	0	2	54.6497333652
316	116	1	0	1	40.8585896567
316	122	2	0	2	31.1049430254
316	140	1	0	1	60.75326393
316	142	1	0	1	69.9422528712
316	155	3	0	3	44.7882378771
316	156	1	0	1	39.7705712406
316	168	1	0	1	56.0130018453
316	169	11	2	9	33.0781416609
316	171	3	1	2	47.5558828416
316	172	1	0	1	60.7996942938
316	177	4	0	4	59.3659666308
316	187	1	0	1	56.3018626215
316	196	0	0	0	61.8363323769
316	205	1	0	1	19.7461340328
316	208	2	0	2	33.2567531181
316	212	3	0	3	27.1503314143
316	215	1	0	1	26.0888348393
316	220	1	0	1	75.8293608047
316	245	2	0	2	31.823626523
316	247	10	1	9	12.4751095432
316	251	2	1	1	20.8384630378
316	253	3	1	2	13.7179186098
316	272	2	0	2	30.3639870107
316	273	0	0	0	26.2064788447
316	274	1	0	1	32.7866951892
316	276	1	0	1	19.7711371905
316	277	9	0	9	35.6902023276
316	282	1	0	1	24.5678604949
316	284	1	0	1	24.1915965247
316	293	12	2	10	13.5652780573
316	294	59	27	32	8.73831989504
316	296	15	5	10	5.27445243416
316	297	2	0	2	14.4807109777
316	301	2	0	2	7.87487669037
316	302	1	0	1	13.7669837016
316	310	47	2	45	13.0285455081
316	311	1	0	1	24.7727938485
316	312	1	0	1	30.6490207096
316	313	1	0	1	19.3721507979
316	314	1	0	1	20.6152824585
316	315	22	19	3	4.32057541989
316	317	8	1	7	12.1490312443
316	319	2	0	2	61.9060691307
316	326	1	0	1	45.9890526879
316	331	1	0	1	56.4381177783
316	338	8	0	8	37.5407469344
316	341	1	0	1	30.020420213
316	345	3	1	2	33.8746689959
316	347	1	0	1	32.7361307729
316	348	4	0	4	22.6520985038
316	350	74	0	74	8.47744844707
316	352	2	0	2	19.8147580412
316	353	2	0	2	30.0392134415
316	357	1	0	1	49.6154841783
316	373	3	1	2	27.5883340084
316	375	23	2	21	27.4491856125
316	377	12	5	7	18.8306857287
316	378	1	0	1	16.0685131166
316	385	1	0	1	108.713284524
316	408	0	0	0	131.671026823
316	466	1	0	1	126.057433253
316	494	1	0	1	110.429093088
316	496	1	0	1	113.320110122
316	568	0	0	0	84.0168249942
316	569	1	0	1	80.5307265347
316	573	2	0	2	86.888113605
317	1	3	0	3	83.7591605042
317	42	1	0	1	67.9182231042
317	48	1	0	1	110.974972153
317	50	1	0	1	101.332665175
317	56	1	0	1	107.383748431
317	70	29	1	28	51.3691623439
317	71	1	0	1	60.6335588826
317	72	3	0	3	52.8061111688
317	73	131	0	131	58.4677486527
317	74	9	0	9	58.3152348209
317	75	7	0	7	60.534311807
317	76	26	0	26	52.9862494643
317	78	16	0	16	56.8093761152
317	79	6	0	6	55.3224923561
317	81	10	0	10	54.0214389709
317	82	27	1	26	54.848546975
317	83	4	0	4	57.3416312747
317	84	7	0	7	58.74172666
317	85	9	0	9	54.866165063
317	87	11	0	11	61.2869453398
317	88	3	1	2	61.5361186382
317	89	1	0	1	49.9328971005
317	90	3	0	3	49.9591781239
317	92	1	0	1	48.4252029457
317	95	1	0	1	61.836698881
317	96	2	0	2	45.0934534018
317	103	2	0	2	64.1600018877
317	112	4	1	3	64.7256912089
317	113	9	0	9	65.7518517777
317	116	3	1	2	51.3721412761
317	120	1	0	1	55.8672922844
317	142	1	0	1	80.835052605
317	145	1	0	1	85.2751025691
317	155	2	0	2	53.1588615171
317	158	2	0	2	68.112101525
317	166	5	1	4	52.4660118971
317	168	1	0	1	65.2986380547
317	169	5	1	4	41.5754231476
317	170	1	0	1	66.7057541963
317	171	2	0	2	56.6461011411
317	172	1	0	1	70.0217806493
317	175	1	1	0	60.6782032349
317	177	4	0	4	67.9243482842
317	179	3	0	3	37.3501982244
317	183	1	0	1	67.5942212919
317	187	1	0	1	55.1651852027
317	204	1	0	1	19.4621366879
317	205	3	0	3	14.8155879478
317	206	2	1	1	24.282193678
317	207	3	1	2	28.8624615979
317	208	7	1	6	27.0408200185
317	212	9	0	9	26.1368188345
317	213	2	0	2	34.3002067957
317	214	4	0	4	19.8294057469
317	215	1	0	1	17.5947413856
317	228	1	0	1	42.8214878356
317	229	1	0	1	43.3465085068
317	230	1	0	1	50.8176923909
317	237	4	0	4	30.3959098876
317	245	3	0	3	43.969779667
317	247	2	0	2	23.9405288053
317	251	2	0	2	32.6222951853
317	253	1	0	1	25.1458169971
317	254	1	0	1	36.2960065123
317	264	3	0	3	52.5936152554
317	272	3	0	3	34.7640935964
317	276	2	0	2	28.0598958471
317	277	18	1	17	44.4721320505
317	281	0	0	0	37.5879064501
317	290	1	0	1	49.4470387098
317	292	4	0	4	25.5799886337
317	293	37	2	35	19.0833942735
317	294	329	253	76	7.50307414415
317	295	2	0	2	25.1786571406
317	296	1	0	1	16.9622968898
317	297	14	2	12	11.9129992924
317	298	3	0	3	19.1588823075
317	299	1	0	1	17.9120611526
317	301	3	0	3	12.8626553891
317	307	0	0	0	64.3869061936
317	310	163	0	163	13.0513049828
317	311	14	0	14	17.7953875013
317	312	5	0	5	23.3709295424
317	313	9	3	6	20.8153692994
317	314	3	0	3	17.8911243617
317	315	34	22	12	8.12767775659
317	316	30	1	29	12.1490312443
317	318	1	0	1	54.3351146498
317	319	6	1	5	65.7132148267
317	323	1	0	1	69.7787653082
317	326	2	0	2	49.6853026264
317	331	2	0	2	62.2481267597
317	332	6	0	6	31.679901772
317	333	0	0	0	35.3616390989
317	334	2	1	1	38.2840797753
317	336	1	0	1	27.4929479084
317	338	50	24	26	36.6324853608
317	339	1	0	1	32.7454656999
317	341	6	1	5	25.9061339319
317	342	1	0	1	35.237648972
317	345	27	1	26	25.3485267198
317	346	2	0	2	47.830141448
317	347	1	0	1	38.9099299066
317	348	9	0	9	30.2666424145
317	349	5	3	2	45.6221571818
317	350	82	7	75	16.7120413661
317	352	5	1	4	25.5378409478
317	353	5	0	5	33.4813757478
317	356	1	0	1	68.6678746782
317	361	0	0	0	58.1056588548
317	369	4	0	4	16.9665393215
317	370	21	14	7	10.9438031059
317	371	8	2	6	22.0103730646
317	372	9	0	9	17.186394952
317	373	49	7	42	17.2083144324
317	374	1	0	1	25.0651776131
317	375	453	24	429	15.4575405222
317	376	4	0	4	22.5568876914
317	377	144	28	116	9.67273848055
317	378	33	8	25	9.17627279539
317	392	0	0	0	113.667538631
317	408	1	0	1	140.415294951
317	414	1	0	1	147.114534217
317	426	0	0	0	178.245675946
317	466	1	0	1	136.806104428
317	552	0	0	0	116.13626668
317	563	0	0	0	102.78195511
317	568	0	0	0	91.8565611927
317	573	6	0	6	93.1782017492
317	575	1	0	1	93.2990992424
317	581	2	0	2	79.5091617089
317	583	8	0	8	95.0802533261
317	586	1	0	1	90.2837945366
318	1	2	0	2	88.3872263048
318	36	1	0	1	64.0052953464
318	42	1	0	1	66.0350334431
318	70	31	6	25	40.7653222281
318	71	9	0	9	40.1006903447
318	72	1	0	1	44.7361103662
318	73	119	0	119	46.0800601365
318	74	8	1	7	41.8918972313
318	75	21	0	21	46.0318706093
318	76	23	0	23	39.1952652684
318	77	1	0	1	45.8415587745
318	78	28	4	24	40.5130474807
318	79	2	0	2	46.6906122098
318	80	1	0	1	44.6241154705
318	81	15	0	15	43.7329045109
318	82	21	0	21	41.0155294084
318	83	9	0	9	43.9071312572
318	84	11	1	10	44.961033887
318	85	20	2	18	36.7800629178
318	86	6	0	6	37.9820448574
318	87	16	0	16	44.0546577898
318	88	4	0	4	42.4390751304
318	89	2	0	2	49.731562373
318	90	12	0	12	32.0416008366
318	92	1	0	1	43.6309137251
318	93	1	0	1	38.6031789615
318	95	1	0	1	53.9976610243
318	96	3	1	2	29.5634038109
318	102	2	0	2	60.9696444454
318	103	5	0	5	50.1887908382
318	109	2	0	2	36.2722318476
318	110	1	0	1	53.1480488658
318	111	2	0	2	45.971162967
318	112	7	0	7	53.0385051508
318	113	7	3	4	47.5906900753
318	116	3	0	3	36.8651330046
318	118	1	0	1	34.2178130517
318	119	1	0	1	31.9588117052
318	120	1	0	1	49.7574511035
318	140	1	0	1	51.504720967
318	142	1	0	1	55.2160186917
318	145	1	0	1	63.5426728607
318	155	41	3	38	23.9229634604
318	156	12	2	10	24.1560843321
318	158	3	0	3	26.6580572835
318	159	3	0	3	20.2887537872
318	162	2	0	2	20.1309421687
318	163	1	0	1	50.1006068123
318	164	2	0	2	32.9236713187
318	166	129	0	129	15.2870653503
318	168	11	2	9	33.2914172611
318	169	9	0	9	26.2301440134
318	170	2	0	2	20.2574000401
318	171	11	0	11	28.6966947779
318	172	12	1	11	35.4969552394
318	173	1	0	1	27.6261858933
318	175	4	0	4	27.3743057384
318	177	11	0	11	30.2735716132
318	258	1	0	1	69.2433636415
318	277	2	0	2	78.7100755135
318	293	1	1	0	64.0324912702
318	307	0	0	0	79.1145123805
318	309	1	0	1	74.8112355305
318	310	5	0	5	41.3502264191
318	311	1	0	1	43.0746818211
318	313	1	0	1	33.5267546458
318	319	440	134	306	11.3928944856
318	320	12	0	12	18.1561847177
318	321	80	14	66	3.94790481555
318	322	1	0	1	18.63065089
318	323	37	0	37	18.0167674785
318	324	23	0	23	6.59843812461
318	325	0	0	0	21.3065643856
318	326	177	139	38	4.90255974
318	327	7	0	7	11.2760962155
318	328	21	4	17	8.75696585294
318	329	183	12	171	9.65932869897
318	330	1	0	1	21.4662675927
318	332	4	0	4	34.7896455857
318	333	1	0	1	36.4348657411
318	334	4	1	3	29.5524293756
318	336	1	1	0	28.2072372739
318	338	57	0	57	22.3760815692
318	339	1	0	1	30.4994162449
318	340	1	0	1	42.115092852
318	341	8	0	8	34.5539311361
318	344	1	0	1	25.9068182476
318	347	8	2	6	19.9368490075
318	349	391	107	284	9.35320957182
318	350	4	1	3	42.4652960616
318	351	6	0	6	13.7644798421
318	353	23	1	22	21.0587690179
318	354	9	6	3	13.5113608557
318	355	26	13	13	6.72837224901
318	356	1	0	1	26.0205522604
318	357	30	11	19	9.84481300403
318	358	1	0	1	46.9664749854
318	359	4	0	4	20.5593013781
318	361	8	4	4	12.2998629462
318	362	1	0	1	17.0654891793
318	364	9	1	8	15.4691327564
318	365	2	0	2	16.1946560316
318	366	4	0	4	17.4940691809
318	367	99	40	59	3.53451393206
318	375	3	0	3	64.4847186718
318	385	0	0	0	66.4305367095
318	391	1	0	1	69.0920071842
318	393	1	0	1	85.7789362925
318	401	2	0	2	96.1117711538
318	408	1	0	1	93.9969021995
318	415	2	0	2	83.6988850285
318	435	1	0	1	107.4497216
318	442	0	0	0	112.505382374
318	443	1	0	1	130.054695686
318	464	1	0	1	94.6095660772
318	475	1	0	1	75.2851856469
318	524	4	0	4	80.0953384183
318	540	1	0	1	99.1192108682
318	555	1	0	1	52.2119819094
318	569	3	0	3	33.3048859337
318	571	0	0	0	54.431752933
318	573	16	3	13	41.4268913933
318	576	2	1	1	23.4091392351
318	577	3	0	3	23.6620986
318	579	2	0	2	27.5358500584
318	580	1	0	1	37.701501812
318	581	4	0	4	31.522228385
318	585	2	0	2	33.67358977
318	588	2	0	2	51.4104651751
319	0	2	0	2	79.1514380869
319	1	25	0	25	92.8602485924
319	5	1	0	1	98.9400340053
319	7	1	0	1	81.774930153
319	12	1	0	1	101.535500488
319	13	1	0	1	78.1597250515
319	17	1	0	1	86.5361440001
319	18	1	0	1	74.8369444045
319	21	1	0	1	93.9302787447
319	23	1	0	1	90.116964246
319	26	1	0	1	89.5649226005
319	33	1	0	1	75.25447507
319	34	1	0	1	75.4074584011
319	36	6	0	6	67.5903419264
319	38	2	0	2	71.463159738
319	39	1	1	0	72.2929167854
319	41	2	0	2	71.6898958266
319	42	1	0	1	70.551736377
319	43	3	0	3	111.415291391
319	46	1	0	1	103.04020305
319	48	2	0	2	91.4948955696
319	59	1	0	1	103.514825269
319	60	1	0	1	88.4608582446
319	65	1	0	1	107.033378959
319	70	283	0	283	46.4602316241
319	71	59	0	59	43.2756114224
319	72	13	6	7	50.3313456842
319	73	1317	0	1317	50.4438383076
319	74	126	0	126	45.9022816092
319	75	163	5	158	49.8682946159
319	76	198	4	194	44.4072806072
319	77	9	1	8	51.1911859218
319	78	225	36	189	44.8103343878
319	79	25	9	16	51.8566017914
319	80	7	3	4	49.7728565413
319	81	64	12	52	48.9789099668
319	82	213	0	213	45.8667505326
319	83	55	1	54	48.3537456276
319	84	158	0	158	49.1490332637
319	85	129	0	129	41.3425190321
319	86	64	0	64	41.3672668043
319	87	162	0	162	47.476362419
319	88	43	3	40	45.6099084595
319	89	9	1	8	56.2454192641
319	90	26	11	15	37.8143329848
319	92	14	0	14	50.1185243318
319	94	1	1	0	46.6312101277
319	95	12	0	12	58.3856333686
319	96	23	1	22	36.7125327061
319	97	1	0	1	43.7862038545
319	98	4	1	3	37.8246064055
319	99	1	0	1	58.5390463974
319	101	1	0	1	55.0757319042
319	102	5	0	5	66.5134249805
319	103	37	1	36	53.5746563063
319	107	6	0	6	39.5708713974
319	109	14	2	12	42.9014218685
319	110	6	0	6	55.8089011104
319	111	10	0	10	53.3313393135
319	112	79	8	71	56.6362548126
319	113	119	8	111	50.219024913
319	114	3	0	3	62.0700311019
319	116	31	1	30	42.3809706989
319	117	3	0	3	47.2811703258
319	118	3	1	2	39.0907438504
319	119	14	0	14	36.2362805659
319	120	6	0	6	55.0554232446
319	121	3	1	2	47.1141111114
319	122	1	0	1	47.6301053335
319	129	2	0	2	62.8132986697
319	131	1	0	1	78.518171882
319	137	2	0	2	42.8807554752
319	141	1	0	1	57.7789658478
319	142	12	1	11	54.7426361243
319	144	1	0	1	47.8127062523
319	146	7	0	7	45.0026946607
319	147	1	0	1	56.3143649079
319	149	2	0	2	65.8260157246
319	154	7	0	7	45.8524781552
319	155	259	0	259	28.6176406844
319	156	26	0	26	30.6671152579
319	157	2	0	2	34.6877068271
319	158	19	0	19	24.5767815966
319	159	46	9	37	21.084953085
319	160	7	1	6	40.5738456901
319	161	1	0	1	39.4568770386
319	162	12	0	12	27.6250494981
319	163	5	0	5	45.5259701441
319	164	21	0	21	35.1248518148
319	165	9	0	9	27.5150225945
319	166	451	5	446	20.8654221381
319	167	4	0	4	34.5327899573
319	168	84	0	84	33.9576117158
319	169	27	3	24	34.5429425696
319	170	33	0	33	17.0326264124
319	171	118	19	99	32.1865864966
319	172	130	44	86	34.6502876538
319	173	4	0	4	22.9985967538
319	175	24	0	24	29.1264339406
319	177	167	4	163	29.2008584089
319	178	1	0	1	41.2949419727
319	179	6	1	5	35.1923808034
319	180	2	0	2	29.8549060278
319	181	1	0	1	112.014091031
319	183	11	0	11	124.971295391
319	190	1	0	1	128.295731171
319	196	2	0	2	120.659741082
319	206	2	0	2	88.7698141631
319	208	3	0	3	92.7252140847
319	212	1	0	1	88.9902323351
319	215	1	0	1	83.1680764039
319	219	0	0	0	138.492663529
319	220	2	0	2	137.557506
319	225	1	0	1	102.958384934
319	230	1	0	1	116.028641126
319	236	1	0	1	99.6401544923
319	237	2	0	2	93.0117361806
319	245	4	0	4	63.6985748553
319	249	1	0	1	62.9358751713
319	251	2	0	2	54.310576542
319	257	3	0	3	71.6785422756
319	271	1	0	1	100.949977909
319	277	4	1	3	88.1547599106
319	279	1	0	1	86.0549978725
319	281	0	0	0	78.2535728498
319	284	1	0	1	83.2517735431
319	291	1	0	1	88.8485697277
319	294	1	0	1	68.9032602165
319	305	2	0	2	83.8851911778
319	307	5	0	5	85.835787855
319	309	4	0	4	80.818177716
319	310	6	1	5	52.7117689351
319	311	2	0	2	54.2303090502
319	312	2	1	1	53.3771788079
319	313	1	0	1	44.8995800335
319	314	5	0	5	48.9767447851
319	316	1	0	1	61.9060691307
319	318	79	16	63	11.3928944856
319	320	1094	543	551	6.7636884438
319	321	560	384	176	8.75649707266
319	322	146	112	34	8.08999410358
319	323	1319	29	1290	10.3777358408
319	324	241	23	218	8.13898601296
319	325	258	69	189	10.5224592889
319	326	102	31	71	16.0693870376
319	327	544	13	531	6.70172555933
319	328	111	0	111	10.9912541353
319	329	205	0	205	18.6184745762
319	330	133	33	100	10.2304356339
319	331	103	4	99	11.9221578701
319	332	16	1	15	45.0094289704
319	333	1	0	1	46.0590560693
319	334	9	0	9	39.0229130145
319	336	11	2	9	39.4925225895
319	338	271	15	256	32.9637576766
319	339	2	0	2	40.8531081099
319	341	21	11	10	45.4752677038
319	342	9	2	7	41.8813633345
319	343	0	0	0	50.9349138224
319	344	3	0	3	34.5835551265
319	345	7	0	7	90.6551278714
319	346	8	0	8	112.409668852
319	347	17	0	17	29.9680219934
319	348	5	1	4	40.398010476
319	349	375	0	375	20.5401526713
319	350	4	0	4	53.451224443
319	351	5	0	5	25.1514287897
319	352	2	0	2	42.0922119072
319	353	25	8	17	32.350509573
319	354	3	0	3	23.9595661585
319	355	108	10	98	12.1326838523
319	356	24	5	19	24.7022486925
319	357	61	0	61	18.2972141863
319	358	18	0	18	43.0076887757
319	359	31	4	27	24.7180554321
319	360	2	1	1	29.1381259543
319	361	86	16	70	15.4716138156
319	362	4	0	4	20.3436291659
319	363	3	0	3	49.0450364467
319	364	155	0	155	13.8928059037
319	365	6	0	6	24.1459630809
319	366	180	6	174	10.519159465
319	367	111	45	66	13.8495681864
319	368	5	2	3	33.114788462
319	369	2	0	2	70.1966443737
319	371	2	1	1	86.2525830183
319	372	1	0	1	81.6314374916
319	373	3	1	2	62.8006984909
319	375	29	1	28	75.781155655
319	377	1	0	1	60.2758930213
319	379	8	0	8	63.7705348858
319	380	2	0	2	50.3520266835
319	385	12	0	12	56.6916586861
319	386	1	0	1	57.2481882865
319	387	1	0	1	61.6405578709
319	391	3	0	3	60.2933824814
319	392	1	0	1	55.8907385588
319	394	1	0	1	69.2012609071
319	396	1	0	1	81.1222023346
319	398	0	0	0	89.8369538254
319	401	3	0	3	86.6893837523
319	403	1	0	1	99.3144922667
319	405	1	0	1	90.9609759447
319	406	8	0	8	87.7404457578
319	408	46	2	44	85.0274685219
319	409	3	0	3	91.5476602229
319	410	2	0	2	80.6908076299
319	411	13	1	12	78.7372913721
319	412	0	0	0	94.649848218
319	414	0	0	0	95.3097732456
319	415	10	2	8	75.0117816993
319	416	1	0	1	94.3725314324
319	417	9	1	8	73.8446787665
319	421	1	0	1	104.806849245
319	422	1	0	1	115.329056498
319	432	1	0	1	115.114302861
319	435	0	0	0	97.8505226303
319	437	1	0	1	120.941804685
319	438	5	0	5	101.612750513
319	441	0	0	0	98.412578311
319	442	3	0	3	102.949268038
319	443	0	0	0	119.780882375
319	444	2	1	1	109.709400841
319	447	1	0	1	112.214422876
319	450	0	0	0	54.9840988015
319	457	1	0	1	72.6919537646
319	459	1	0	1	68.3456123451
319	464	0	0	0	91.2107801344
319	466	5	0	5	96.2887528111
319	469	2	0	2	84.0497854028
319	475	6	0	6	69.3976083192
319	480	1	0	1	89.7768687082
319	496	0	0	0	76.89370234
319	503	1	0	1	82.5053152286
319	507	6	1	5	127.699138857
319	510	1	0	1	114.32498032
319	511	1	0	1	133.121172167
319	512	5	0	5	104.647667209
319	515	1	0	1	99.8383720791
319	516	1	0	1	104.736752564
319	517	2	0	2	99.494128946
319	520	2	0	2	75.0193815508
319	521	1	0	1	80.8969672359
319	524	42	5	37	68.7291338895
319	529	2	0	2	85.5929303465
319	535	1	0	1	95.3393123737
319	536	2	0	2	75.9205205625
319	540	2	0	2	87.9694079905
319	541	0	0	0	103.649800886
319	549	1	0	1	113.784968803
319	551	4	0	4	28.9625729499
319	552	2	1	1	51.8421608083
319	553	2	0	2	69.4143492027
319	554	6	0	6	51.6544303057
319	555	10	0	10	40.8382031143
319	556	2	0	2	58.9036812513
319	557	0	0	0	50.8729057381
319	561	1	0	1	59.9051166671
319	563	13	2	11	37.4494608965
319	564	3	0	3	37.4682063246
319	566	8	0	8	44.7410108991
319	567	1	0	1	39.9088134674
319	568	3	0	3	37.3539628748
319	569	33	16	17	22.8083889888
319	570	25	14	11	17.7350663923
319	571	2	0	2	43.8501959854
319	572	18	3	15	20.0076021579
319	573	534	0	534	31.3332241085
319	575	2	0	2	28.3936541786
319	576	79	1	78	16.7153931651
319	577	216	76	140	13.4836324731
319	578	2	0	2	41.80906124
319	579	127	0	127	18.0166595833
319	580	5	0	5	29.1789855018
319	581	81	32	49	24.435525624
319	582	8	0	8	26.8642478401
319	583	21	0	21	42.7451122094
319	584	0	0	0	36.0707247289
319	585	118	0	118	23.2611938264
319	586	26	1	25	30.0522182101
319	587	53	0	53	17.1817993431
319	588	1	0	1	43.0390191411
320	1	1	0	1	95.9774211888
320	3	2	0	2	78.1759840153
320	5	1	0	1	101.50455794
320	34	1	0	1	76.5166610235
320	70	38	2	36	50.6881284232
320	71	13	2	11	46.3180850692
320	72	1	0	1	54.444327922
320	73	220	0	220	53.9371109357
320	74	14	3	11	49.3079466185
320	75	26	4	22	53.1011954011
320	76	36	8	28	48.4421581132
320	78	29	1	28	48.3855679086
320	79	4	0	4	55.7317556
320	81	10	1	9	52.9422332932
320	82	27	1	26	49.6944366735
320	83	7	0	7	51.9288275881
320	84	25	0	25	52.5769893907
320	85	27	2	25	45.1334016512
320	86	9	0	9	44.5707962946
320	87	22	3	19	50.5439659286
320	88	2	0	2	48.5903551345
320	89	2	0	2	60.7299087711
320	90	2	0	2	42.2681800545
320	92	1	0	1	54.6682880905
320	95	2	1	1	61.7644953663
320	96	2	1	1	41.7990915808
320	98	1	0	1	40.7816678709
320	103	9	0	9	56.5019620712
320	107	1	0	1	41.6263492856
320	109	1	0	1	47.6339305251
320	111	2	0	2	58.2573569617
320	112	11	0	11	59.6246895588
320	113	17	0	17	52.8071460064
320	116	6	0	6	46.6053931035
320	117	1	0	1	50.0008029522
320	119	2	0	2	40.0406284404
320	124	0	0	0	70.1085639863
320	131	1	0	1	77.4760617026
320	137	1	0	1	44.1302571306
320	140	1	0	1	54.9031818394
320	142	5	0	5	55.4844824307
320	144	1	0	1	48.4491124171
320	146	2	0	2	47.2159520329
320	155	34	3	31	32.9220324575
320	156	3	0	3	35.652329124
320	157	1	0	1	34.3814357819
320	159	8	1	7	24.1506075369
320	160	2	0	2	40.7898310032
320	162	1	0	1	33.0931225001
320	164	1	0	1	37.9390345712
320	166	60	45	15	25.9828475676
320	167	2	0	2	32.448690368
320	168	18	4	14	36.0052931867
320	169	4	0	4	40.1512669162
320	170	5	0	5	18.3948120184
320	171	11	1	10	35.7719022105
320	172	19	0	19	35.8020715948
320	173	3	2	1	22.5497048182
320	175	2	1	1	32.013226305
320	177	29	0	29	30.5324553265
320	178	1	0	1	38.6641361007
320	179	2	0	2	41.2233696474
320	183	1	0	1	131.173913815
320	264	1	0	1	82.0373405685
320	277	2	0	2	93.9200131075
320	294	1	0	1	75.5872441746
320	307	1	0	1	90.2019877258
320	310	3	0	3	59.4565656973
320	318	4	0	4	18.1561847177
320	319	2925	848	2077	6.7636884438
320	321	47	7	40	15.3384066765
320	322	72	34	38	4.4945924124
320	323	335	65	270	9.99738208404
320	324	34	0	34	14.2610268023
320	325	88	9	79	5.53621988813
320	326	16	4	12	22.7973699261
320	327	43	0	43	10.957815258
320	328	19	1	18	16.3808665767
320	329	61	12	49	24.8667487009
320	330	63	4	59	3.94909048707
320	331	22	1	21	15.4618147243
320	332	4	0	4	51.3419476833
320	333	2	0	2	52.1496190952
320	336	1	0	1	46.225943935
320	338	40	0	40	39.4851169393
320	341	1	0	1	52.0742475893
320	342	1	0	1	48.087369272
320	345	0	0	0	97.4188097705
320	347	2	0	2	36.275545534
320	349	60	0	60	27.2707999851
320	350	3	0	3	60.0250853721
320	352	1	0	1	48.6817434675
320	353	8	1	7	39.0731832497
320	355	15	6	9	18.2135816743
320	356	1	0	1	26.4169108291
320	357	8	4	4	24.5028147415
320	358	1	0	1	42.0567579159
320	359	3	0	3	29.1433889205
320	361	3	0	3	20.4135080293
320	363	1	0	1	48.9592501712
320	364	20	14	6	17.0533325576
320	365	0	0	0	29.9800508826
320	366	18	1	17	10.9242092822
320	367	7	3	4	20.5322173491
320	368	1	0	1	34.4488094131
320	373	0	0	0	69.436730109
320	375	5	0	5	82.509743777
320	377	1	0	1	67.0258710442
320	379	1	0	1	58.4932892663
320	385	0	0	0	51.1766907847
320	386	2	0	2	51.4128680519
320	391	1	0	1	55.4501335973
320	392	0	0	0	50.7586792056
320	396	2	0	2	76.4520436986
320	406	3	0	3	82.910421625
320	408	4	0	4	79.931563768
320	415	1	0	1	70.154316536
320	416	1	0	1	89.3790512493
320	441	1	0	1	92.5818819108
320	444	0	0	0	104.458576628
320	455	1	0	1	49.1043298725
320	462	1	0	1	57.9212967432
320	466	1	0	1	93.376183316
320	469	1	0	1	81.574592207
320	471	1	0	1	95.0895564972
320	475	1	0	1	66.4959961376
320	480	2	0	2	87.8486862635
320	493	1	0	1	109.872222395
320	507	1	0	1	121.241820686
320	509	0	0	0	128.121310357
320	512	4	0	4	97.887836477
320	515	2	0	2	93.1105303888
320	520	0	0	0	68.6351156434
320	524	14	0	14	61.9790413108
320	525	0	0	0	66.1549525793
320	530	1	0	1	76.9703850179
320	536	0	0	0	69.8686408023
320	549	2	0	2	107.393126818
320	551	2	0	2	22.1989170118
320	554	1	0	1	44.9132217441
320	555	2	0	2	34.09992649
320	560	1	0	1	25.5969664342
320	563	7	0	7	30.7437933807
320	566	5	1	4	39.2257727934
320	568	0	0	0	33.7040151071
320	569	16	0	16	17.0705400393
320	570	12	2	10	11.2556596067
320	572	14	0	14	13.3900599502
320	573	149	21	128	25.7976087374
320	575	1	0	1	21.8541227427
320	576	25	0	25	15.4881029116
320	577	103	6	97	8.87102145985
320	579	56	44	12	13.7020251805
320	580	4	1	3	25.1356544518
320	581	20	1	19	21.920642239
320	583	5	2	3	40.0648919283
320	585	45	0	45	17.7218620002
320	586	11	3	8	25.7726066611
320	587	6	1	5	15.7908263785
321	1	5	0	5	87.0871851533
321	23	1	0	1	85.1100550475
321	32	1	0	1	69.6289325277
321	35	1	0	1	73.6811495571
321	39	2	0	2	66.0453967503
321	42	1	0	1	64.7048743141
321	65	1	0	1	104.117660543
321	70	57	13	44	39.7951938994
321	71	12	0	12	38.1736661962
321	72	2	0	2	43.7473762354
321	73	280	88	192	44.6146616506
321	74	28	3	25	40.2706009345
321	75	28	0	28	44.3741844313
321	76	39	1	38	38.0152355378
321	77	2	0	2	44.7579248161
321	78	41	3	38	38.9874782584
321	79	7	0	7	45.5375545126
321	80	2	0	2	43.4530858274
321	81	16	1	15	42.5957944166
321	82	32	1	31	39.7047806623
321	83	2	0	2	42.4599950665
321	84	31	7	24	43.4241878923
321	85	40	4	36	35.3253292133
321	86	15	0	15	36.1094950918
321	87	27	6	21	42.2397315959
321	88	11	0	11	40.5278775608
321	89	2	0	2	49.161906426
321	90	8	0	8	31.0357366859
321	92	1	0	1	43.0225733401
321	95	5	0	5	52.5792299677
321	96	2	0	2	29.1735085416
321	103	6	0	6	48.3962256385
321	109	2	0	2	35.6854068696
321	112	16	0	16	51.3323489888
321	113	19	0	19	45.5332864009
321	116	10	2	8	35.7925149332
321	117	2	0	2	42.493561773
321	119	2	0	2	30.3480391958
321	120	2	0	2	48.6719344141
321	131	1	0	1	78.0298690495
321	140	1	0	1	49.120179082
321	142	3	1	2	52.3241228661
321	144	1	0	1	45.7060390566
321	146	3	0	3	40.92922603
321	155	58	12	46	22.3548039668
321	156	7	0	7	23.3899049894
321	158	3	0	3	23.2059059754
321	159	13	2	11	17.3343199538
321	162	5	2	3	19.8039618039
321	163	1	0	1	46.410549173
321	164	8	0	8	30.6122614615
321	166	199	3	196	13.8589330737
321	168	16	0	16	30.5419167349
321	169	6	3	3	26.4375022647
321	170	6	0	6	16.5223306546
321	171	25	3	22	26.7561486808
321	172	21	5	16	32.3984098837
321	173	2	1	1	23.8238342637
321	175	7	2	5	24.8484372714
321	177	31	0	31	27.0693326493
321	180	1	0	1	30.7486651188
321	183	1	0	1	116.273637497
321	207	1	0	1	84.8817179224
321	220	2	0	2	128.801631276
321	251	1	0	1	45.926446625
321	262	1	0	1	66.851888337
321	303	1	0	1	86.9770260276
321	310	2	0	2	44.2299230828
321	314	1	0	1	40.8997568141
321	318	62	34	28	3.94790481555
321	319	2134	478	1656	8.75649707266
321	320	75	4	71	15.3384066765
321	322	14	1	13	15.1794076658
321	323	131	12	119	14.1158329367
321	324	89	7	82	7.37452917575
321	325	30	1	29	19.2036230997
321	326	71	13	58	7.63916703596
321	327	59	4	55	10.9120444212
321	328	67	2	65	5.41189935004
321	329	113	27	86	10.0422680741
321	330	10	1	9	18.3112137896
321	331	20	5	15	9.771403261
321	332	8	0	8	38.6826910538
321	334	2	0	2	33.500068907
321	336	3	0	3	31.6608570984
321	338	59	12	47	26.2289115891
321	339	2	0	2	34.3783439782
321	341	2	0	2	38.2623733973
321	342	3	0	3	35.9654038254
321	344	1	0	1	29.8230856715
321	345	2	0	2	82.3521406001
321	347	7	0	7	21.2722463811
321	348	1	0	1	31.6724657161
321	349	203	0	203	13.0596789701
321	350	5	0	5	44.7117609451
321	351	3	1	2	17.0599197566
321	353	14	1	13	23.8042796998
321	354	4	0	4	15.2033409608
321	355	38	16	22	9.33814368536
321	356	6	1	5	27.6714248811
321	357	20	11	9	13.6042836866
321	358	1	0	1	48.0215229141
321	359	2	0	2	23.6159548134
321	360	2	0	2	34.1987335096
321	361	17	4	13	14.7587113437
321	362	1	0	1	19.7959346225
321	363	1	0	1	53.0018613635
321	364	31	1	30	16.6304449907
321	365	0	0	0	19.9754643782
321	366	17	0	17	16.9447446916
321	367	56	0	56	7.44252171521
321	368	1	0	1	35.9723418673
321	370	1	0	1	68.0362680932
321	375	4	0	4	67.8612073662
321	379	1	0	1	69.225834614
321	385	1	0	1	62.568181146
321	392	3	0	3	61.2152391734
321	396	2	0	2	85.5469332861
321	401	1	0	1	92.2034730794
321	408	5	2	3	90.0607468095
321	411	1	0	1	84.0669054108
321	415	4	0	4	79.7548558962
321	416	1	0	1	99.2024122072
321	427	1	0	1	104.668389699
321	438	0	0	0	108.023612329
321	441	0	0	0	104.565821206
321	444	0	0	0	114.877781818
321	469	1	0	1	85.3989443842
321	475	3	0	3	71.4771143129
321	507	1	0	1	136.454735027
321	524	3	0	3	76.9604891161
321	527	1	0	1	91.5868966715
321	528	1	0	1	95.9357352136
321	530	1	0	1	91.0780550543
321	536	1	0	1	84.6070091612
321	540	0	0	0	96.7032587635
321	552	2	1	1	60.5831559607
321	554	0	0	0	59.8602973006
321	564	0	0	0	46.2232916561
321	566	1	0	1	50.7641469847
321	569	3	0	3	29.6668253838
321	570	2	0	2	25.6469784012
321	571	0	0	0	50.7602403884
321	572	6	0	6	28.7051427499
321	573	65	11	54	37.6578754498
321	575	1	0	1	36.203795239
321	576	6	1	5	19.4628164238
321	577	24	0	24	20.014577705
321	578	2	0	2	46.5947811604
321	579	14	0	14	23.7262948583
321	581	27	1	26	27.5792460955
321	582	1	0	1	33.2883290803
321	583	1	0	1	49.3533256371
321	585	12	3	9	31.8736501714
321	586	6	0	6	38.0150638738
321	587	3	0	3	23.8531104552
322	20	1	0	1	91.4398699819
322	28	1	0	1	89.2817885898
322	60	1	0	1	84.5223367271
322	70	10	0	10	47.4025725791
322	71	2	0	2	42.4878254243
322	73	56	1	55	50.2622139619
322	74	5	0	5	45.6143707064
322	75	5	0	5	49.3177612238
322	76	10	1	9	45.0612064804
322	77	1	0	1	51.7240688689
322	78	10	1	9	44.7734796583
322	81	6	0	6	49.4999178952
322	82	8	0	8	46.19817957
322	83	4	1	3	48.299646584
322	84	4	0	4	48.878641449
322	85	5	0	5	41.6447901973
322	86	2	0	2	40.8152206318
322	87	6	1	5	46.7044125605
322	88	2	0	2	44.7253970113
322	92	2	0	2	51.5578244841
322	99	1	0	1	56.385563003
322	103	1	0	1	52.5880581095
322	112	6	0	6	55.7242170894
322	113	9	0	9	48.7873376963
322	116	2	1	1	43.3418566273
322	142	0	0	0	51.054271227
322	144	1	1	0	44.0144634207
322	155	9	2	7	29.8379855261
322	156	1	0	1	32.9975059569
322	157	1	0	1	29.8919996629
322	158	1	0	1	21.3958538702
322	164	1	0	1	34.0715477584
322	165	2	0	2	23.2160957823
322	166	12	0	12	23.6116821766
322	167	1	0	1	28.0838007885
322	168	2	0	2	31.8945748393
322	169	1	0	1	37.9855022976
322	170	2	1	1	14.3164492467
322	171	7	3	4	32.2573913355
322	172	5	0	5	31.4756604037
322	173	1	0	1	18.070802759
322	177	5	0	5	26.2721447392
322	183	1	0	1	129.456244151
322	229	1	0	1	114.201159691
322	230	4	0	4	122.1725766
322	242	2	0	2	151.132132473
322	277	1	0	1	91.6926976922
322	307	2	0	2	86.8811259621
322	314	1	0	1	56.0789587423
322	318	2	1	1	18.63065089
322	319	699	171	528	8.08999410358
322	320	135	96	39	4.4945924124
322	321	14	3	11	15.1794076658
322	323	105	69	36	5.80480721761
322	324	6	1	5	16.2289664889
322	325	13	5	8	9.76056224556
322	326	7	5	2	22.8163880088
322	327	10	0	10	14.021251446
322	328	5	0	5	14.67831735
322	329	9	0	9	23.7254742716
322	330	26	1	25	3.90653620738
322	331	3	0	3	12.5244225583
322	334	1	0	1	47.0792818118
322	338	9	0	9	40.7730397492
322	341	0	0	0	53.1421570481
322	344	1	0	1	42.6730435665
322	349	13	3	10	27.9801097569
322	353	3	0	3	38.8445167287
322	355	1	0	1	20.2210438317
322	357	3	0	3	26.3521975736
322	358	2	0	2	46.5455238463
322	361	1	0	1	23.3202577364
322	364	2	0	2	20.7418825832
322	366	1	0	1	15.1833373821
322	367	5	1	4	21.5324901002
322	368	1	0	1	38.7605248388
322	369	1	0	1	77.6902222704
322	371	0	0	0	93.2690272196
322	375	0	0	0	83.031898831
322	385	5	0	5	48.6018986205
322	386	1	0	1	49.1959553422
322	391	1	0	1	52.2995164529
322	399	1	0	1	83.6088076345
322	401	1	0	1	78.6034676312
322	408	4	0	4	76.9838906065
322	417	2	0	2	65.7912584666
322	455	0	0	0	45.24789124
322	460	1	0	1	58.4850582215
322	469	1	0	1	77.3591259049
322	480	1	0	1	83.5139067516
322	524	3	0	3	61.8789294248
322	540	0	0	0	82.678410656
322	541	1	0	1	99.7262016787
322	554	1	0	1	44.7821627555
322	563	1	0	1	30.4593723343
322	567	1	0	1	32.295636563
322	568	2	0	2	29.8274891963
322	569	15	0	15	14.8014771992
322	570	3	0	3	10.5509328799
322	571	0	0	0	35.9157201994
322	572	1	0	1	15.1936223445
322	573	45	7	38	23.2528404788
322	575	1	0	1	21.0289923073
322	576	11	5	6	10.9949705422
322	577	56	26	30	5.40104939887
322	579	24	6	18	10.059103267
322	580	2	0	2	21.4192598537
322	581	6	1	5	17.6001670772
322	585	10	2	8	20.964350894
322	586	0	0	0	29.6368842423
322	587	3	0	3	20.2853153041
323	1	2	0	2	86.2626183746
323	3	1	0	1	68.5457928755
323	36	1	0	1	60.641603843
323	70	28	2	26	41.8791575186
323	71	1	0	1	36.7090959039
323	72	1	0	1	45.4947164019
323	73	189	0	189	44.5302724474
323	74	20	4	16	39.8785344083
323	75	21	2	19	43.5490254489
323	76	11	0	11	39.483197423
323	78	30	0	30	39.0728387684
323	79	1	0	1	46.577367424
323	80	2	0	2	44.5554241347
323	81	12	3	9	43.8793112197
323	82	23	1	22	40.5529725629
323	83	9	3	6	42.5879902752
323	84	22	5	17	43.1386541727
323	85	25	0	25	36.0110404468
323	86	6	2	4	35.0603541197
323	87	18	3	15	40.9216537171
323	88	9	1	8	38.9374969399
323	89	1	0	1	52.0810903742
323	90	2	0	2	33.8116311195
323	95	1	0	1	52.2507299878
323	96	5	1	4	34.1701358935
323	101	1	0	1	52.6814261736
323	103	5	0	5	46.7898564354
323	107	2	0	2	31.6978691649
323	109	4	0	4	39.4097696408
323	112	9	3	6	49.9275446575
323	113	11	0	11	42.9826341755
323	116	4	0	4	37.8422868232
323	117	1	0	1	40.2319856425
323	118	1	0	1	34.170997868
323	122	1	0	1	44.984718782
323	142	4	1	3	45.566293833
323	146	1	0	1	37.3053420754
323	154	3	0	3	35.9362298551
323	155	31	3	28	24.5378699388
323	156	3	0	3	28.0523477248
323	157	2	0	2	24.758513987
323	158	18	2	16	15.6736659624
323	159	12	3	9	14.9692979029
323	160	1	0	1	30.9823040806
323	162	2	0	2	26.4096440744
323	163	3	0	3	35.187166733
323	164	4	0	4	28.2878466095
323	165	7	1	6	17.8173528208
323	166	80	29	51	19.1222183968
323	167	6	1	5	24.1572041137
323	168	27	0	27	26.0971639334
323	169	7	6	1	33.4685553035
323	170	39	28	11	8.51182024313
323	171	21	0	21	26.6315763908
323	172	56	8	48	25.8073807787
323	173	2	0	2	12.9115053094
323	175	4	0	4	22.4778174811
323	177	62	2	60	20.5391408189
323	180	7	0	7	19.6009870067
323	247	2	0	2	55.429870648
323	255	0	0	0	72.7573448424
323	272	1	0	1	91.2472956702
323	277	3	0	3	86.9085300434
323	303	1	0	1	87.7572009949
323	310	1	0	1	56.7591348296
323	313	1	0	1	49.2148073048
323	318	8	4	4	18.0167674785
323	319	1468	609	859	10.3777358408
323	320	140	106	34	9.99738208404
323	321	29	0	29	14.1158329367
323	322	35	0	35	5.80480721761
323	324	14	4	10	17.7335273054
323	325	17	2	15	15.4684548092
323	326	12	0	12	21.3163545479
323	327	8	0	8	17.0720002557
323	328	12	3	9	11.5870906184
323	329	29	14	15	20.7040919164
323	330	20	2	18	9.44393376103
323	331	36	13	23	7.92529005856
323	332	1	0	1	52.7971318821
323	335	1	0	1	58.7275804097
323	336	2	0	2	45.3382881051
323	338	22	0	22	40.3410877464
323	339	1	0	1	48.4941642396
323	341	1	0	1	52.250694139
323	346	1	0	1	117.309351445
323	347	1	0	1	31.5448296255
323	348	1	0	1	41.7853137833
323	349	35	8	27	27.1262644712
323	352	1	0	1	44.7953490345
323	353	2	0	2	36.5135208105
323	354	2	0	2	26.8210590007
323	355	7	0	7	21.4551641166
323	356	2	0	2	34.8235186933
323	357	5	0	5	27.0614715817
323	358	1	0	1	51.8537625958
323	361	6	0	6	25.5904761448
323	364	4	0	4	24.2344251879
323	366	7	1	6	19.7880939742
323	367	5	0	5	21.3779917297
323	368	1	0	1	43.1574017239
323	373	1	0	1	69.159145406
323	375	1	0	1	81.2456920277
323	385	3	0	3	48.4672083188
323	392	1	0	1	47.1118059843
323	399	1	0	1	81.6843928858
323	406	5	0	5	78.4353574046
323	408	8	1	7	76.0215761322
323	409	1	0	1	82.06496207
323	411	3	1	2	69.9741133505
323	415	1	0	1	65.7818418779
323	433	1	0	1	106.549350879
323	441	1	0	1	90.4802793295
323	442	2	0	2	94.491906116
323	453	1	0	1	64.0636212238
323	457	2	0	2	62.8159421981
323	461	1	0	1	37.271805925
323	471	1	0	1	86.1684195759
323	475	1	0	1	59.077115606
323	494	1	0	1	68.5904577489
323	506	1	0	1	95.0465052684
323	507	3	0	3	127.116333153
323	512	1	0	1	101.47484285
323	517	1	0	1	97.6799869718
323	519	1	0	1	87.0405170881
323	524	7	2	5	64.8798239581
323	535	1	0	1	95.1357338725
323	536	0	0	0	77.1553340758
323	537	0	0	0	75.9924776052
323	554	0	0	0	47.8874109594
323	555	3	0	3	38.9290793605
323	557	0	0	0	45.6809647587
323	561	0	0	0	57.8279712165
323	563	2	0	2	33.629475234
323	565	1	0	1	75.66977922
323	566	5	0	5	36.7027299537
323	568	1	0	1	27.4452285533
323	569	10	2	8	16.3624167883
323	570	5	0	5	14.4241694943
323	572	6	0	6	20.418312216
323	573	157	12	145	23.7707886171
323	575	3	0	3	23.9384344714
323	576	71	25	46	6.33790904792
323	577	215	25	190	7.27656011664
323	579	85	26	59	9.82612679783
323	580	5	0	5	19.7343444782
323	581	65	8	57	14.192046075
323	583	3	0	3	50.0536887937
323	585	7	0	7	26.6802617378
323	586	5	1	4	35.4415947931
323	587	3	1	2	25.5413661092
323	588	1	0	1	48.4960103241
324	1	1	0	1	94.3781514458
324	36	1	0	1	69.6966618327
324	62	1	0	1	122.469120572
324	70	28	0	28	46.9426374314
324	71	7	1	6	45.5480909796
324	72	3	0	3	50.9069721458
324	73	93	1	92	51.9344179446
324	74	12	0	12	47.6186348888
324	75	14	2	12	51.7295634247
324	76	21	0	21	45.2449479925
324	78	16	1	15	46.316895458
324	79	1	0	1	52.7644369593
324	80	1	0	1	50.6847993576
324	81	8	0	8	49.8143114137
324	82	15	0	15	46.9795607405
324	83	5	1	4	49.7741068186
324	84	18	2	16	50.7586267012
324	85	9	0	9	42.6355941658
324	86	6	0	6	43.4821867588
324	87	7	0	7	49.6105146123
324	88	2	1	1	47.9022096254
324	89	1	0	1	56.1101489321
324	90	2	1	1	38.1864053431
324	92	3	0	3	49.9882638003
324	95	2	0	2	59.8918372823
324	98	1	0	1	40.3754794076
324	103	7	0	7	55.7666416296
324	110	3	0	3	58.5002433053
324	112	7	0	7	58.6957882948
324	113	14	1	13	52.9026272541
324	116	2	0	2	42.9784961246
324	119	1	0	1	37.6870010233
324	137	1	0	1	47.213230029
324	142	1	0	1	59.3582431775
324	150	1	1	0	68.5476205486
324	154	1	0	1	51.5760745511
324	155	23	0	23	29.6731399895
324	156	2	0	2	30.4067834806
324	158	2	0	2	29.7338774333
324	159	7	0	7	24.4738932866
324	162	4	2	2	26.5456007215
324	163	0	0	0	52.1757595864
324	165	1	0	1	33.3086709139
324	166	54	0	54	21.1053421281
324	168	6	1	5	37.7255402518
324	169	6	1	5	32.7945453274
324	171	7	0	7	34.1294681079
324	172	15	0	15	39.3090056494
324	173	0	0	0	29.4160245905
324	175	3	0	3	32.1470545865
324	177	10	1	9	33.9013821436
324	212	1	0	1	83.5694511181
324	229	1	0	1	102.393142966
324	262	1	0	1	72.6419701621
324	281	0	0	0	75.3038169109
324	307	1	0	1	85.5676955573
324	310	0	0	0	46.6129884795
324	311	1	0	1	46.9294305741
324	312	1	0	1	45.707989914
324	317	0	0	0	59.447400222
324	318	37	2	35	6.59843812461
324	319	1323	382	941	8.13898601296
324	320	60	53	7	14.2610268023
324	321	89	21	68	7.37452917575
324	322	11	0	11	16.2289664889
324	323	65	0	65	17.7335273054
324	325	15	6	9	16.0613122077
324	326	32	0	32	11.2607604616
324	327	100	5	95	4.92224385712
324	328	13	0	13	12.575135585
324	329	45	12	33	16.181939878
324	330	3	0	3	18.0703728547
324	331	9	2	7	16.1213465339
324	332	4	1	3	37.08214965
324	334	0	0	0	30.9381670387
324	335	1	0	1	43.2130414107
324	336	1	0	1	32.5338058072
324	338	29	0	29	25.2939427083
324	341	3	0	3	37.9484331102
324	342	2	0	2	33.8581831017
324	344	2	0	2	26.445768397
324	345	1	0	1	84.0292336746
324	347	1	0	1	26.4701869364
324	349	82	10	72	13.8277915678
324	353	5	0	5	26.728126725
324	355	61	16	45	4.00375545803
324	356	5	0	5	20.3003244039
324	357	27	0	27	10.2535019285
324	358	2	0	2	40.7592035318
324	359	4	0	4	17.3613337089
324	360	1	0	1	27.009689476
324	361	24	2	22	8.05963077281
324	363	2	0	2	45.6287655367
324	364	22	7	15	9.2772682583
324	365	2	0	2	16.0071939856
324	366	11	4	7	11.0323489084
324	367	44	0	44	7.11635014311
324	368	2	0	2	28.6243171677
324	375	6	0	6	68.6867618663
324	379	2	0	2	71.9004115342
324	385	1	0	1	64.8303143526
324	392	1	0	1	64.0084597393
324	394	1	0	1	77.3344825135
324	408	6	1	5	93.1298071074
324	411	3	0	3	86.863333571
324	415	1	0	1	83.0725022836
324	453	1	0	1	81.5249529173
324	505	1	0	1	114.151812166
324	512	1	0	1	111.353130773
324	515	1	0	1	107.080438916
324	536	1	0	1	80.3860615899
324	540	0	0	0	93.6821281567
324	551	1	0	1	36.0153887248
324	555	4	0	4	47.4837918962
324	566	1	0	1	52.8786892931
324	569	1	0	1	30.905672292
324	570	2	0	2	25.5107267172
324	573	37	0	37	39.4657903705
324	576	3	0	3	23.9031639723
324	577	8	1	7	21.6210964988
324	579	6	0	6	26.1066297719
324	581	8	0	8	31.9173238032
324	583	0	0	0	42.623935341
324	585	4	1	3	27.8295586626
324	586	3	0	3	32.5410068503
324	587	1	0	1	17.5955921682
325	1	3	0	3	101.510547037
325	13	1	0	1	86.5384503109
325	29	1	0	1	106.001135308
325	33	0	0	0	83.2348579791
325	70	14	0	14	56.0660379195
325	71	4	0	4	51.8463254025
325	73	113	3	110	59.4364735517
325	74	19	1	18	54.8130259077
325	75	7	1	6	58.6217446718
325	76	10	1	9	53.8581091517
325	78	17	0	17	53.8722356664
325	79	1	0	1	61.1823415847
325	80	1	0	1	59.1188092578
325	81	4	0	4	58.3756975479
325	82	19	4	15	55.1477015723
325	83	5	0	5	57.4180887899
325	84	11	0	11	58.0819408642
325	85	7	0	7	50.587841904
325	86	4	1	3	50.089058236
325	87	23	1	22	56.0725813863
325	88	3	1	2	54.121826769
325	90	2	0	2	47.5784944724
325	92	3	0	3	59.9667362038
325	98	1	0	1	46.3111924693
325	102	1	0	1	75.856540446
325	103	3	0	3	62.0364548807
325	109	2	0	2	52.8670202437
325	110	1	0	1	63.8390292105
325	111	1	0	1	63.431159473
325	112	3	1	2	65.158137797
325	113	6	0	6	58.3419808198
325	117	1	0	1	55.5370221793
325	119	1	0	1	45.4865633011
325	142	2	0	2	60.7873257206
325	148	1	0	1	73.8299776535
325	155	9	0	9	38.2518616269
325	156	1	0	1	40.7716052995
325	157	1	0	1	39.4947086027
325	158	3	0	3	31.1313038756
325	159	1	1	0	29.652379709
325	165	1	0	1	32.944770889
325	166	24	1	23	31.0163021058
325	169	3	0	3	44.9632252062
325	171	5	0	5	41.2429933539
325	172	6	1	5	41.2317973585
325	175	1	0	1	37.5401434586
325	177	13	1	12	36.0026959239
325	203	1	0	1	140.883903681
325	237	1	0	1	103.227223184
325	252	1	0	1	79.5491078611
325	309	1	0	1	90.2760605556
325	310	1	0	1	62.5129420953
325	317	1	0	1	75.4185873572
325	318	1	0	1	21.3065643856
325	319	1519	137	1382	10.5224592889
325	320	234	0	234	5.53621988813
325	321	19	0	19	19.2036230997
325	322	16	11	5	9.76056224556
325	323	82	28	54	15.4684548092
325	324	21	0	21	16.0613122077
325	326	6	0	6	26.171721388
325	327	35	6	29	11.5628339331
325	328	10	2	8	21.2212258341
325	329	14	3	11	29.1380847128
325	330	23	6	17	7.26192108462
325	331	3	0	3	20.8447631765
325	332	2	0	2	52.4075894747
325	333	2	0	2	52.7459372523
325	338	24	3	21	41.1093735393
325	339	1	0	1	48.5077358042
325	341	2	0	2	53.8145776429
325	347	1	0	1	40.4665382892
325	349	19	4	15	29.8201629953
325	351	1	0	1	34.7655164449
325	352	1	0	1	52.369375277
325	353	1	0	1	42.3453733538
325	355	8	1	7	19.6224783327
325	356	2	0	2	23.1813210511
325	357	4	0	4	25.790042053
325	358	9	0	9	37.0560090765
325	359	5	1	4	28.0665349693
325	360	1	0	1	24.0034444247
325	361	5	0	5	20.3140289151
325	364	11	2	9	15.6189743551
325	365	1	0	1	30.5186524191
325	366	35	1	34	8.394236916
325	367	8	1	7	23.0213177594
325	368	1	0	1	30.7256881052
325	375	1	0	1	84.7116541958
325	385	1	0	1	52.4438463491
325	406	1	0	1	84.8532226472
325	408	8	0	8	81.5767253461
325	415	4	0	4	72.1208094657
325	417	1	0	1	70.3623086112
325	442	1	0	1	98.4098836623
325	469	1	0	1	85.476404684
325	496	0	0	0	76.7109503176
325	524	4	1	3	59.990990565
325	529	1	0	1	75.09777866
325	531	1	0	1	54.124251172
325	535	1	1	0	84.9866134936
325	551	1	0	1	20.2869144336
325	554	3	0	3	43.120776999
325	555	2	0	2	31.4543684692
325	561	1	0	1	50.2983337318
325	563	2	1	1	29.4122525042
325	566	1	0	1	40.6340557297
325	569	5	0	5	18.8616199633
325	570	13	0	13	11.992657916
325	572	21	0	21	10.5318408963
325	573	75	0	75	27.4786320682
325	576	9	0	9	20.620782099
325	577	41	9	32	12.8258249374
325	579	17	0	17	17.3678781533
325	581	10	0	10	26.3451302395
325	582	3	0	3	19.7702820603
325	583	14	1	13	34.5960100209
325	584	1	0	1	25.6747334566
325	585	44	11	33	12.7507331572
325	586	18	0	18	20.2798095385
325	587	18	9	9	11.1606145884
326	1	1	0	1	85.2771322122
326	23	1	0	1	84.1819648138
326	32	1	0	1	66.9549264548
326	35	1	0	1	73.4022261952
326	63	1	0	1	104.251734035
326	70	53	11	42	37.517724483
326	71	13	0	13	37.9396984415
326	72	3	0	3	41.4749429991
326	73	201	0	201	43.3094708468
326	74	15	0	15	39.3368036495
326	75	24	3	21	43.4827295353
326	76	44	1	43	36.1766885394
326	77	5	3	2	42.6669326795
326	78	31	5	26	37.8606292303
326	79	4	1	3	43.5806077956
326	81	12	0	12	40.6286017415
326	82	28	3	25	38.118366525
326	83	10	0	10	41.1338284517
326	84	23	4	19	42.2802764886
326	85	20	2	18	34.0893588503
326	86	7	0	7	35.7770726147
326	87	20	9	11	41.7124295544
326	88	5	1	4	40.2329718191
326	90	13	1	12	28.9316528858
326	92	1	0	1	40.0227077483
326	95	2	0	2	51.1235181262
326	96	10	0	10	25.9032269178
326	97	1	0	1	29.2160456743
326	101	1	0	1	42.7174162901
326	103	6	2	4	47.7704211338
326	107	2	0	2	37.2426384947
326	109	10	2	8	32.705429712
326	110	7	1	6	50.9950060183
326	111	3	0	3	42.0031381626
326	112	10	4	6	50.4977362414
326	113	23	2	21	45.5277071259
326	116	2	1	1	33.7601273706
326	118	2	0	2	31.4516042483
326	119	3	0	3	29.5219000561
326	120	0	0	0	46.5592347774
326	131	2	0	2	81.3149413491
326	155	65	0	65	21.6285484355
326	156	13	4	9	20.9620905686
326	157	1	0	1	38.5275103801
326	158	1	0	1	27.2774512034
326	159	7	0	7	20.1339853884
326	162	8	0	8	16.6315513144
326	163	1	0	1	51.0927668681
326	164	2	0	2	31.3862256402
326	166	233	0	233	13.2898469235
326	168	13	0	13	32.4202282924
326	169	31	6	25	22.1327624898
326	170	3	0	3	21.8064483775
326	171	26	1	25	26.7382545262
326	172	15	0	15	35.2092741472
326	173	2	0	2	29.2401522458
326	175	4	0	4	26.2744834733
326	177	12	1	11	30.2813693505
326	179	3	0	3	21.2182190971
326	183	6	0	6	109.713438445
326	245	1	0	1	51.5925371405
326	251	2	0	2	40.4956974764
326	258	1	0	1	65.3823720143
326	277	3	0	3	73.9951334713
326	281	1	0	1	64.0550465797
326	294	2	0	2	52.8493993515
326	303	1	0	1	84.324914447
326	307	1	0	1	75.2172263465
326	310	5	1	4	36.6638480687
326	311	1	0	1	39.1073171721
326	312	1	0	1	39.0739432447
326	314	0	0	0	33.2664855105
326	317	1	0	1	49.6853026264
326	318	61	0	61	4.90255974
326	319	302	61	241	16.0693870376
326	320	8	0	8	22.7973699261
326	321	22	11	11	7.63916703596
326	322	1	0	1	22.8163880088
326	323	29	0	29	21.3163545479
326	324	16	0	16	11.2607604616
326	325	1	0	1	26.171721388
326	327	4	1	3	16.0834890503
326	328	6	1	5	10.3715679333
326	329	390	38	352	6.30515460932
326	330	1	0	1	25.9172807361
326	331	4	0	4	15.3384977029
326	332	6	0	6	31.9298574427
326	333	2	0	2	34.069995847
326	334	12	2	10	27.4593009407
326	336	0	0	0	24.0959317382
326	337	2	1	1	24.6423692323
326	338	106	16	90	19.3958741319
326	339	3	0	3	27.5799725001
326	340	1	1	0	39.4754378401
326	341	9	7	2	30.9530282478
326	342	2	0	2	29.5567864072
326	343	1	0	1	39.6678169755
326	344	2	0	2	24.5665757479
326	347	27	1	26	15.2381760035
326	348	3	0	3	25.2155870089
326	349	1054	10	1044	6.19381065863
326	350	4	0	4	37.5735050434
326	351	21	13	8	9.46526288127
326	353	39	10	29	16.2811527451
326	354	15	6	9	8.74725771271
326	355	26	0	26	10.1786258147
326	356	1	0	1	29.425581821
326	357	45	0	45	10.3733817008
326	358	2	0	2	50.708577211
326	359	6	2	4	22.2348703322
326	360	0	0	0	37.3427691395
326	361	8	0	8	15.3149231289
326	363	0	0	0	54.6197276703
326	364	10	6	4	19.5168687885
326	365	7	1	6	16.0584797731
326	366	2	0	2	22.2746179597
326	367	162	47	115	5.1325431089
326	368	0	0	0	37.1425883273
326	369	1	0	1	55.0744929633
326	373	2	0	2	47.8636868566
326	375	11	1	10	60.2412502961
326	377	1	1	0	44.5977060279
326	385	2	0	2	69.716672313
326	399	1	0	1	101.404660355
326	402	0	0	0	94.9566283626
326	406	1	0	1	98.8618234966
326	408	3	0	3	96.7735864709
326	409	1	0	1	102.227472181
326	411	1	0	1	90.9312969353
326	413	0	0	0	101.064808374
326	415	2	0	2	86.3564477409
326	438	1	0	1	115.298405424
326	466	1	0	1	102.97698982
326	475	1	0	1	76.623426754
326	493	0	0	0	119.977164953
326	507	1	0	1	143.558633872
326	524	2	0	2	84.5814082454
326	554	1	0	1	67.4826042667
326	555	1	0	1	56.8967832654
326	561	0	0	0	75.9722690654
326	563	2	0	2	53.192337963
326	566	1	0	1	58.0061051007
326	569	2	0	2	37.2158502519
326	573	27	3	24	45.0509957177
326	575	1	0	1	43.8426102435
326	576	3	1	2	26.0364345318
326	577	3	0	3	27.5762325489
326	579	4	0	4	31.0892205256
326	581	4	0	4	33.9777931011
326	583	2	0	2	53.5295081554
326	585	7	1	6	38.5751975461
326	587	1	0	1	28.835388652
327	1	1	0	1	97.7501809444
327	36	1	0	1	72.7711831186
327	70	15	6	9	50.652387548
327	71	3	0	3	48.4826588338
327	72	1	0	1	54.594005651
327	73	114	3	111	55.2485058511
327	74	9	1	8	50.8187345603
327	75	11	2	9	54.8777120484
327	76	11	0	11	48.8090531572
327	78	13	0	13	49.6049725589
327	79	1	0	1	56.3256422141
327	81	2	0	2	53.3956386293
327	82	20	1	19	50.4378892139
327	83	2	1	1	53.1118530137
327	84	8	0	8	54.016840035
327	85	11	0	11	46.0004328195
327	86	4	0	4	46.4830665883
327	87	5	0	5	52.6253558277
327	88	2	0	2	50.8359507899
327	90	3	0	3	41.8995593516
327	92	2	0	2	53.9324604761
327	96	1	0	1	40.0733268424
327	103	1	0	1	58.7719673743
327	109	1	0	1	46.5972202582
327	112	5	0	5	61.7708068659
327	113	9	0	9	55.6591973824
327	116	2	0	2	46.6281949663
327	119	1	1	0	40.9587811825
327	142	1	0	1	61.0189689318
327	146	1	0	1	50.696821702
327	155	13	1	12	33.0534081633
327	156	1	0	1	34.2994645788
327	158	1	0	1	30.9426614557
327	159	2	0	2	26.6898993616
327	162	1	0	1	30.6783901857
327	164	3	1	2	40.5787856861
327	166	27	0	27	24.6995556676
327	168	3	1	2	39.8421780294
327	169	2	0	2	37.1719803621
327	170	1	0	1	23.4552664612
327	171	2	0	2	37.1584572054
327	172	7	0	7	40.8929195744
327	177	15	0	15	35.4344743427
327	208	1	0	1	91.269401659
327	310	1	0	1	51.4582313622
327	314	1	0	1	46.8932908782
327	318	9	0	9	11.2760962155
327	319	1262	78	1184	6.70172555933
327	320	59	0	59	10.957815258
327	321	35	9	26	10.9120444212
327	322	6	0	6	14.021251446
327	323	35	0	35	17.0720002557
327	324	35	0	35	4.92224385712
327	325	24	0	24	11.5628339331
327	326	5	0	5	16.0834890503
327	328	2	2	0	15.3162401544
327	329	14	1	13	20.5713880408
327	330	7	0	7	14.9068080004
327	331	2	1	1	17.7182686631
327	332	1	0	1	40.9299907967
327	334	3	0	3	34.4317903468
327	336	1	0	1	37.182560285
327	338	36	9	27	29.5472996343
327	341	1	0	1	42.2536080093
327	347	0	0	0	31.2120527713
327	349	27	4	23	18.6667506987
327	351	2	1	1	23.7673149153
327	353	3	1	2	31.6445832268
327	355	11	0	11	8.08639192836
327	356	5	0	5	18.1915004611
327	357	10	0	10	14.2288528845
327	358	2	0	2	37.457855564
327	359	5	1	4	18.3795407022
327	360	1	0	1	23.5573427197
327	361	20	16	4	9.45780284498
327	364	51	3	48	7.20708058207
327	365	1	0	1	19.2066115886
327	366	17	14	3	6.22231457498
327	367	11	3	8	12.0244593138
327	368	1	0	1	26.6356500577
327	373	1	0	1	59.6620438213
327	375	3	0	3	73.1984136077
327	385	3	1	2	62.1280589138
327	404	1	0	1	86.6831944234
327	406	1	0	1	93.6998994836
327	408	4	1	3	90.8104595463
327	411	4	0	4	84.3901682287
327	441	0	0	0	103.517585271
327	444	1	0	1	115.380380289
327	524	3	0	3	71.5498773193
327	536	0	0	0	75.4647542627
327	537	1	0	1	78.9117110487
327	540	1	0	1	88.8682681307
327	551	0	0	0	31.7913301835
327	552	1	0	1	51.9877314889
327	554	0	0	0	54.6517889725
327	555	2	0	2	42.9969084128
327	563	1	0	1	40.8081784953
327	566	1	0	1	50.173420286
327	569	1	0	1	28.0234051812
327	572	2	0	2	22.0931284312
327	573	50	1	49	36.73819209
327	577	9	0	9	19.3226007626
327	579	8	0	8	24.0728028243
327	580	1	0	1	35.4330222715
327	581	4	0	4	31.0493935501
327	585	5	0	5	22.9488285734
327	586	2	0	2	27.7044955469
327	587	8	3	5	13.0144405844
328	1	3	0	3	82.4499737717
328	18	1	0	1	64.5684799212
328	36	1	0	1	57.4635687522
328	38	1	0	1	62.3505703628
328	60	1	0	1	80.4751416455
328	70	79	2	77	35.5984219221
328	71	23	6	17	33.1955400392
328	72	3	0	3	39.5031883527
328	73	392	123	269	39.9500135318
328	74	42	10	32	35.5046417521
328	75	33	4	29	39.5615245357
328	76	34	2	32	33.6373350267
328	77	1	0	1	40.4198071833
328	78	75	5	70	34.3046586505
328	79	6	0	6	41.1325648218
328	80	2	0	2	39.0443875729
328	81	29	2	27	38.2229597505
328	82	71	16	55	35.1976795161
328	83	8	0	8	37.8210379608
328	84	38	0	38	38.708347485
328	85	54	0	54	30.727316006
328	86	17	0	17	31.1791512625
328	87	34	5	29	37.3219179938
328	88	17	4	13	35.5506754681
328	89	2	0	2	45.2907983844
328	90	4	0	4	26.901334728
328	92	4	0	4	39.1569907417
328	96	10	0	10	25.7328499988
328	98	2	0	2	27.919219026
328	100	1	0	1	54.5113207061
328	102	1	0	1	55.7414538855
328	103	6	2	4	43.4729547511
328	104	1	0	1	49.9647760813
328	107	2	0	2	30.5651338466
328	108	1	0	1	30.4688812881
328	109	2	0	2	31.9186365112
328	110	5	0	5	46.0539531638
328	112	11	2	9	46.4608690682
328	113	28	2	26	40.4476376445
328	116	3	0	3	31.5350802809
328	118	3	1	2	28.3708708601
328	119	3	0	3	25.6638626007
328	120	1	0	1	44.3104467904
328	129	1	0	1	53.3749178391
328	142	7	4	3	46.9177999819
328	146	3	0	3	35.6869292778
328	155	146	3	143	17.8315058656
328	156	19	7	12	19.6759364545
328	157	3	0	3	29.1251418692
328	158	5	2	3	17.9137069793
328	159	18	2	16	11.9399059871
328	160	1	0	1	33.8976003727
328	162	9	1	8	16.7617427579
328	163	1	0	1	41.3744428595
328	164	11	0	11	25.429726384
328	166	489	478	11	9.87433715664
328	168	27	2	25	25.1731400861
328	169	6	1	5	23.7856285567
328	170	11	0	11	11.6272821517
328	171	51	18	33	21.8451358736
328	172	51	5	46	26.988690817
328	173	1	0	1	19.0594592161
328	175	7	0	7	19.5809162053
328	177	35	1	34	21.6720931351
328	179	1	0	1	24.9291611586
328	180	1	0	1	25.8567682211
328	183	1	0	1	114.908842723
328	229	1	0	1	99.6572450233
328	245	1	0	1	52.7346125153
328	305	1	0	1	72.9128855227
328	307	1	0	1	74.8868277776
328	310	1	0	1	45.1845527297
328	313	1	1	0	37.6277221722
328	314	1	0	1	42.7071846763
328	318	9	2	7	8.75696585294
328	319	1138	164	974	10.9912541353
328	320	43	1	42	16.3808665767
328	321	75	6	69	5.41189935004
328	322	5	0	5	14.67831735
328	323	74	0	74	11.5870906184
328	324	11	4	7	12.575135585
328	325	5	1	4	21.2212258341
328	326	11	0	11	10.3715679333
328	327	20	12	8	15.3162401544
328	329	58	18	40	9.18250953801
328	330	2	1	1	18.3957007151
328	331	42	10	32	4.98351814955
328	336	1	0	1	33.9707246556
328	338	37	1	36	29.7667791425
328	341	2	0	2	41.16611929
328	346	1	0	1	105.722326094
328	347	9	0	9	20.3560075271
328	349	64	1	63	16.5247957298
328	351	4	0	4	19.4695125143
328	353	11	2	9	24.9296129833
328	355	10	1	9	14.7448403942
328	356	1	0	1	32.8195235022
328	357	7	0	7	18.5937497684
328	358	0	0	0	52.7636998277
328	359	1	0	1	29.0055729515
328	361	2	0	2	20.1640258801
328	364	6	0	6	21.6755080484
328	366	10	1	9	20.8671584176
328	367	10	1	9	12.2315028919
328	375	3	0	3	69.7038657058
328	377	1	0	1	53.980027017
328	385	4	0	4	59.5651406043
328	391	1	0	1	61.5167905595
328	396	1	0	1	81.6006231687
328	405	1	0	1	92.7273610727
328	408	7	0	7	86.418102627
328	411	3	0	3	80.6131136287
328	441	0	0	0	101.589395916
328	524	8	0	8	76.2269939368
328	536	1	0	1	86.244659603
328	540	0	0	0	97.3317651176
328	553	2	0	2	79.9867662248
328	554	0	0	0	59.1704487429
328	555	1	1	0	49.5272203575
328	558	1	0	1	63.7102898085
328	561	1	0	1	68.5960290621
328	566	2	0	2	47.9625448234
328	567	1	0	1	45.9766915441
328	569	2	0	2	27.9235617032
328	570	1	0	1	25.1074669827
328	572	2	1	1	29.5301590259
328	573	59	1	58	35.271553056
328	576	11	2	9	15.7155653192
328	577	14	0	14	18.5295469988
328	579	8	5	3	21.3848801118
328	580	1	0	1	30.3520294054
328	581	13	0	13	23.6085815912
328	583	1	0	1	53.4124785053
328	585	5	0	5	33.9287021788
328	587	4	0	4	27.7664566809
328	588	1	0	1	54.0267977909
329	1	1	0	1	79.0672344023
329	23	2	0	2	77.8848135392
329	59	1	0	1	98.5639259216
329	70	67	10	57	31.3326857036
329	71	16	0	16	31.6711078763
329	72	3	0	3	35.2988842876
329	73	198	0	198	37.0162751641
329	74	24	0	24	33.0316612663
329	75	15	1	14	37.1775850565
329	76	26	0	26	29.9204392073
329	77	2	1	1	36.4605390998
329	78	40	7	33	31.5570550368
329	79	1	0	1	37.354632999
329	80	2	0	2	35.3107427317
329	81	12	4	8	34.3986582802
329	82	35	1	34	31.8396004399
329	83	6	0	6	34.8400314943
329	84	23	5	18	35.9791734205
329	85	40	5	35	27.7864894992
329	86	12	4	8	29.5039066044
329	87	28	2	26	35.4167454434
329	88	6	0	6	33.9545584465
329	89	2	1	1	40.1091947808
329	90	9	1	8	22.6899570148
329	92	1	0	1	34.0262500577
329	93	0	0	0	29.9295457441
329	94	1	0	1	28.4725140323
329	95	1	0	1	44.847748773
329	96	3	0	3	19.9298771105
329	103	3	0	3	41.4677020843
329	109	1	0	1	26.6755146586
329	110	2	0	2	44.7162745759
329	111	1	0	1	36.3132442906
329	112	7	2	5	44.1927169333
329	113	19	3	16	39.2681022335
329	116	7	1	6	27.5235880508
329	117	2	0	2	36.208081624
329	118	3	0	3	25.1523889495
329	119	5	0	5	23.22602488
329	120	1	0	1	40.3637680675
329	122	1	0	1	30.3314450896
329	123	1	0	1	40.949482138
329	128	2	0	2	47.4148902157
329	140	1	0	1	43.7079742355
329	142	1	0	1	48.529739924
329	147	1	0	1	56.1345339028
329	154	2	0	2	43.5326895659
329	155	115	21	94	15.375556721
329	156	12	1	11	14.7284964647
329	158	9	3	6	22.8884503231
329	159	7	1	6	15.2923445181
329	160	1	0	1	37.3633031537
329	161	1	0	1	40.2640190574
329	162	13	4	9	10.5244694613
329	163	1	0	1	46.6714190648
329	164	8	0	8	25.329088477
329	165	1	0	1	27.3235056476
329	166	526	270	256	7.3240720522
329	167	1	0	1	38.412799291
329	168	12	1	11	26.7051167433
329	169	26	11	15	16.6235029747
329	170	6	0	6	18.7198894875
329	171	68	7	61	20.5508221225
329	172	27	4	23	29.8595927526
329	173	1	0	1	25.8738617355
329	175	5	0	5	20.4985233982
329	177	35	7	28	25.2461667943
329	179	1	0	1	16.6316139005
329	180	1	1	0	32.0358584764
329	183	3	0	3	106.367498386
329	208	1	0	1	75.7625986326
329	247	0	0	0	36.1212508765
329	264	1	0	1	59.9395702352
329	277	3	1	2	69.6854232233
329	281	0	0	0	59.7616370183
329	303	1	0	1	78.292257652
329	307	1	0	1	69.4578400905
329	309	2	0	2	65.211946821
329	310	0	0	0	36.0689777439
329	318	17	0	17	9.65932869897
329	319	112	0	112	18.6184745762
329	320	5	2	3	24.8667487009
329	321	6	1	5	10.0422680741
329	322	1	0	1	23.7254742716
329	323	10	1	9	20.7040919164
329	324	3	0	3	16.181939878
329	326	91	14	77	6.30515460932
329	327	3	0	3	20.5713880408
329	328	8	0	8	9.18250953801
329	331	1	0	1	13.2828584915
329	332	2	0	2	35.4445280731
329	333	1	0	1	38.1346451563
329	334	1	0	1	31.9347940422
329	336	1	0	1	25.6956031892
329	338	45	18	27	23.1683550776
329	339	1	0	1	31.1231018007
329	340	2	0	2	43.1373166025
329	341	8	0	8	33.3673466002
329	342	1	0	1	33.5873605754
329	344	2	0	2	29.7357023239
329	347	12	4	8	11.4091423265
329	348	1	0	1	21.8739723088
329	349	171	68	103	11.1902521409
329	350	1	0	1	35.4290648086
329	351	6	3	3	11.9686926198
329	353	11	1	10	16.002090653
329	354	9	3	6	6.12658444497
329	355	3	1	2	16.0504438349
329	356	1	0	1	35.4461609566
329	357	13	0	13	16.6348614563
329	358	1	0	1	56.5636465479
329	361	5	0	5	21.4219621288
329	364	2	0	2	25.1126586738
329	365	0	0	0	22.0508124486
329	367	15	7	8	11.2602370254
329	368	0	0	0	43.3080064119
329	373	0	0	0	49.4607319838
329	377	1	0	1	45.1354579221
329	381	1	0	1	77.4051380447
329	384	1	0	1	59.5409118834
329	385	1	0	1	68.0455598665
329	387	1	0	1	73.8852833847
329	394	1	0	1	79.5596313785
329	396	1	0	1	89.0019469816
329	408	0	0	0	94.2022591407
329	410	1	0	1	89.702125518
329	415	1	0	1	83.6540951482
329	437	1	0	1	135.173761906
329	460	0	0	0	72.6738509158
329	466	2	0	2	98.4305560522
329	496	0	0	0	81.1651597262
329	524	3	0	3	85.4063188224
329	551	0	0	0	46.3870446727
329	554	0	0	0	68.3444895352
329	563	1	0	1	54.0229229238
329	565	1	0	1	90.4564810109
329	569	1	0	1	37.0652240786
329	573	25	1	24	44.2082700485
329	576	4	0	4	24.1250241119
329	577	4	0	4	27.7116796949
329	581	4	0	4	31.5363035724
329	585	1	0	1	41.8581830656
330	1	1	0	1	95.6063657891
330	39	1	0	1	75.9570889203
330	70	14	1	13	51.2463933273
330	71	5	0	5	46.1225433734
330	73	72	0	72	53.9720453347
330	74	7	0	7	49.319678765
330	75	5	0	5	52.972046361
330	76	6	0	6	48.8827207177
330	78	11	1	10	48.5163027228
330	79	1	0	1	56.0116298912
330	81	4	1	3	53.3005239102
330	82	10	0	10	49.9835692057
330	83	2	0	2	52.0319203208
330	84	5	0	5	52.5784072431
330	85	5	2	3	45.4366799167
330	86	3	0	3	44.4948188951
330	87	8	0	8	50.3280095945
330	88	2	0	2	48.3352060781
330	89	1	0	1	61.4142890812
330	96	1	0	1	43.0621962033
330	100	2	0	2	68.4142948932
330	103	1	0	1	56.1551274762
330	111	1	0	1	59.287794574
330	112	2	0	2	59.297876026
330	113	7	0	7	52.2742816064
330	116	3	0	3	47.192820438
330	141	0	0	0	51.8441596677
330	146	2	0	2	46.501590255
330	149	1	0	1	60.4996098115
330	154	0	0	0	43.3717298507
330	155	8	1	7	33.7267721154
330	156	1	0	1	36.9030887347
330	158	2	0	2	24.6716028492
330	159	1	0	1	24.3727171245
330	160	0	0	0	39.014159006
330	164	1	0	1	37.6974378483
330	165	2	0	2	26.0709137222
330	166	9	0	9	27.4922147571
330	167	3	0	3	29.6238612613
330	168	6	0	6	35.3283603175
330	170	3	0	3	17.8816721127
330	171	5	0	5	36.0518467184
330	172	7	3	4	34.6088099338
330	175	1	0	1	31.9166867392
330	177	15	0	15	29.5410967984
330	183	2	0	2	133.267002397
330	257	1	0	1	77.2607899582
330	307	1	0	1	90.7033212727
330	310	1	0	1	62.5396554442
330	319	785	212	573	10.2304356339
330	320	200	58	142	3.94909048707
330	321	11	3	8	18.3112137896
330	322	53	11	42	3.90653620738
330	323	82	30	52	9.44393376103
330	324	8	0	8	18.0703728547
330	325	24	7	17	7.26192108462
330	326	6	1	5	25.9172807361
330	327	14	0	14	14.9068080004
330	328	2	0	2	18.3957007151
330	329	8	0	8	27.3174619934
330	331	2	1	1	16.430471975
330	334	1	0	1	48.9781271804
330	338	11	1	10	43.1768669773
330	341	1	0	1	55.7053617927
330	344	1	0	1	44.3361547673
330	345	1	0	1	100.644659182
330	347	1	0	1	38.6783882723
330	349	15	1	14	30.7263330483
330	350	1	0	1	62.7046415633
330	353	2	0	2	42.1097984052
330	355	9	0	9	22.0520013928
330	356	2	0	2	29.8308073795
330	357	3	0	3	28.323858948
330	359	1	0	1	33.0579671548
330	360	2	0	2	31.2524237652
330	361	1	1	0	24.3625546187
330	364	7	1	6	20.8824389957
330	366	4	1	3	14.4099181841
330	367	1	0	1	24.0755506554
330	375	1	0	1	85.9451274656
330	379	1	0	1	54.5598633981
330	385	4	1	3	47.2294738773
330	391	1	0	1	51.5768877918
330	403	1	0	1	90.6193770056
330	406	3	0	3	79.0271799136
330	408	3	0	3	76.0122597707
330	411	0	0	0	69.5355451076
330	417	1	0	1	64.7905155744
330	441	0	0	0	88.6445100764
330	507	2	0	2	118.940619453
330	512	0	0	0	94.7990813351
330	524	2	0	2	58.6669503827
330	549	1	0	1	105.20577694
330	551	1	0	1	19.1271692583
330	552	1	0	1	43.7894122133
330	554	2	0	2	41.5704772236
330	555	0	0	0	31.2397470361
330	568	1	0	1	30.2125708972
330	569	12	2	10	13.1238091044
330	570	8	3	5	7.50468738101
330	572	11	1	10	11.2931895187
330	573	74	0	74	21.8565585769
330	575	1	0	1	18.1632533946
330	576	10	5	5	13.6700770641
330	577	170	36	134	5.57830478581
330	579	65	0	65	10.2496204044
330	580	1	0	1	21.5694493197
330	581	23	0	23	19.083808693
330	582	1	0	1	26.9621211062
330	583	2	0	2	41.3821463743
330	585	14	9	5	17.2463420925
330	586	6	0	6	26.2208420003
330	587	4	0	4	18.3813382236
330	588	0	0	0	39.1973572793
331	1	2	0	2	81.0429995248
331	32	0	0	0	64.7535303348
331	70	23	9	14	35.2318059193
331	71	9	0	9	31.3996349193
331	72	2	0	2	39.0060884382
331	73	141	39	102	38.7288444805
331	74	7	1	6	34.1422283837
331	75	16	0	16	38.0526367377
331	76	14	4	10	33.0137089356
331	78	32	2	30	33.1245811803
331	79	4	0	4	40.3563903723
331	80	3	1	2	38.2877346196
331	81	6	0	6	37.53669503
331	82	21	0	21	34.3271937406
331	83	4	1	3	36.6741913809
331	84	21	0	21	37.4036653925
331	85	18	0	18	29.7714910124
331	86	7	0	7	29.52826161
331	87	27	0	27	35.6119844683
331	88	4	0	4	33.7248495163
331	89	1	0	1	45.270968635
331	90	3	0	3	26.8173659643
331	92	1	0	1	39.2188591917
331	95	1	0	1	46.6328600945
331	96	1	0	1	26.6318419241
331	99	2	0	2	46.6542033251
331	100	0	0	0	53.326801074
331	103	5	0	5	41.6884166924
331	104	1	0	1	49.0857503118
331	107	1	0	1	27.7249594993
331	112	3	0	3	44.7645589789
331	113	16	3	13	38.2973985374
331	116	4	1	3	31.1473544011
331	117	1	0	1	35.3645003391
331	118	1	0	1	27.6633986578
331	119	1	0	1	24.6626807439
331	142	4	0	4	43.3864446829
331	148	0	0	0	55.9626665682
331	154	2	0	2	35.4978562766
331	155	59	11	48	17.4667831387
331	156	12	3	9	20.4733651057
331	157	3	0	3	24.6264981844
331	158	7	1	6	13.6198305217
331	159	36	5	31	9.16388788715
331	160	1	0	1	29.7976726051
331	162	4	0	4	18.5370646418
331	164	6	1	5	23.2063796381
331	165	3	1	2	17.3588994932
331	166	188	72	116	11.2374471549
331	168	26	4	22	22.1442826703
331	169	7	0	7	25.6221928125
331	170	12	1	11	6.76238123465
331	171	51	1	50	20.4729106452
331	172	31	1	30	23.2747532288
331	173	1	0	1	14.1411457135
331	175	9	1	8	17.2066443206
331	177	36	0	36	17.834344957
331	180	2	0	2	21.0114134122
331	277	1	0	1	79.2217950696
331	310	0	0	0	49.2797680685
331	319	667	120	547	11.9221578701
331	320	28	0	28	15.4618147243
331	321	20	6	14	9.771403261
331	322	4	2	2	12.5244225583
331	323	68	2	66	7.92529005856
331	324	11	4	7	16.1213465339
331	325	7	0	7	20.8447631765
331	326	6	1	5	15.3384977029
331	327	9	2	7	17.7182686631
331	328	20	12	8	4.98351814955
331	329	22	5	17	13.2828584915
331	330	0	0	0	16.430471975
331	338	18	4	14	34.7329523604
331	341	2	0	2	46.0103186846
331	345	0	0	0	87.587198034
331	347	1	0	1	23.7297938085
331	349	23	0	23	21.5044004484
331	350	1	0	1	48.0227046005
331	351	1	0	1	24.2943374555
331	352	1	0	1	37.0691951595
331	353	4	0	4	29.279485631
331	355	2	0	2	18.9247063886
331	356	1	0	1	35.8196481468
331	357	3	1	2	23.3237081855
331	358	1	0	1	54.8798556653
331	359	1	0	1	33.2001382007
331	361	2	0	2	24.0817441622
331	363	0	0	0	60.6888581912
331	364	4	1	3	24.6550804984
331	366	1	0	1	22.4314420171
331	367	4	0	4	17.0244155196
331	375	0	0	0	74.1391929595
331	379	1	0	1	61.0905141072
331	385	2	0	2	54.8617665248
331	392	1	0	1	53.0459232082
331	396	1	0	1	76.6336443649
331	397	1	0	1	73.4028823809
331	408	3	0	3	81.5006284335
331	441	0	0	0	96.8608559033
331	466	1	0	1	88.3978015129
331	475	1	0	1	61.7917430543
331	493	0	0	0	105.337416925
331	507	1	0	1	134.948830506
331	524	1	0	1	72.7423362601
331	540	0	0	0	94.8088475579
331	551	0	0	0	34.6172775467
331	553	1	0	1	78.7091366396
331	554	1	0	1	55.779441518
331	555	2	0	2	46.8084635416
331	563	0	0	0	41.5418030443
331	566	2	0	2	43.3681388142
331	569	1	0	1	24.0975898899
331	572	1	0	1	27.7149331061
331	573	33	2	31	30.9496055049
331	575	1	0	1	31.8437479924
331	576	7	1	6	10.9171842469
331	577	8	1	7	15.1998160842
331	578	1	0	1	38.2105107436
331	579	7	2	5	17.2936643524
331	581	12	0	12	18.6741802194
331	585	8	1	7	33.1366794842
331	586	1	0	1	41.1053656708
332	1	2	0	2	100.63542735
332	36	1	0	1	81.0897904061
332	70	39	26	13	56.657537984
332	71	7	0	7	62.0197033008
332	73	161	12	149	64.1032517316
332	74	20	1	19	61.6454883075
332	75	17	2	15	65.3079324663
332	76	79	14	65	56.7788202173
332	77	2	0	2	61.3867301523
332	78	28	0	28	59.9398197186
332	79	2	0	2	62.5389559433
332	80	1	0	1	60.9885036143
332	81	8	1	7	60.0540613592
332	82	29	11	18	59.0109194049
332	83	7	0	7	62.1975644702
332	84	22	0	22	63.6385212404
332	85	15	1	14	56.5727050783
332	86	8	0	8	59.9577297241
332	87	15	2	13	64.6421739701
332	88	3	0	3	63.8779947659
332	89	1	0	1	60.9230694259
332	90	5	1	4	50.5141032405
332	92	3	0	3	56.4384837531
332	95	1	0	1	70.4777367668
332	96	11	1	10	45.4183250631
332	98	1	0	1	59.1104257915
332	103	5	0	5	69.733690738
332	109	3	0	3	50.9368740856
332	110	3	0	3	73.8308953163
332	111	1	0	1	55.2274943244
332	112	6	0	6	71.626631978
332	113	14	0	14	69.2006666057
332	116	3	0	3	54.3619120471
332	119	2	0	2	53.7742291014
332	142	1	0	1	81.5270714211
332	146	1	0	1	67.3908251989
332	147	1	0	1	91.2676906931
332	154	1	0	1	78.4146319577
332	155	10	0	10	47.8496621074
332	156	3	2	1	44.292734964
332	158	1	0	1	58.3325186627
332	159	1	0	1	50.6981702035
332	160	1	0	1	72.2088897041
332	166	17	4	13	42.1461798377
332	168	1	1	0	60.8107136908
332	169	12	0	12	40.2391365095
332	171	6	1	5	53.0008991179
332	172	8	1	7	64.612846545
332	175	1	0	1	54.7304558775
332	177	7	3	4	60.4358230491
332	180	1	0	1	67.4130957711
332	183	1	0	1	99.242955848
332	207	1	0	1	59.7033380923
332	208	1	0	1	56.093346993
332	245	0	0	0	60.6168479853
332	251	1	0	1	46.6831169386
332	277	2	0	2	72.1826947029
332	310	24	0	24	23.6824405242
332	311	5	4	1	14.0999063196
332	312	34	13	21	9.89508166086
332	313	6	2	4	20.0378471889
332	314	4	0	4	16.0621230746
332	315	1	0	1	33.4077036423
332	316	2	0	2	36.622356956
332	317	1	0	1	31.679901772
332	318	3	0	3	34.7896455857
332	319	113	0	113	45.0094289704
332	320	4	0	4	51.3419476833
332	323	1	0	1	52.7971318821
332	324	3	0	3	37.08214965
332	326	11	0	11	31.9298574427
332	327	4	0	4	40.9299907967
332	328	2	1	1	42.3011267542
332	329	28	1	27	35.4445280731
332	330	1	0	1	55.1376820534
332	333	120	65	55	4.50904682212
332	334	100	26	74	7.41145824261
332	335	16	3	13	6.15853542168
332	336	5	0	5	13.075306929
332	338	831	234	597	12.534670066
332	339	97	39	58	4.35410531669
332	340	21	14	7	7.71061471574
332	341	385	332	53	6.6887832872
332	342	113	19	94	3.94599856064
332	343	9	5	4	9.94264259745
332	344	11	1	10	12.8824526533
332	345	3	0	3	51.8057844709
332	347	8	2	6	32.0988120958
332	348	3	1	2	32.278601342
332	349	64	0	64	25.8068801724
332	350	13	3	10	31.8326294304
332	351	4	0	4	23.4758359739
332	353	56	10	46	22.9059137324
332	354	3	0	3	30.8216973056
332	355	3	1	2	33.1397856333
332	356	2	0	2	39.3700349223
332	357	13	1	12	26.8444450385
332	359	3	0	3	27.6843352804
332	360	1	0	1	48.6402156804
332	361	1	0	1	32.3607979286
332	364	2	0	2	38.0389121171
332	367	7	2	5	31.5389190878
332	369	1	0	1	27.6441277792
332	373	12	3	9	20.1899778385
332	375	40	2	38	34.7720446138
332	376	1	0	1	30.7111519232
332	377	7	0	7	22.4504340875
332	385	2	0	2	101.212324351
332	387	1	0	1	106.463065341
332	408	0	0	0	128.658243726
332	417	1	0	1	117.645760092
332	419	1	0	1	135.894751394
332	438	1	0	1	146.510155062
332	441	1	0	1	143.164050648
332	460	1	0	1	107.837357152
332	507	2	0	2	165.169149824
332	517	1	0	1	139.889124887
332	524	5	0	5	112.311826291
332	530	1	0	1	114.697118761
332	555	2	0	2	83.5556968671
332	566	1	0	1	89.355835756
332	573	10	0	10	76.0988311213
332	579	3	1	2	62.2879179891
332	581	1	0	1	65.9018694214
332	585	5	1	4	62.1121079705
333	29	0	0	0	119.940441942
333	47	1	0	1	133.516708954
333	48	1	0	1	120.854619799
333	50	1	0	1	113.207829903
333	70	33	1	32	60.728571656
333	71	3	0	3	65.7611402947
333	73	113	26	87	68.1245871018
333	74	8	1	7	65.5364807144
333	75	14	0	14	69.2630169727
333	76	53	1	52	60.7546379589
333	77	1	0	1	65.520556167
333	78	11	0	11	63.834922439
333	79	1	0	1	66.6667522675
333	81	7	0	7	64.1356282875
333	82	24	7	17	62.986412588
333	83	3	0	3	66.1864020848
333	84	15	0	15	67.6166718112
333	85	4	0	4	60.4044608318
333	86	2	0	2	63.6725816803
333	87	9	0	9	68.5049329541
333	88	2	0	2	67.6733800746
333	89	3	0	3	65.2417910245
333	90	2	0	2	54.3464504038
333	92	1	0	1	60.6587613699
333	96	9	2	7	49.3225754888
333	103	1	0	1	73.7055848189
333	107	1	0	1	67.8096383836
333	109	1	0	1	55.0045983985
333	111	2	0	2	59.5750860423
333	112	5	0	5	75.6692978942
333	113	12	1	11	73.0287188625
333	116	4	0	4	58.3134220213
333	142	2	0	2	85.031957532
333	154	1	0	1	81.4634511833
333	155	10	0	10	51.2104347681
333	163	0	0	0	84.7927921638
333	164	1	0	1	61.6389449073
333	165	1	0	1	65.3635909833
333	166	14	0	14	45.0703920101
333	168	6	0	6	64.0291151115
333	169	6	0	6	44.1310101559
333	171	4	0	4	56.4281215371
333	172	3	1	2	67.6797670012
333	177	6	0	6	63.3226180555
333	182	1	0	1	111.242593038
333	191	1	1	0	98.5129648648
333	215	1	0	1	48.5342788667
333	229	0	0	0	76.5389654891
333	245	1	0	1	65.0960578175
333	252	1	0	1	60.7913762295
333	277	1	0	1	76.5390328704
333	310	16	0	16	28.0471476268
333	311	6	0	6	17.5780342778
333	312	26	3	23	12.476570776
333	313	1	0	1	24.5433947915
333	314	3	0	3	20.4469475535
333	316	2	0	2	40.9166664491
333	318	2	0	2	36.4348657411
333	319	58	6	52	46.0590560693
333	320	1	0	1	52.1496190952
333	321	4	0	4	40.3767616584
333	323	2	0	2	54.4145515975
333	324	2	0	2	37.9805903101
333	326	9	0	9	34.069995847
333	328	1	0	1	44.3753079442
333	329	27	12	15	38.1346451563
333	331	2	0	2	49.3588259437
333	332	252	65	187	4.50904682212
333	334	99	33	66	7.0442225078
333	335	30	21	9	7.48957980388
333	336	3	0	3	17.3365152185
333	337	1	0	1	22.1819454018
333	338	640	274	366	14.9692792815
333	339	61	17	44	7.56456700896
333	340	52	46	6	6.07644856817
333	341	221	29	192	11.1531641761
333	342	104	55	49	4.54815281126
333	343	27	17	10	5.954872645
333	344	13	1	12	12.0944855422
333	345	6	1	5	54.2348555818
333	347	8	0	8	35.7756897978
333	348	2	0	2	36.5731208602
333	349	46	0	46	27.8771030163
333	350	12	0	12	36.3118781247
333	351	3	0	3	26.2499021549
333	353	27	0	27	26.6797745796
333	355	3	0	3	33.9819578312
333	356	0	0	0	37.8733926387
333	357	8	0	8	27.7620368827
333	359	2	0	2	26.6199409621
333	360	1	0	1	46.890257944
333	361	1	0	1	32.460667276
333	364	1	0	1	37.8330971766
333	365	0	0	0	22.2555976869
333	367	9	3	6	33.0367418037
333	371	2	0	2	48.5597389469
333	372	1	0	1	44.9655114393
333	373	15	0	15	22.3477268936
333	374	1	0	1	37.4128078037
333	375	35	2	33	36.9761875677
333	377	10	0	10	25.8948955271
333	386	1	0	1	103.302838361
333	391	0	0	0	105.52582679
333	408	4	0	4	130.427773801
333	414	1	0	1	139.862608388
333	415	1	0	1	120.130957479
333	426	1	0	1	167.282339106
333	492	1	0	1	146.455703137
333	507	1	0	1	163.805376525
333	513	1	0	1	137.121027658
333	524	5	0	5	112.358249583
333	536	1	0	1	110.013062439
333	537	0	0	0	117.547302165
333	555	2	0	2	83.5244522638
333	573	12	9	3	77.351458199
333	577	1	0	1	59.4473700308
333	579	3	0	3	63.6940237588
333	581	5	0	5	67.8642990547
333	582	1	0	1	51.6438488995
333	583	0	0	0	62.8518728827
333	585	1	0	1	61.7671636503
334	1	1	0	1	102.222049788
334	29	1	0	1	116.055637944
334	36	2	0	2	81.3898657208
334	41	1	0	1	87.6803163041
334	56	1	0	1	117.084294834
334	70	42	5	37	56.6422293167
334	71	7	0	7	60.8456430896
334	72	1	0	1	60.1243462903
334	73	165	4	161	63.8550355004
334	74	13	0	13	60.9484372125
334	75	22	8	14	64.8133465338
334	76	77	9	68	56.4038210035
334	78	37	9	28	59.2655185017
334	79	1	0	1	62.7204220868
334	81	23	2	21	60.0600301377
334	82	30	1	29	58.6214621368
334	83	6	3	3	61.8390429019
334	84	28	1	27	63.234066053
334	85	13	5	8	55.7090073072
334	86	5	0	5	58.714137828
334	87	13	0	13	63.8370922808
334	88	3	0	3	62.8609133911
334	89	2	0	2	62.0420935874
334	90	4	0	4	49.6926912688
334	92	5	3	2	57.0703405279
334	95	2	0	2	70.7178009495
334	96	6	2	4	44.8791736762
334	103	9	2	7	69.2794915769
334	104	1	0	1	70.3688015769
334	109	1	0	1	50.949216063
334	110	2	0	2	73.1970619438
334	112	9	1	8	71.4258154882
334	113	12	1	11	68.2641023394
334	116	1	0	1	53.9157249048
334	118	2	0	2	53.0965758619
334	142	2	0	2	79.6236491072
334	146	1	0	1	65.8325194812
334	155	19	1	18	45.7173111961
334	156	1	0	1	42.7695634739
334	160	1	0	1	69.2645033216
334	162	1	0	1	38.4519538896
334	164	3	0	3	56.1645067497
334	166	24	3	21	39.0568794333
334	168	6	1	5	58.26955251
334	169	18	1	17	39.7133167475
334	171	7	0	7	51.0038039017
334	172	4	0	4	61.7202880024
334	175	2	0	2	52.0777543797
334	177	5	0	5	57.1804725323
334	179	1	0	1	35.7516361607
334	183	2	0	2	105.602084719
334	205	1	0	1	52.8504879591
334	214	1	0	1	57.1491089904
334	277	2	0	2	76.9644041463
334	281	1	0	1	67.807654041
334	293	0	0	0	54.8503457988
334	294	1	0	1	44.5966543975
334	297	1	0	1	50.1242679327
334	310	19	2	17	28.8767097561
334	311	3	2	1	21.1415835475
334	312	14	2	12	17.3033146323
334	313	5	0	5	23.6288405739
334	314	10	0	10	21.4207390204
334	318	1	0	1	29.5524293756
334	319	103	14	89	39.0229130145
334	320	3	1	2	45.1064314942
334	321	6	0	6	33.500068907
334	322	1	0	1	47.0792818118
334	323	2	0	2	47.482915313
334	326	14	0	14	27.4593009407
334	327	2	0	2	34.4317903468
334	328	1	0	1	37.6671531003
334	329	35	3	32	31.9347940422
334	332	140	27	113	7.41145824261
334	333	40	11	29	7.0442225078
334	335	4	0	4	13.2563568598
334	336	11	2	9	15.0824586139
334	337	2	0	2	20.1505561358
334	338	1383	868	515	9.22738018043
334	339	115	71	44	5.67204608098
334	340	9	4	5	13.0563822021
334	341	191	6	185	12.3961413742
334	342	138	98	40	3.47522069599
334	343	6	1	5	12.2348594897
334	344	57	0	57	5.48643456109
334	345	2	0	2	59.1547259632
334	346	1	0	1	78.6014818186
334	347	21	0	21	31.008019681
334	348	3	0	3	33.5729538156
334	349	76	0	76	21.2818556622
334	350	8	4	4	36.0736437644
334	351	6	0	6	20.3223690259
334	353	45	1	44	22.3566103881
334	354	2	0	2	28.2759933102
334	355	2	1	1	26.9387036673
334	356	0	0	0	31.9585796526
334	357	11	1	10	20.7279926373
334	359	5	0	5	20.3016203041
334	361	2	0	2	25.5133549715
334	364	4	0	4	31.0061423299
334	365	3	3	0	15.2464511399
334	366	1	0	1	38.0789621245
334	367	10	0	10	26.1138788434
334	369	2	0	2	35.0502715379
334	371	1	0	1	53.6893003672
334	372	1	0	1	49.7871833636
334	373	7	0	7	27.6011876521
334	375	32	0	32	42.1720229314
334	377	4	0	4	29.3894672497
334	378	0	0	0	47.18859903
334	379	3	0	3	102.510099988
334	385	1	0	1	95.6142887811
334	406	1	0	1	125.857480511
334	408	7	0	7	123.504447897
334	413	2	0	2	126.8736582
334	415	1	0	1	113.240878263
334	417	1	0	1	112.407307272
334	419	1	0	1	130.411493902
334	433	1	0	1	152.832612223
334	453	2	0	2	111.421874741
334	464	1	0	1	121.142544533
334	476	1	0	1	111.403145045
334	480	1	0	1	121.152182063
334	505	1	0	1	141.72936685
334	518	1	0	1	145.567566352
334	520	1	0	1	113.682439666
334	524	2	0	2	105.476487537
334	537	1	0	1	111.004023111
334	551	1	0	1	66.0315775392
334	554	1	0	1	88.7904983778
334	555	1	0	1	76.6632314909
334	569	1	0	1	61.8296502523
334	573	24	5	19	70.3266899566
334	576	0	0	0	52.9520600724
334	577	2	0	2	52.4254121038
334	578	1	0	1	80.0409809473
334	579	2	0	2	56.6995859073
334	581	0	0	0	61.0480625909
334	585	3	0	3	55.0294766817
334	586	2	0	2	55.5838112697
334	587	1	0	1	41.3027855332
335	21	1	0	1	107.721815426
335	70	13	1	12	59.8557785106
335	71	1	0	1	65.9343886952
335	73	61	18	43	67.3962750215
335	74	3	0	3	65.2580112821
335	75	4	1	3	68.7588368772
335	76	14	1	13	60.2204722258
335	78	2	0	2	63.5512028336
335	79	1	0	1	65.5450381391
335	80	1	0	1	64.1180741396
335	81	5	1	4	63.2053193095
335	82	13	1	12	62.4417399258
335	83	2	0	2	65.5806411833
335	84	11	0	11	67.0412676764
335	85	6	0	6	60.3353204069
335	86	1	0	1	63.9308428922
335	87	4	0	4	68.3028790056
335	88	4	0	4	67.6804952395
335	90	2	0	2	54.3103397388
335	95	1	0	1	73.381491881
335	96	3	0	3	49.0988949772
335	98	3	0	3	63.3793695398
335	107	1	0	1	68.8215235253
335	109	1	0	1	54.1793358383
335	113	4	0	4	72.9167717656
335	116	1	0	1	57.8747583715
335	142	1	0	1	85.7857776608
335	155	3	0	3	52.4418966594
335	156	2	0	2	48.584818235
335	166	10	0	10	47.2729005782
335	168	4	0	4	65.5278430478
335	169	4	1	3	43.9924274015
335	172	4	1	3	69.4960996512
335	176	0	0	0	92.7019340469
335	177	1	0	1	65.5210997803
335	229	1	0	1	69.1148400738
335	271	2	0	2	73.9102751212
335	276	1	0	1	54.880871251
335	277	1	0	1	71.03257348
335	310	12	0	12	23.0245389414
335	311	8	1	7	10.8960285953
335	312	44	0	44	5.22233020334
335	314	5	1	4	15.8552475501
335	317	2	1	1	28.5650984701
335	319	24	1	23	51.1091150606
335	320	1	0	1	57.4740640048
335	323	1	0	1	58.7275804097
335	326	3	1	2	37.6900052045
335	329	7	4	3	40.821569799
335	332	131	3	128	6.15853542168
335	333	54	24	30	7.48957980388
335	334	20	12	8	13.2563568598
335	336	5	1	4	16.5899020938
335	337	2	0	2	20.4904189521
335	338	268	73	195	18.3865123343
335	339	21	3	18	10.2720217254
335	340	75	2	73	4.5135215325
335	341	103	0	103	8.42084187898
335	342	21	0	21	9.82803236699
335	343	11	6	5	9.40949516352
335	345	2	1	1	46.7452958855
335	347	3	0	3	36.3552864738
335	348	2	0	2	34.9765126126
335	349	12	2	10	31.6418392748
335	352	2	0	2	29.3503352424
335	353	13	0	13	27.1623857083
335	357	1	0	1	32.985182767
335	361	1	0	1	38.4999846357
335	365	1	0	1	28.150170887
335	367	3	0	3	37.5580530135
335	369	1	0	1	22.0727641172
335	370	1	0	1	35.1780002159
335	372	2	0	2	37.4792899226
335	373	11	0	11	14.8596874011
335	375	18	10	8	29.4947743319
335	377	5	0	5	18.9361408599
335	379	0	0	0	113.808162171
335	408	1	0	1	134.463562823
335	459	0	0	0	117.837286376
335	461	0	0	0	94.8624400237
335	524	1	0	1	118.463419311
335	573	8	5	3	82.1271018431
335	576	1	0	1	63.7224774557
335	581	1	0	1	71.6560117014
336	0	1	0	1	75.4740835222
336	1	4	0	4	87.7808733558
336	5	1	0	1	96.8352768873
336	36	2	1	1	68.0158670592
336	70	20	3	17	43.6308973171
336	71	4	0	4	49.366067665
336	72	1	0	1	46.8047104774
336	73	182	2	180	51.1092027625
336	74	14	0	14	48.7881330848
336	75	10	2	8	52.3740607697
336	76	17	0	17	43.8340504048
336	78	25	1	24	47.080493185
336	79	1	0	1	49.4788776695
336	81	5	0	5	47.0186565074
336	82	29	1	28	46.0636077655
336	83	7	0	7	49.2337991646
336	84	25	0	25	50.683505339
336	85	14	1	13	43.803454902
336	86	6	0	6	47.35169909
336	87	7	1	6	51.8144115479
336	88	5	0	5	51.141070734
336	92	1	0	1	43.3643786991
336	93	1	1	0	26.04868983
336	96	3	0	3	32.5846242447
336	103	5	0	5	56.7791688329
336	109	1	0	1	37.9168548894
336	110	1	0	1	60.9197067316
336	111	2	0	2	42.2491189121
336	112	3	0	3	58.6118772335
336	113	3	0	3	56.4093649029
336	116	4	1	3	41.446817869
336	120	1	0	1	51.516313431
336	142	2	0	2	69.2000893546
336	146	2	0	2	54.9178991004
336	154	1	0	1	66.9759622598
336	155	7	0	7	36.003637367
336	156	1	0	1	32.0239560768
336	157	1	0	1	58.5551288914
336	159	1	0	1	40.3167078156
336	164	3	0	3	46.1728444313
336	166	14	0	14	31.4741425678
336	168	4	1	3	49.1357813754
336	169	11	0	11	27.4464697117
336	171	2	0	2	40.9589141618
336	172	3	0	3	53.2323133232
336	175	1	0	1	43.2484279658
336	177	8	0	8	49.5074366555
336	179	1	0	1	22.9381073871
336	211	1	0	1	60.472458854
336	242	1	0	1	107.530664872
336	245	1	1	0	48.1252702134
336	262	1	0	1	52.2375518335
336	277	1	0	1	62.3194299532
336	310	53	4	49	15.600498689
336	311	8	0	8	15.0487675503
336	312	2	0	2	16.0207825983
336	313	25	18	7	8.87747608398
336	314	24	1	23	9.74511760298
336	315	1	0	1	25.9997894583
336	316	1	0	1	28.0740705045
336	317	1	0	1	27.4929479084
336	319	71	14	57	39.4925225895
336	320	6	0	6	46.225943935
336	321	5	0	5	31.6608570984
336	322	1	0	1	46.7965977716
336	323	1	0	1	45.3382881051
336	324	1	0	1	32.5338058072
336	326	7	1	6	24.0959317382
336	329	17	0	17	25.6956031892
336	332	50	2	48	13.075306929
336	333	6	0	6	17.3365152185
336	334	33	1	32	15.0824586139
336	335	1	0	1	16.5899020938
336	337	24	0	24	5.07767039104
336	338	849	292	557	9.51325783201
336	339	24	18	6	10.1806584186
336	340	5	0	5	20.131851993
336	341	97	21	76	8.25991317358
336	342	23	2	21	13.8688001841
336	343	1	0	1	23.0168654906
336	344	1	0	1	18.0416199567
336	345	2	0	2	51.5382560684
336	347	25	0	25	19.8142612221
336	348	5	0	5	19.2367320262
336	349	54	0	54	18.9552376367
336	350	13	0	13	21.3805098794
336	351	2	0	2	14.6324056454
336	352	1	0	1	14.3263058572
336	353	119	34	85	10.7046247762
336	355	1	0	1	29.1283025473
336	356	2	0	2	41.5759788112
336	357	6	1	5	23.4436404236
336	358	1	0	1	61.6918771605
336	359	3	1	2	29.8120226457
336	364	1	0	1	36.6401496374
336	365	1	1	0	21.5540075907
336	366	1	0	1	42.4684249568
336	367	11	1	10	25.7226441715
336	370	1	0	1	37.58770196
336	372	2	0	2	42.3475182012
336	373	5	1	4	23.8583366705
336	375	27	5	22	36.289277288
336	377	2	0	2	20.8544168984
336	408	0	0	0	119.8963327
336	438	1	0	1	139.199873499
336	442	0	0	0	139.054795006
336	469	0	0	0	109.053151891
336	485	0	0	0	142.007034546
336	507	1	0	1	164.834013222
336	524	1	0	1	108.199329237
336	537	0	0	0	116.08596303
336	551	0	0	0	68.372071826
336	555	1	0	1	79.9997847159
336	563	0	0	0	76.9394364236
336	573	17	5	12	69.1061109739
336	576	1	0	1	49.5918185111
336	579	1	0	1	55.1472686407
336	581	1	0	1	57.1968742782
336	584	1	0	1	70.7330466729
336	585	2	0	2	59.9283192611
336	586	1	0	1	62.7925712647
337	1	1	0	1	82.8646368851
337	34	1	0	1	80.4065347666
337	36	1	0	1	63.5025518621
337	39	1	0	1	61.6758420449
337	70	12	0	12	39.3654500595
337	71	2	0	2	45.7034983375
337	73	68	1	67	46.9073935006
337	74	4	0	4	44.8461238947
337	75	5	0	5	48.2909908571
337	76	10	0	10	39.7587309317
337	78	6	1	5	43.1421273438
337	79	3	0	3	45.0804255087
337	81	8	0	8	42.7176590519
337	82	8	0	8	41.9749455314
337	83	3	0	3	45.1021395051
337	84	3	0	3	46.5651500207
337	85	9	1	8	40.016363667
337	86	2	0	2	43.7581616158
337	87	2	0	2	47.9065699738
337	88	2	0	2	47.3633539304
337	90	2	1	1	34.0426523462
337	92	1	0	1	38.8001313462
337	94	1	0	1	26.7791755618
337	96	7	0	7	28.7794313268
337	97	1	0	1	19.1207814089
337	103	1	0	1	52.6465295604
337	109	3	0	3	33.690739101
337	110	1	0	1	56.8555365613
337	112	1	0	1	54.3454074999
337	113	1	0	1	52.5386313319
337	116	1	0	1	37.4382873879
337	122	1	0	1	32.3348116559
337	146	1	0	1	51.4371672815
337	155	3	0	3	33.3126291506
337	156	1	0	1	28.9706229725
337	162	1	0	1	25.7206408052
337	165	0	0	0	50.8096265938
337	166	5	0	5	29.862054093
337	167	1	0	1	62.4107419945
337	169	6	1	5	23.7720651433
337	171	1	0	1	38.0160633607
337	172	1	0	1	50.7371877758
337	177	2	1	1	47.3867336745
337	179	2	0	2	19.105359652
337	310	64	7	57	12.4260792816
337	311	2	0	2	16.2920783964
337	313	16	12	4	4.70300264368
337	314	13	12	1	9.00911293695
337	319	15	0	15	40.576740126
337	320	2	0	2	47.3390779992
337	321	1	0	1	32.274967802
337	322	1	0	1	47.4321837489
337	326	1	0	1	24.6423692323
337	329	3	0	3	24.9689643022
337	332	11	0	11	17.7969503047
337	333	2	0	2	22.1819454018
337	334	8	0	8	20.1505561358
337	336	21	2	19	5.07767039104
337	338	173	63	110	13.8010391842
337	339	4	0	4	15.2150916924
337	341	25	1	24	12.1077405057
337	342	6	0	6	18.9020682987
337	345	1	0	1	50.0932871072
337	347	16	6	10	17.0886102079
337	348	7	0	7	14.5712508344
337	349	13	2	11	20.4147153923
337	350	12	3	9	16.7427896229
337	351	2	0	2	15.4586922378
337	352	7	1	6	9.33274551607
337	353	97	6	91	8.98158437037
337	354	4	0	4	18.9571876512
337	355	1	0	1	31.1867189317
337	357	1	0	1	26.0259368939
337	359	2	0	2	33.7285883069
337	364	2	0	2	39.3779651588
337	365	0	0	0	25.1736859339
337	369	1	0	1	31.5339037682
337	372	1	0	1	41.155572849
337	375	10	1	9	35.9113143408
337	377	2	0	2	20.1818120868
337	378	1	0	1	34.2174229584
337	408	2	0	2	118.732516604
337	431	1	0	1	143.104026534
337	503	0	0	0	111.732909738
337	563	2	0	2	77.834662488
337	568	0	0	0	69.42321596
337	573	3	0	3	69.0717471503
337	577	1	0	1	52.0333470872
337	581	1	0	1	56.3904722067
337	585	1	0	1	61.9989160304
338	1	14	2	12	93.7014356964
338	5	1	0	1	102.299216098
338	7	1	0	1	84.7207256349
338	28	0	0	0	89.358138311
338	29	1	0	1	107.02463656
338	36	5	0	5	72.3928908854
338	50	2	0	2	99.3909795644
338	56	1	0	1	107.926953713
338	59	1	0	1	120.115061306
338	70	204	2	202	47.6093634797
338	71	30	2	28	51.6218641641
338	72	8	0	8	51.1614812941
338	73	981	24	957	54.7476933612
338	74	85	4	81	51.7661658867
338	75	114	0	114	55.657136044
338	76	220	7	213	47.2840536219
338	77	4	0	4	52.6193318189
338	78	148	36	112	50.0883908351
338	79	17	0	17	53.7269836269
338	80	3	1	2	51.9797447706
338	81	68	1	67	51.0233320704
338	82	163	0	163	49.4942484667
338	83	52	3	49	52.7122199148
338	84	123	8	115	54.0960893818
338	85	85	0	85	46.511876411
338	86	44	6	38	49.4885858183
338	87	92	13	79	54.6389444858
338	88	28	1	27	53.6447048118
338	89	3	0	3	53.4168635367
338	90	13	2	11	40.5088876801
338	92	5	0	5	48.2554045344
338	93	0	0	0	33.4328084176
338	94	2	0	2	37.565749032
338	95	3	0	3	61.722614067
338	96	29	0	29	35.756269444
338	98	2	0	2	48.1710753092
338	99	1	0	1	68.3820278813
338	102	1	0	1	65.6763464871
338	103	37	1	36	60.1247679358
338	105	1	0	1	58.7692847521
338	109	15	1	14	41.9445140801
338	110	6	0	6	64.0120789128
338	111	5	0	5	48.0705292056
338	112	27	0	27	62.3168067867
338	113	71	6	65	59.0510975185
338	116	16	4	12	44.786869163
338	117	2	0	2	56.139723034
338	118	4	0	4	43.8913324489
338	119	3	0	3	43.1355472734
338	120	3	0	3	56.1351211214
338	121	1	0	1	56.8794798248
338	135	1	0	1	73.4409345478
338	140	1	0	1	64.3221951111
338	142	11	0	11	70.4385634743
338	146	3	0	3	56.6106906546
338	154	2	0	2	66.5271038474
338	155	75	12	63	36.5367753352
338	156	11	0	11	33.5422090751
338	157	3	0	3	57.0861201576
338	158	1	0	1	46.0197146975
338	159	8	0	8	38.4606502326
338	160	3	0	3	60.3290298286
338	162	9	0	9	29.2309107729
338	163	3	0	3	69.8347402448
338	164	14	0	14	46.9860302863
338	165	2	0	2	50.4304964089
338	166	132	12	120	30.1201196719
338	168	35	5	30	49.1924672302
338	169	75	21	54	30.6150045733
338	170	3	0	3	41.1206352827
338	171	39	1	38	41.8111442325
338	172	33	2	31	52.7569037953
338	173	1	0	1	48.520735097
338	175	6	2	4	43.0221727771
338	177	59	0	59	48.3569851261
338	179	9	2	7	26.8093274191
338	183	10	0	10	102.395787067
338	190	2	0	2	108.144215437
338	196	1	0	1	89.8602629235
338	211	1	0	1	68.9801907976
338	213	1	0	1	70.3193027642
338	220	1	0	1	111.726020795
338	222	1	0	1	110.718897095
338	227	1	0	1	86.4490709871
338	230	1	0	1	87.2692634455
338	241	0	0	0	119.60486179
338	245	3	0	3	55.1756628272
338	251	2	1	1	41.6245938407
338	264	1	0	1	68.5391264127
338	270	1	0	1	83.8317526088
338	277	9	1	8	71.3149345453
338	294	2	0	2	41.8901473109
338	296	0	0	0	41.2837184599
338	297	1	0	1	47.9344076197
338	307	0	0	0	79.8019273228
338	310	105	0	105	25.1010907136
338	311	26	0	26	21.9257840742
338	312	35	10	25	20.4270187249
338	313	36	14	22	18.2115956755
338	314	24	2	22	18.7425161557
338	315	2	0	2	35.5107169525
338	316	4	0	4	37.5407469344
338	317	4	0	4	36.6324853608
338	318	17	8	9	22.3760815692
338	319	608	28	580	32.9637576766
338	320	25	0	25	39.4851169393
338	321	22	0	22	26.2289115891
338	322	4	0	4	40.7730397492
338	323	30	2	28	40.3410877464
338	324	11	3	8	25.2939427083
338	325	3	0	3	41.1093735393
338	326	87	10	77	19.3958741319
338	327	9	2	7	29.5472996343
338	328	5	2	3	29.7667791425
338	329	165	48	117	23.1683550776
338	330	2	0	2	43.1768669773
338	331	4	0	4	34.7329523604
338	332	449	0	449	12.534670066
338	333	96	22	74	14.9692792815
338	334	397	4	393	9.22738018043
338	335	15	1	14	18.3865123343
338	336	62	16	46	9.51325783201
338	337	21	0	21	13.8010391842
338	339	244	158	86	8.18859467108
338	340	38	0	38	20.1091727713
338	341	586	111	475	12.708541108
338	342	185	98	87	10.4248825753
338	343	5	0	5	20.8142641574
338	344	79	32	47	9.63134721841
338	345	19	7	12	59.9005552468
338	346	2	0	2	80.7069826674
338	347	83	12	71	21.8393871656
338	348	15	0	15	25.3804777505
338	349	603	220	383	13.2794522118
338	350	36	13	23	30.5423180594
338	351	75	0	75	11.2954149504
338	352	4	0	4	21.8466366217
338	353	391	0	391	13.4887142034
338	354	9	4	5	19.1238646874
338	355	14	1	13	21.5084683044
338	356	7	3	4	32.1312858343
338	357	118	0	118	15.3364497962
338	358	4	0	4	52.1885548272
338	359	40	0	40	20.3142695487
338	360	2	1	1	41.6390946635
338	361	4	0	4	21.9554360033
338	364	7	1	6	27.9533045771
338	365	36	1	35	12.2601181956
338	366	3	0	3	34.2895479004
338	367	56	5	51	19.2466118139
338	368	2	0	2	36.6831312806
338	369	6	0	6	37.6271680437
338	370	2	0	2	46.3140195734
338	371	2	1	1	54.9145676174
338	372	4	0	4	50.575202596
338	373	55	1	54	30.1148105404
338	375	193	21	172	43.8345515368
338	376	6	0	6	41.6547975639
338	377	12	0	12	29.1236381195
338	379	2	0	2	95.4273795444
338	385	5	0	5	88.7957276221
338	392	1	0	1	87.4053652609
338	396	1	0	1	111.366035359
338	397	1	0	1	108.131714217
338	401	1	0	1	118.397951874
338	404	1	0	1	113.391034484
338	406	1	0	1	118.256283643
338	407	1	0	1	114.952190658
338	408	23	1	22	116.133592586
338	411	1	0	1	110.231281836
338	415	8	0	8	105.739360219
338	416	4	0	4	125.181766025
338	417	1	0	1	105.132793671
338	419	1	0	1	123.428339303
338	427	1	0	1	130.757168539
338	438	2	0	2	134.196692919
338	441	0	0	0	130.783512424
338	442	0	0	0	134.815106888
338	453	1	0	1	103.755182367
338	466	1	0	1	121.591630384
338	468	1	0	1	96.513331226
338	469	1	0	1	108.396085982
338	471	1	0	1	116.414077047
338	496	1	0	1	104.230169654
338	497	1	0	1	100.342245055
338	507	4	0	4	156.190961061
338	512	2	0	2	136.275376623
338	517	0	0	0	129.879500033
338	524	6	0	6	101.082512866
338	532	1	0	1	120.16183548
338	536	1	0	1	102.745175086
338	548	1	0	1	150.635134701
338	554	0	0	0	84.1386064466
338	555	2	0	2	72.532125144
338	558	0	0	0	91.0321510244
338	563	2	0	2	70.1425047293
338	566	2	0	2	76.9744266616
338	569	0	0	0	55.5558663498
338	570	1	0	1	50.6748679582
338	571	1	0	1	76.6850777478
338	572	1	0	1	51.6365357408
338	573	121	1	120	63.7853319603
338	575	1	0	1	61.3214019184
338	576	1	0	1	45.3865133932
338	577	7	1	6	45.9540653373
338	578	1	0	1	72.707700863
338	579	5	1	4	49.9115732872
338	581	12	0	12	53.3674338843
338	582	1	0	1	44.8538207704
338	583	4	1	3	58.6278908573
338	585	12	0	12	51.7485530806
338	586	5	1	4	53.914542008
338	587	1	0	1	38.8190984139
339	24	1	0	1	97.3011626185
339	36	3	0	3	77.8033244533
339	50	1	0	1	105.649314077
339	59	1	0	1	126.881831352
339	70	35	4	31	53.2156301663
339	71	7	0	7	58.2018446585
339	72	2	0	2	56.5366891116
339	73	159	121	38	60.5895680517
339	74	8	1	7	57.9746875026
339	75	16	0	16	61.7101604783
339	76	70	0	70	53.2078272248
339	77	1	0	1	58.0404389701
339	78	29	10	19	56.2736473786
339	79	1	0	1	59.1823458921
339	81	12	0	12	56.6265108685
339	82	30	6	24	55.4390810757
339	83	6	2	4	58.6419263903
339	84	11	0	11	60.06919144
339	85	10	1	9	52.8399181184
339	86	8	0	8	56.1165690796
339	87	11	0	11	60.9410605756
339	88	3	0	3	60.1097081713
339	89	1	0	1	57.9556241532
339	90	2	0	2	46.7819880943
339	92	1	0	1	53.2512440669
339	95	1	0	1	67.1555924865
339	96	14	4	10	41.7641262931
339	103	7	1	6	66.1557645901
339	109	2	1	1	47.4925088387
339	110	2	0	2	70.1971808126
339	112	8	0	8	68.1403553955
339	113	16	0	16	65.4641814707
339	114	1	0	1	73.5147250538
339	116	2	0	2	50.7615072716
339	117	1	0	1	62.6424314856
339	142	2	1	1	77.5331848038
339	154	1	0	1	74.2006032584
339	155	7	0	7	43.7623844398
339	159	1	0	1	46.3909702015
339	160	2	0	2	67.9948624687
339	162	1	0	1	36.2455417039
339	163	1	0	1	77.7740112911
339	166	14	0	14	37.8805537256
339	168	9	0	9	56.6587525859
339	169	24	7	17	36.571908288
339	170	0	0	0	49.2706659448
339	171	6	0	6	48.9531546901
339	172	8	1	7	60.4018922409
339	175	1	0	1	50.5508541054
339	177	7	1	6	56.1680262149
339	183	3	0	3	99.9628511379
339	205	1	0	1	47.3929847667
339	208	1	0	1	58.1491221639
339	220	1	0	1	107.959021368
339	238	1	0	1	80.9726760568
339	241	1	0	1	114.242390274
339	242	1	0	1	111.48838629
339	258	1	0	1	73.905154636
339	310	12	1	11	23.2230399898
339	311	4	0	4	15.9822975139
339	312	9	4	5	13.0368265902
339	313	3	1	2	18.2781211071
339	314	5	0	5	15.7489617172
339	318	1	0	1	30.4994162449
339	319	65	7	58	40.8531081099
339	320	4	0	4	47.2550711965
339	321	2	1	1	34.3783439782
339	322	4	1	3	48.7575116136
339	323	6	0	6	48.4941642396
339	324	3	0	3	32.9978625379
339	326	8	1	7	27.5799725001
339	327	2	0	2	36.9808981331
339	328	2	0	2	37.9515209155
339	329	31	16	15	31.1231018007
339	332	208	117	91	4.35410531669
339	333	46	25	21	7.56456700896
339	334	118	57	61	5.67204608098
339	335	6	4	2	10.2720217254
339	336	11	1	10	10.1806584186
339	337	3	0	3	15.2150916924
339	338	975	166	809	8.18859467108
339	340	13	0	13	12.0146013575
339	341	247	89	158	6.85017019918
339	342	122	86	36	3.68865630007
339	343	2	1	1	13.5018637386
339	344	12	0	12	10.4339763679
339	345	1	0	1	54.2577607699
339	347	7	1	6	28.2196811003
339	348	3	0	3	29.2971424659
339	349	62	2	60	21.4668972377
339	350	6	1	5	30.6081173109
339	351	1	0	1	19.1568337921
339	352	2	0	2	24.5064526693
339	353	62	11	51	19.115430693
339	354	1	0	1	26.6084227671
339	355	2	0	2	29.092908596
339	356	1	0	1	36.7035437683
339	357	5	0	5	22.8049779859
339	359	3	0	3	24.8222004802
339	361	0	0	0	28.668369685
339	362	1	0	1	27.1434672451
339	364	3	0	3	34.4776166768
339	365	1	0	1	18.3639453188
339	367	1	0	1	27.2876999589
339	368	1	0	1	39.7509044747
339	369	1	0	1	30.7643044816
339	370	2	0	2	41.3760021257
339	373	12	2	10	23.2151756788
339	375	18	1	17	37.5399164412
339	377	3	0	3	24.0588686676
339	385	1	0	1	96.9298304831
339	392	0	0	0	95.5773842935
339	401	2	0	2	126.569442843
339	408	2	0	2	124.321208521
339	415	1	0	1	113.927795234
339	417	1	0	1	113.316418414
339	419	1	0	1	131.590187788
339	444	0	0	0	149.154594603
339	507	2	0	2	162.148525193
339	524	1	0	1	108.476886082
339	573	12	0	12	71.8570935216
339	581	0	0	0	61.5547074599
339	582	1	0	1	50.1221466093
339	583	1	0	1	62.7589530181
339	585	3	0	3	58.5368414269
339	588	1	0	1	69.2670334676
340	21	1	0	1	111.955311222
340	70	10	0	10	63.7025880522
340	71	2	0	2	69.4343972038
340	73	32	7	25	71.2087664752
340	74	4	0	4	68.9186013673
340	75	3	0	3	72.5004819794
340	76	17	1	16	63.9593752467
340	78	13	5	8	67.2110058798
340	81	2	0	2	67.0750117975
340	82	19	0	19	66.1877266002
340	83	4	0	4	69.3512877741
340	84	8	0	8	70.8040405708
340	85	5	0	5	63.9144483987
340	86	2	0	2	67.3959639076
340	87	4	0	4	71.9413123863
340	88	2	0	2	71.243854806
340	96	4	0	4	52.7084550802
340	111	1	1	0	61.635323092
340	112	3	1	2	78.6891158784
340	113	5	0	5	76.5294927244
340	142	1	0	1	89.0842910428
340	147	1	0	1	98.975353699
340	155	1	0	1	55.4895915321
340	166	8	1	7	49.8567879486
340	168	2	0	2	68.4835910638
340	169	1	0	1	47.5566982941
340	171	2	0	2	60.6120511854
340	177	1	0	1	68.1464198007
340	196	1	0	1	77.9707325208
340	252	1	0	1	60.7649734392
340	258	1	0	1	81.883161874
340	277	1	0	1	75.4876010664
340	310	7	0	7	27.538020117
340	311	4	0	4	15.2254480399
340	312	9	2	7	9.36637018607
340	313	2	0	2	25.7268225191
340	314	3	1	2	20.3342010358
340	317	1	0	1	32.6703789539
340	319	21	2	19	51.9779422486
340	320	2	0	2	58.1354508992
340	323	1	0	1	60.1284247636
340	324	1	0	1	43.9317327859
340	326	2	0	2	39.4754378401
340	329	11	0	11	43.1373166025
340	331	1	0	1	54.8114486811
340	332	79	30	49	7.71061471574
340	333	60	31	29	6.07644856817
340	334	27	2	25	13.0563822021
340	335	19	8	11	4.5135215325
340	336	4	0	4	20.131851993
340	337	1	0	1	24.4074896526
340	338	246	21	225	20.1091727713
340	339	23	9	14	12.0146013575
340	341	80	2	78	12.3291046475
340	342	11	2	9	10.1143379779
340	343	11	3	8	5.18207559739
340	344	1	0	1	18.1685725773
340	345	2	1	1	49.5120047773
340	346	1	0	1	67.3768154889
340	347	2	0	2	39.6160449641
340	348	2	0	2	38.9710194833
340	349	14	3	11	33.312195995
340	350	2	0	2	36.4101218602
340	351	2	0	2	31.1700585714
340	352	1	0	1	33.4676330428
340	353	9	1	8	30.3979118097
340	355	1	0	1	39.9413376954
340	357	3	0	3	33.6892110519
340	359	1	0	1	32.6006951306
340	365	1	0	1	28.2999298316
340	367	1	0	1	38.7761205519
340	369	1	0	1	24.4705827164
340	371	0	0	0	43.698662776
340	372	2	0	2	40.3960500894
340	373	6	0	6	17.8018558433
340	375	14	0	14	32.1641759073
340	377	2	0	2	22.9994053835
340	394	1	0	1	120.705896264
340	408	0	0	0	136.091367427
340	512	2	0	2	152.560520426
340	524	1	0	1	118.434422696
340	573	1	0	1	83.2243207415
340	579	1	0	1	69.5041620453
340	581	0	0	0	73.4069492595
340	585	2	0	2	67.8257553008
341	0	1	0	1	82.5345904657
341	1	4	0	4	94.4994754694
341	36	2	0	2	75.5878845279
341	41	1	0	1	82.2625537996
341	70	32	0	32	51.4628847104
341	71	8	2	6	57.5304998628
341	73	214	13	201	58.9944743504
341	74	28	1	27	56.8371710292
341	75	18	3	15	60.3434781158
341	76	54	11	43	51.8040817928
341	78	30	15	15	55.1303612713
341	79	3	0	3	57.1877183638
341	80	2	0	2	55.7375399698
341	81	11	1	10	54.8208999687
341	82	28	3	25	54.0264487514
341	83	8	0	8	57.1695180898
341	84	17	0	17	58.6289204486
341	85	26	3	23	51.9195353584
341	86	14	0	14	55.5354145788
341	87	24	1	23	59.8822796569
341	88	10	0	10	59.2657483563
341	89	1	0	1	55.0913233952
341	90	3	0	3	45.8989105085
341	92	2	0	2	50.879155742
341	94	1	0	1	38.7261936318
341	95	1	0	1	65.0507714521
341	96	3	0	3	40.6813959456
341	97	1	1	0	31.0453431078
341	98	1	0	1	55.0472496028
341	103	5	0	5	64.7169181211
341	104	2	0	2	63.9655977863
341	109	3	0	3	45.7780357087
341	110	1	0	1	68.9042406002
341	111	1	0	1	49.3275285865
341	112	3	0	3	66.4461607805
341	113	9	3	6	64.4971033156
341	116	1	0	1	49.4549945643
341	118	1	0	1	49.5075548097
341	119	1	0	1	49.5371639195
341	141	1	0	1	93.8081514203
341	142	3	1	2	77.4361983886
341	146	1	0	1	63.1328957114
341	155	15	0	15	44.2522333358
341	156	2	0	2	40.2803956883
341	159	2	0	2	48.2775058217
341	160	1	0	1	69.0163514552
341	162	1	0	1	36.5956602535
341	164	2	0	2	54.4327547808
341	166	21	5	16	39.4839320422
341	168	9	1	8	57.3767114355
341	169	13	0	13	35.5825693324
341	171	4	0	4	49.2186109466
341	172	10	1	9	61.4391656195
341	176	0	0	0	85.1174787964
341	177	8	1	7	57.6265958493
341	179	1	0	1	31.0029080427
341	198	1	0	1	88.5627908812
341	208	2	0	2	51.4014163812
341	215	1	0	1	41.0942364814
341	220	2	0	2	101.109038535
341	229	1	0	1	68.6300267769
341	242	1	0	1	104.769192292
341	245	1	0	1	54.2661162512
341	258	1	0	1	69.8979720815
341	277	5	0	5	65.5216275395
341	310	101	9	92	17.0351124839
341	311	37	24	13	9.39617998929
341	312	42	7	35	8.14174316275
341	313	7	0	7	13.6015353008
341	314	31	6	25	9.4135116964
341	316	1	0	1	30.020420213
341	317	7	0	7	25.9061339319
341	318	3	0	3	34.5539311361
341	319	124	0	124	45.4752677038
341	320	3	0	3	52.0742475893
341	321	4	0	4	38.2623733973
341	322	1	0	1	53.1421570481
341	323	5	1	4	52.250694139
341	324	3	0	3	37.9484331102
341	325	1	0	1	53.8145776429
341	326	9	3	6	30.9530282478
341	327	4	0	4	42.2536080093
341	328	1	0	1	41.16611929
341	329	40	8	32	33.3673466002
341	331	2	1	1	46.0103186846
341	332	266	168	98	6.6887832872
341	333	46	4	42	11.1531641761
341	334	101	57	44	12.3961413742
341	335	18	5	13	8.42084187898
341	336	27	1	26	8.25991317358
341	337	6	3	3	12.1077405057
341	338	1190	0	1190	12.708541108
341	339	104	22	82	6.85017019918
341	340	23	16	7	12.3291046475
341	342	75	0	75	9.54754048018
341	343	6	0	6	16.03494151
341	344	6	0	6	17.2737937255
341	345	7	0	7	47.6895637265
341	347	12	0	12	28.074168889
341	348	2	0	2	26.6518512221
341	349	94	0	94	25.216124812
341	350	23	0	23	25.1587256491
341	351	7	4	3	21.7160837825
341	352	1	0	1	21.1471860587
341	353	53	22	31	18.9429664129
341	354	1	0	1	28.0491226242
341	355	1	0	1	34.2039614973
341	357	10	0	10	28.0445551422
341	359	4	0	4	31.4464119649
341	361	1	0	1	34.5039724117
341	364	2	0	2	40.4453962752
341	365	4	1	3	24.4178519783
341	367	8	0	8	31.6485806997
341	369	2	0	2	24.9188235179
341	370	1	0	1	34.5982932651
341	372	1	0	1	38.3140906229
341	373	19	11	8	17.4104207816
341	375	62	7	55	31.2583009822
341	376	1	0	1	29.0484931481
341	377	19	7	12	17.2581174978
341	392	0	0	0	99.0344742227
341	396	1	0	1	122.362981671
341	406	2	0	2	129.330184805
341	408	1	0	1	127.46472242
341	411	2	0	2	121.753202389
341	415	1	0	1	116.958187327
341	416	2	0	2	136.351916682
341	417	1	0	1	116.585034348
341	453	1	0	1	114.789815879
341	475	1	0	1	105.207007186
341	476	1	0	1	109.309584171
341	497	1	0	1	110.656803429
341	507	1	0	1	168.492499146
341	512	1	0	1	148.97370109
341	524	2	0	2	113.777545668
341	535	1	0	1	136.135031912
341	540	2	0	2	130.147095231
341	554	0	0	0	96.8169459922
341	555	0	0	0	85.2406653919
341	564	2	0	2	79.6774911636
341	566	1	0	1	88.9519609848
341	570	1	0	1	63.2100321588
341	572	1	0	1	64.3395126661
341	573	23	0	23	75.9182480641
341	576	1	0	1	56.87837593
341	581	1	0	1	64.6557181461
341	585	5	0	5	64.375777527
341	586	1	0	1	66.132982579
342	1	2	0	2	101.600257095
342	24	1	0	1	100.910662253
342	36	1	0	1	81.3549922632
342	50	1	0	1	109.037889747
342	56	0	0	0	117.348298357
342	65	1	0	1	128.285481745
342	70	33	0	33	56.718423035
342	71	6	0	6	61.4742353857
342	72	1	0	1	60.0807779926
342	73	134	0	134	64.0541679949
342	74	7	1	6	61.3531748685
342	75	17	0	17	65.1296522384
342	76	85	4	81	56.6483762126
342	77	3	2	1	61.5786651363
342	78	17	3	14	59.6564399973
342	79	5	0	5	62.7160465381
342	80	1	0	1	61.0795498712
342	81	5	0	5	60.1331303431
342	82	31	4	27	58.8773655288
342	83	6	0	6	62.0864587175
342	84	16	3	13	63.5054636773
342	85	18	0	18	56.181712614
342	86	3	0	3	59.3714995878
342	87	18	0	18	64.2975263429
342	88	9	0	9	63.4192527723
342	89	1	0	1	61.5970280358
342	90	5	0	5	50.1310068885
342	95	1	0	1	70.6983339863
342	96	9	2	7	45.1700651649
342	102	1	0	1	73.822662494
342	103	1	0	1	69.5835933806
342	109	6	0	6	50.9988907737
342	110	1	0	1	73.5906224978
342	111	1	0	1	56.002654266
342	112	6	2	4	71.6140448703
342	113	13	0	13	68.793011686
342	119	1	0	1	53.0857875925
342	120	1	0	1	64.917794765
342	142	3	0	3	80.6190986179
342	155	11	0	11	46.7633013904
342	156	1	0	1	43.517832313
342	159	1	0	1	48.8783900522
342	162	3	0	3	39.3299042003
342	166	18	1	17	40.5364978703
342	168	3	0	3	59.5363395296
342	169	30	2	28	39.978332551
342	170	1	0	1	51.3580386613
342	171	4	0	4	51.9996529747
342	172	4	0	4	63.157671299
342	177	7	0	7	58.7813981079
342	183	2	0	2	102.704584909
342	208	1	0	1	59.9681091421
342	209	1	0	1	64.6961819386
342	214	1	0	1	53.8965303425
342	219	1	0	1	108.969905965
342	277	1	0	1	74.8169745718
342	282	1	1	0	63.6396094852
342	292	1	0	1	60.082226835
342	294	1	0	1	41.7289933822
342	310	24	0	24	26.4471124055
342	311	2	0	2	17.8655690172
342	312	17	2	15	13.8409629458
342	313	10	0	10	21.8726346794
342	314	6	1	5	18.8675950776
342	316	1	0	1	39.4709909792
342	317	2	1	1	35.237648972
342	318	1	0	1	32.0322039388
342	319	81	1	80	41.8813633345
342	320	4	2	2	48.087369272
342	321	3	0	3	35.9654038254
342	323	4	2	2	50.0372788158
342	325	1	0	1	48.930023786
342	326	10	1	9	29.5567864072
342	327	2	0	2	37.5238470092
342	328	1	0	1	39.8807319996
342	329	26	0	26	33.5873605754
342	332	219	160	59	3.94599856064
342	333	73	39	34	4.54815281126
342	334	208	153	55	3.47522069599
342	335	10	0	10	9.82803236699
342	336	10	0	10	13.8688001841
342	337	5	1	4	18.9020682987
342	338	884	278	606	10.4248825753
342	339	130	24	106	3.68865630007
342	340	17	1	16	10.1143379779
342	341	231	55	176	9.54754048018
342	343	8	2	6	10.4151679031
342	344	16	8	8	8.95956589766
342	345	3	0	3	55.7366739754
342	347	7	0	7	31.4937305685
342	348	2	0	2	32.951908443
342	349	63	17	46	23.3673207942
342	350	3	0	3	34.1077772743
342	351	3	0	3	21.7126838616
342	353	42	0	42	22.5005010491
342	354	2	0	2	29.4411963273
342	355	3	0	3	29.8777595376
342	356	1	0	1	35.4292872913
342	357	6	0	6	23.6068055155
342	359	1	0	1	23.7733866539
342	360	1	0	1	44.694217173
342	361	1	0	1	28.7576524522
342	364	1	0	1	34.3394760994
342	365	2	0	2	18.4288178008
342	366	1	0	1	41.3526669405
342	367	8	0	8	28.6727702982
342	368	1	0	1	37.7688428894
342	369	1	0	1	31.5759038528
342	370	1	0	1	43.321062803
342	373	11	1	10	24.13352239
342	375	29	0	29	38.7177356319
342	377	1	0	1	26.174466449
342	379	1	0	1	105.136960859
342	385	2	0	2	98.3300873458
342	397	1	0	1	118.240026128
342	408	4	0	4	126.026062007
342	411	0	0	0	120.011127484
342	415	1	0	1	115.704134821
342	441	0	0	0	140.213804882
342	442	1	0	1	144.488813538
342	487	1	0	1	140.22806728
342	507	1	0	1	161.25297439
342	512	1	0	1	143.212844816
342	521	1	0	1	122.224122389
342	524	6	0	6	108.741023192
342	554	1	0	1	92.0087599256
342	569	1	0	1	64.6813444195
342	570	1	0	1	59.3423121413
342	573	5	0	5	73.1117957241
342	576	1	0	1	55.348306569
342	577	1	0	1	55.2068771902
342	579	4	0	4	59.3913933907
342	581	3	0	3	63.4027507779
342	583	2	0	2	61.0684044679
342	585	2	0	2	58.391703018
342	586	1	0	1	59.0473171329
343	1	1	0	1	110.473511555
343	34	1	0	1	107.184690883
343	70	6	1	5	66.5617863239
343	73	28	3	25	73.9848492269
343	74	1	0	1	71.4465447812
343	75	2	0	2	75.151910658
343	76	8	0	8	66.6341524427
343	78	6	0	6	69.7435187862
343	80	1	0	1	70.9001464908
343	82	6	0	6	68.8664012396
343	83	2	0	2	72.0612352463
343	84	6	0	6	73.4961995549
343	85	1	0	1	66.3294195095
343	87	2	0	2	74.4232897796
343	88	1	0	1	73.6069619173
343	89	1	0	1	70.8482682117
343	96	2	1	1	55.2256348273
343	99	1	0	1	88.1963048482
343	102	1	0	1	82.9809344172
343	103	1	0	1	79.5883843257
343	111	1	0	1	65.1383368319
343	112	1	0	1	81.5196479053
343	116	1	0	1	64.202067807
343	142	1	0	1	90.9853229617
343	154	1	0	1	87.340739655
343	155	1	0	1	57.15583575
343	156	2	0	2	53.8281000708
343	160	1	0	1	81.1418148428
343	164	1	0	1	67.5875933234
343	166	3	0	3	50.9343334095
343	168	4	0	4	69.9506594642
343	171	1	0	1	62.3785354865
343	172	3	0	3	73.5666086759
343	177	0	0	0	69.1600336761
343	196	1	0	1	82.454100385
343	213	1	0	1	66.0411931384
343	220	1	0	1	110.70866731
343	310	6	0	6	32.1983808502
343	311	1	0	1	20.2897766914
343	312	7	1	6	14.4880205976
343	313	1	0	1	29.636290883
343	314	2	1	1	24.7903782791
343	316	1	0	1	44.7194670757
343	319	29	6	23	50.9349138224
343	320	1	0	1	56.8065774207
343	321	1	0	1	45.7094425519
343	322	1	0	1	59.0199823992
343	323	3	1	2	59.6431573048
343	326	4	0	4	39.6678169755
343	327	1	1	0	45.9594476091
343	329	8	2	6	43.9380614523
343	331	1	0	1	54.8783314079
343	332	78	8	70	9.94264259745
343	333	161	85	76	5.954872645
343	334	26	5	21	12.2348594897
343	335	18	2	16	9.40949516352
343	336	2	0	2	23.0168654906
343	338	262	5	257	20.8142641574
343	339	24	0	24	13.5018637386
343	340	67	11	56	5.18207559739
343	341	78	38	40	16.03494151
343	342	37	5	32	10.4151679031
343	344	6	1	5	16.3853804085
343	345	0	0	0	54.347517854
343	347	3	1	2	41.7212282014
343	349	11	0	11	33.4797836817
343	350	4	0	4	40.8783618466
343	353	12	4	8	32.6056231231
343	354	2	0	2	39.8553585343
343	357	1	0	1	32.716130774
343	359	2	1	1	29.8577881972
343	365	1	0	1	26.8376858802
343	367	2	0	2	38.3016595272
343	373	5	0	5	22.836051758
343	375	15	1	14	37.0063714408
343	376	0	0	0	30.4440587767
343	377	1	0	1	28.167058679
343	379	1	0	1	114.589753709
343	408	0	0	0	135.652478793
343	524	1	0	1	116.152950502
343	536	1	0	1	112.140425434
343	540	1	0	1	129.120071629
343	573	4	0	4	82.2679481523
343	581	0	0	0	73.2719524711
343	583	1	0	1	64.1585669546
343	585	1	0	1	65.3150615587
343	586	1	0	1	64.6390522296
343	587	0	0	0	51.3262847415
344	70	14	1	13	56.7127109472
344	71	2	0	2	60.0070069202
344	73	78	9	69	63.6821151646
344	74	10	0	10	60.4671380642
344	75	10	0	10	64.4488083669
344	76	13	3	10	56.20973734
344	78	11	1	10	58.817653157
344	79	2	0	2	62.8759545755
344	81	3	1	2	60.1107324716
344	82	17	5	12	58.3928867564
344	84	7	1	6	62.9503216515
344	85	2	0	2	55.1569583499
344	86	1	0	1	57.8437189798
344	87	11	0	11	63.2488073867
344	88	2	0	2	62.1220899787
344	89	1	0	1	62.8916751138
344	96	3	0	3	44.7233629901
344	103	1	0	1	68.9099337881
344	109	1	0	1	51.1098739505
344	112	4	0	4	71.2293584711
344	113	2	0	2	67.5417455675
344	142	1	0	1	78.1036528407
344	155	4	0	4	44.3309367277
344	156	2	0	2	41.9056752884
344	162	1	0	1	37.4395841076
344	163	1	0	1	75.6199033442
344	166	9	0	9	37.0318502818
344	168	1	0	1	56.4133351722
344	169	4	0	4	39.669764852
344	172	4	0	4	59.5635459624
344	177	4	0	4	54.7809240216
344	179	1	0	1	36.1222861136
344	183	1	0	1	110.113265374
344	310	1	0	1	32.9456034808
344	311	1	0	1	26.3535294504
344	312	2	0	2	22.7591258997
344	313	8	0	8	26.9070063933
344	314	1	0	1	25.7606183046
344	318	3	0	3	25.9068182476
344	319	46	16	30	34.5835551265
344	320	3	0	3	40.4221994239
344	321	1	0	1	29.8230856715
344	323	6	0	6	43.5296966978
344	324	2	0	2	26.445768397
344	326	7	0	7	24.5665757479
344	328	1	0	1	34.390553289
344	329	14	0	14	29.7357023239
344	332	37	1	36	12.8824526533
344	333	8	0	8	12.0944855422
344	334	119	51	68	5.48643456109
344	335	1	0	1	18.7245098977
344	336	3	0	3	18.0416199567
344	337	1	0	1	22.8750502984
344	338	782	420	362	9.63134721841
344	339	22	1	21	10.4339763679
344	340	3	0	3	18.1685725773
344	341	70	3	67	17.2737937255
344	342	35	0	35	8.95956589766
344	343	0	0	0	16.3853804085
344	345	2	1	1	64.5194075339
344	347	8	0	8	30.785482193
344	348	1	0	1	35.0080606946
344	349	40	3	37	18.6159282797
344	350	5	1	4	39.4208732718
344	351	4	1	3	18.9905672254
344	352	1	0	1	31.3802728482
344	353	25	10	15	22.9766233991
344	354	1	0	1	27.0077397919
344	355	1	0	1	22.4525817003
344	356	1	0	1	26.5038979852
344	357	27	3	24	16.4767234265
344	359	14	3	11	14.8152439886
344	361	4	0	4	20.4368584639
344	362	1	0	1	17.787493839
344	364	2	0	2	25.7391605072
344	365	13	1	12	10.4551441524
344	367	6	0	6	22.382605663
344	369	1	0	1	40.5265791085
344	372	1	0	1	55.1427554352
344	373	6	1	5	33.0619324014
344	375	15	0	15	47.6042582316
344	377	5	0	5	34.4893614651
344	406	1	0	1	121.959683895
344	408	2	0	2	119.45027845
344	414	1	0	1	129.301471442
344	418	1	0	1	110.380803805
344	433	1	0	1	148.147387817
344	453	1	0	1	107.591476206
344	521	1	0	1	114.107972182
344	569	1	0	1	57.3191504372
344	573	13	1	12	65.9095926382
344	581	2	0	2	57.3724076169
344	582	1	0	1	40.1118898903
344	585	1	0	1	49.6887156033
345	1	9	0	9	97.6856514344
345	19	1	0	1	87.7723471592
345	28	3	0	3	92.6662548773
345	34	1	0	1	110.630854267
345	35	1	0	1	102.008196896
345	39	1	0	1	82.5506366036
345	50	1	0	1	120.271546571
345	56	7	0	7	124.972639528
345	65	2	0	2	135.283386807
345	70	36	1	35	73.992819513
345	71	9	1	8	83.9060039866
345	72	1	0	1	74.684696251
345	73	237	18	219	80.4802409882
345	74	22	3	19	81.1273319105
345	75	11	1	10	82.7322428336
345	76	7	2	5	75.9762095142
345	77	1	0	1	75.9631394463
345	78	29	0	29	79.7693366516
345	79	3	0	3	76.947367904
345	80	2	0	2	76.7373602345
345	81	12	0	12	76.1930389381
345	82	32	7	25	77.6034194998
345	83	10	5	5	79.7061660361
345	84	34	1	33	81.0043527731
345	85	13	2	11	78.34191837
345	86	7	0	7	82.7214007554
345	87	13	0	13	83.9274421849
345	88	7	0	7	84.4840668501
345	90	3	0	3	73.9792822001
345	92	8	0	8	70.3072844276
345	96	2	0	2	69.4256234061
345	103	6	0	6	85.8472414837
345	109	1	0	1	70.1485211459
345	110	1	0	1	90.057693905
345	111	4	0	4	65.5598125495
345	112	8	1	7	85.8404881169
345	113	10	0	10	88.1305885548
345	122	1	0	1	64.7588683467
345	136	1	0	1	111.040160546
345	142	2	0	2	103.526602688
345	151	1	0	1	124.026495775
345	155	4	0	4	78.0633827265
345	159	1	0	1	86.0937831502
345	160	2	0	2	101.150871392
345	163	1	0	1	113.293333467
345	164	1	0	1	85.443797576
345	166	4	0	4	77.779080267
345	168	1	0	1	89.7536231132
345	169	2	0	2	66.3666984071
345	171	3	0	3	81.2047515931
345	172	4	0	4	94.5273630617
345	177	16	1	15	92.792440349
345	179	1	0	1	62.3575333464
345	181	3	0	3	46.4714870107
345	183	21	2	19	56.0463686162
345	185	1	0	1	51.4488801957
345	186	1	0	1	42.6214647515
345	187	9	1	8	37.8606247251
345	188	3	0	3	44.1700139178
345	190	1	0	1	66.2364986468
345	191	2	0	2	44.4041393199
345	196	25	0	25	30.0522711991
345	198	1	0	1	41.7055298174
345	199	13	0	13	15.9561701465
345	200	10	1	9	22.6235047948
345	201	1	0	1	29.926884495
345	202	1	0	1	30.1579580224
345	204	20	5	15	17.7121475832
345	205	36	4	32	14.9633319275
345	206	38	9	29	14.3164636047
345	207	83	16	67	14.7148004837
345	208	331	71	260	7.14328294663
345	209	51	6	45	13.8532580411
345	210	12	0	12	16.69632093
345	211	114	22	92	9.22820985745
345	212	143	2	141	19.2747573054
345	213	134	3	131	11.8739500539
345	214	40	39	1	10.2317612556
345	215	62	5	57	7.88934229427
345	220	1	0	1	57.3095199774
345	222	2	0	2	59.8414637821
345	223	1	0	1	30.5394646749
345	224	9	2	7	20.5981456982
345	225	26	0	26	20.8013030547
345	226	4	1	3	16.6837260038
345	228	10	0	10	20.115327679
345	229	35	1	34	23.7742780295
345	230	7	1	6	29.1606728626
345	231	3	0	3	26.4805805212
345	232	7	3	4	24.0763677275
345	233	6	0	6	22.4345977071
345	234	1	0	1	29.4470413228
345	235	5	0	5	36.6297395101
345	236	27	0	27	31.0694682922
345	237	52	10	42	21.1860297978
345	238	1	0	1	35.947232174
345	239	13	0	13	27.491511646
345	241	1	0	1	60.0045968729
345	242	1	0	1	57.56449599
345	243	1	0	1	54.7816951735
345	245	3	0	3	61.9302161616
345	247	2	0	2	46.1972856116
345	250	2	0	2	55.0585652025
345	253	1	0	1	41.6231526518
345	257	1	0	1	67.2218273859
345	258	1	0	1	73.0093080978
345	261	1	0	1	71.715991388
345	264	1	0	1	66.2225262535
345	266	3	0	3	55.4052342584
345	268	1	0	1	53.2234583675
345	272	12	2	10	33.8424617592
345	276	1	0	1	37.2852699314
345	277	22	13	9	50.2070210239
345	279	1	0	1	58.8952039014
345	281	2	0	2	48.0120429546
345	282	2	0	2	43.3907680255
345	284	2	0	2	35.1758575057
345	287	1	0	1	40.0243270778
345	289	1	0	1	65.8669252666
345	291	10	0	10	27.2356483652
345	292	26	2	24	27.3249159687
345	293	12	0	12	29.0875480459
345	294	22	4	18	25.1365055856
345	297	8	0	8	20.2055557025
345	298	4	0	4	23.0899109827
345	299	1	0	1	32.9525294032
345	300	1	0	1	41.8975234038
345	302	2	1	1	36.7437491069
345	303	4	0	4	89.5879274981
345	304	1	0	1	86.6966893219
345	305	1	1	0	65.0957152196
345	307	3	1	2	76.6778714969
345	309	1	0	1	80.1574011677
345	310	38	0	38	38.3239951781
345	311	5	0	5	38.3130496921
345	312	5	1	4	41.9716715334
345	313	1	0	1	45.9347386993
345	314	1	0	1	41.8272483992
345	315	2	0	2	31.5886026075
345	316	3	0	3	33.8746689959
345	317	10	1	9	25.3485267198
345	319	13	0	13	90.6551278714
345	320	2	0	2	97.4188097705
345	323	1	0	1	95.0819021849
345	326	1	0	1	74.7285710755
345	327	1	0	1	88.7169108323
345	329	5	2	3	74.392589341
345	332	10	1	9	51.8057844709
345	334	2	0	2	59.1547259632
345	336	3	0	3	51.5382560684
345	338	78	9	69	59.9005552468
345	339	2	0	2	54.2577607699
345	341	5	2	3	47.6895637265
345	342	2	0	2	55.7366739754
345	346	119	2	117	22.6345371899
345	347	2	0	2	64.2353591345
345	348	5	1	4	55.2600614125
345	349	17	1	16	70.2914846582
345	350	11	0	11	41.0678714657
345	351	1	0	1	65.5060574991
345	353	1	0	1	58.6633895706
345	357	2	1	1	74.8906415924
345	361	0	0	0	81.8357598674
345	364	1	0	1	87.8469573415
345	365	0	0	0	72.0116285816
345	367	1	0	1	77.100375296
345	368	1	0	1	93.42694497
345	369	17	5	12	25.11729689
345	370	14	0	14	14.4093594988
345	371	307	21	286	6.02604806705
345	372	73	2	71	9.38305013597
345	373	41	7	34	31.8910617238
345	374	1	0	1	21.8902703824
345	375	799	68	731	17.3493249855
345	376	2	0	2	25.3974585412
345	377	26	1	25	30.7993829259
345	378	10	0	10	17.8481935066
345	379	1	0	1	146.751715847
345	385	1	0	1	141.459086846
345	408	2	0	2	165.268680654
345	411	0	0	0	160.507161189
345	417	0	0	0	155.177160055
345	426	3	0	3	203.089670484
345	444	1	0	1	189.531981041
345	458	1	0	1	147.30448371
345	465	1	0	1	153.44703908
345	466	1	0	1	159.637817816
345	469	1	0	1	146.184773696
345	475	0	0	0	137.536405824
345	477	1	0	1	151.895380744
345	491	1	1	0	155.221564824
345	493	1	0	1	175.874867564
345	507	4	0	4	216.087207545
345	512	1	0	1	195.279114087
345	524	2	0	2	159.309952682
345	525	0	0	0	163.540125887
345	528	1	0	1	177.675195423
345	529	1	0	1	172.421854922
345	537	1	0	1	167.624174147
345	549	2	0	2	201.832757847
345	555	0	0	0	131.408190187
345	563	3	0	3	127.913431685
345	567	1	0	1	129.468387095
345	568	0	0	0	117.026526867
345	573	12	2	10	118.52351232
345	576	1	0	1	98.1661283826
345	577	0	0	0	101.947678894
345	581	1	0	1	104.812023759
345	586	1	0	1	113.76451543
345	588	1	0	1	123.524602802
346	0	2	0	2	110.211970525
346	1	4	0	4	115.715125731
346	22	1	0	1	119.775659785
346	31	1	0	1	118.9328413
346	36	1	0	1	111.002447254
346	56	15	0	15	144.565728243
346	70	6	0	6	96.1950681479
346	71	1	0	1	106.243128617
346	73	49	4	45	102.451506496
346	74	8	0	8	103.344478798
346	75	1	0	1	104.748782192
346	76	1	0	1	98.2688745906
346	78	9	0	9	102.035721484
346	79	2	0	2	98.8195821659
346	81	4	0	4	98.2465125201
346	82	11	0	11	99.8221041519
346	83	3	0	3	101.795399214
346	84	5	0	5	103.053054003
346	85	3	0	3	100.750980287
346	86	2	0	2	105.126240427
346	87	5	0	5	106.078464306
346	88	2	0	2	106.725981137
346	90	1	0	1	96.5181778574
346	95	1	0	1	103.801690587
346	103	1	0	1	107.667539175
346	110	1	0	1	111.795717109
346	111	1	0	1	87.3993135841
346	112	4	0	4	107.452104939
346	113	1	0	1	110.174832122
346	120	1	0	1	98.4596233514
346	136	1	0	1	132.928695884
346	142	1	0	1	125.609690171
346	155	1	0	1	100.697635962
346	166	1	0	1	100.294629995
346	177	2	0	2	115.426592991
346	183	6	3	3	57.8765227499
346	184	1	0	1	62.2344134993
346	185	1	0	1	49.9794188232
346	186	1	0	1	45.9941440788
346	188	8	0	8	44.0968259869
346	191	3	1	2	33.332354655
346	192	1	0	1	24.4092534648
346	194	1	0	1	30.7995250893
346	196	127	106	21	12.2779520346
346	197	1	1	0	2.48241669888
346	198	12	1	11	20.7354912727
346	199	74	28	46	11.0064760915
346	200	38	2	36	13.7773480899
346	201	20	2	18	7.5275239875
346	202	9	2	7	18.2764209419
346	203	1	0	1	22.3828545657
346	204	2	0	2	37.8539951853
346	205	1	0	1	36.9171227729
346	206	4	0	4	32.2663099171
346	207	14	0	14	29.2888586337
346	208	74	0	74	24.1123668508
346	209	13	3	10	26.8571265815
346	210	2	0	2	25.9434129968
346	211	80	15	65	16.405506154
346	212	7	0	7	36.1433135003
346	213	68	5	63	19.2811549837
346	214	1	0	1	31.3532415841
346	215	1	0	1	30.5237852998
346	217	1	0	1	44.4442334114
346	219	1	0	1	45.0140986644
346	220	1	0	1	50.9124850583
346	223	2	0	2	28.5257703128
346	225	1	0	1	27.0108903586
346	226	5	3	2	20.3849689908
346	228	5	2	3	17.7749374337
346	229	19	6	13	25.0656692262
346	230	7	0	7	23.3306767181
346	231	1	0	1	40.2692874424
346	232	1	0	1	33.8836599134
346	233	2	0	2	34.8297871504
346	234	3	0	3	36.3725470561
346	236	2	0	2	41.5834833653
346	237	4	1	3	35.492435865
346	239	1	0	1	31.9620714885
346	241	0	0	0	43.5251732554
346	242	2	0	2	43.4539091347
346	244	4	0	4	37.7343249371
346	245	1	0	1	82.7791214587
346	253	1	0	1	62.8515049451
346	260	1	0	1	87.6239393625
346	262	0	0	0	71.284080095
346	272	1	0	1	48.9695750889
346	273	1	0	1	58.0357077447
346	277	5	1	4	66.321213833
346	282	1	0	1	62.0535290697
346	284	1	0	1	52.9049228656
346	291	1	0	1	43.3284983806
346	293	3	0	3	49.8532896044
346	298	1	0	1	43.3438193355
346	305	1	0	1	82.7151458909
346	307	1	0	1	94.468073973
346	310	2	0	2	60.6596804944
346	311	1	0	1	58.7833778193
346	312	1	0	1	61.3537007152
346	316	0	0	0	56.3829252161
346	318	1	0	1	101.051634748
346	319	1	0	1	112.409668852
346	329	3	0	3	96.6738354962
346	334	0	0	0	78.6014818186
346	336	1	0	1	72.9706350434
346	338	12	0	12	80.7069826674
346	340	2	1	1	67.3768154889
346	341	0	0	0	68.1093960657
346	345	225	9	216	22.6345371899
346	347	1	0	1	86.7355224845
346	349	1	0	1	91.9054758758
346	350	1	0	1	63.7005143584
346	353	1	1	0	80.8027697038
346	361	0	0	0	102.60982852
346	366	0	0	0	114.992975548
346	369	1	0	1	43.5581777065
346	370	2	1	1	36.9066436961
346	371	9	0	9	26.2009245209
346	372	4	0	4	30.9307259025
346	373	1	0	1	51.0656959089
346	375	65	0	65	36.8724378453
346	377	3	1	2	52.1366712011
346	378	2	0	2	40.4430203234
346	394	1	0	1	174.68516018
346	403	2	0	2	199.133390219
346	408	4	0	4	187.898264663
346	437	1	0	1	231.798853985
346	442	1	0	1	207.826124766
346	524	2	0	2	181.138801234
346	548	1	0	1	229.4895557
346	573	1	0	1	140.870453761
346	583	1	0	1	135.605662523
346	585	1	0	1	132.455160249
347	1	2	0	2	72.9456169451
347	23	1	0	1	73.1031504656
347	35	0	0	0	63.5390562246
347	36	2	0	2	50.7191503627
347	37	1	0	1	69.8143813902
347	39	1	0	1	51.3109156173
347	41	0	0	0	56.8164544699
347	70	234	0	234	25.932768843
347	71	24	1	23	29.9874419561
347	72	12	0	12	29.6224821648
347	73	779	17	762	32.9371815558
347	74	92	10	82	29.9408115845
347	75	65	19	46	33.8177526581
347	76	112	0	112	25.466027395
347	77	9	0	9	31.0321298975
347	78	147	0	147	28.2575525316
347	79	22	1	21	32.1072441171
347	80	4	0	4	30.2852867429
347	81	60	2	58	29.3265759519
347	82	111	45	66	27.6680422102
347	83	47	3	44	30.8849679524
347	84	80	3	77	32.2614338951
347	85	100	3	97	24.7159380263
347	86	31	16	15	27.8971272964
347	87	65	0	65	32.8423951751
347	88	29	6	23	31.9268958666
347	89	6	2	4	32.7790820168
347	90	26	1	25	18.6866466498
347	91	1	0	1	18.1727763316
347	92	11	5	6	27.1434720753
347	95	2	1	1	40.0734854462
347	96	56	0	56	13.9497785686
347	97	6	1	5	14.0137759344
347	98	2	0	2	27.0501216717
347	102	3	0	3	44.8674910709
347	103	11	0	11	38.2853816011
347	105	1	0	1	37.9892696013
347	107	1	0	1	32.469289885
347	108	0	0	0	14.2466243039
347	109	19	2	17	20.3706366086
347	110	4	0	4	42.1897179028
347	111	4	1	3	28.0179020168
347	112	14	3	11	40.5006023194
347	113	39	2	37	37.307963906
347	114	1	0	1	46.0409369919
347	116	49	2	47	22.9618365288
347	117	2	0	2	34.4488503082
347	119	5	0	5	21.6758771989
347	120	2	1	1	34.6861848594
347	121	1	0	1	35.2719026543
347	122	2	0	2	21.9700348689
347	142	6	0	6	49.4722643883
347	145	1	0	1	56.377413919
347	146	3	0	3	35.2922510742
347	155	153	59	94	16.2669615454
347	156	43	3	40	12.2348854056
347	158	4	1	3	29.6683870901
347	159	1	0	1	22.1469544632
347	160	2	0	2	41.1689745752
347	162	96	40	56	8.63786660434
347	163	1	0	1	52.1182496069
347	164	15	1	14	26.3585871518
347	165	4	0	4	34.017311877
347	166	177	0	177	13.5629574155
347	168	22	6	16	29.4138696383
347	169	218	65	153	8.89558639485
347	170	3	1	2	27.7990602589
347	171	54	4	50	21.1463159681
347	172	27	0	27	33.6566157447
347	173	2	0	2	34.0820468971
347	175	9	0	9	23.6862234501
347	177	31	0	31	30.351000038
347	179	49	28	21	6.20953023514
347	183	3	0	3	95.0064396553
347	186	1	1	0	85.0383918367
347	208	1	0	1	65.1321654572
347	220	2	0	2	107.823861526
347	236	1	0	1	69.8550699412
347	245	3	1	2	36.9069900632
347	270	1	0	1	68.9305356487
347	277	5	1	4	58.777049752
347	310	19	0	19	26.2008375261
347	312	1	0	1	35.6291253143
347	313	6	0	6	19.4903208321
347	314	0	0	0	25.8070839992
347	315	1	0	1	33.3471923913
347	316	1	0	1	32.7361307729
347	317	1	0	1	38.9099299066
347	319	84	21	63	29.9680219934
347	320	7	0	7	36.275545534
347	321	10	0	10	21.2722463811
347	323	4	0	4	31.5448296255
347	324	3	0	3	26.4701869364
347	325	1	0	1	40.4665382892
347	326	21	4	17	15.2381760035
347	327	2	0	2	31.2120527713
347	328	3	1	2	20.3560075271
347	329	70	35	35	11.4091423265
347	330	2	1	1	38.6783882723
347	331	2	0	2	23.7297938085
347	332	11	0	11	32.0988120958
347	333	2	0	2	35.7756897978
347	334	9	1	8	31.008019681
347	335	1	0	1	36.3552864738
347	336	3	0	3	19.8142612221
347	337	0	0	0	17.0886102079
347	338	135	48	87	21.8393871656
347	339	2	0	2	28.2196811003
347	340	2	0	2	39.6160449641
347	341	13	0	13	28.074168889
347	342	1	0	1	31.4937305685
347	344	5	0	5	30.785482193
347	345	2	0	2	64.2353591345
347	348	34	6	28	10.4654540912
347	349	114	3	111	15.9039272997
347	350	14	0	14	24.2998485947
347	351	14	1	13	12.377998934
347	352	8	0	8	13.4371231231
347	353	305	79	226	9.21973250031
347	354	35	33	2	6.50350240821
347	355	1	0	1	25.1983657317
347	357	5	0	5	23.2110255581
347	358	0	0	0	65.2791985901
347	359	1	0	1	34.7342670643
347	361	1	0	1	29.8079666337
347	364	2	0	2	34.5971813194
347	365	3	0	3	26.5739431932
347	367	13	1	12	20.0859118554
347	370	1	0	1	49.8491055644
347	373	2	0	2	41.9895995573
347	375	12	1	11	51.8355963031
347	377	1	0	1	36.3188306175
347	379	2	0	2	82.8637925258
347	385	0	0	0	77.3041927885
347	406	2	0	2	103.511100584
347	407	1	0	1	99.5702335375
347	408	2	0	2	102.191729479
347	411	1	0	1	96.998160135
347	453	1	0	1	89.012665506
347	469	1	0	1	89.3512485788
347	475	0	0	0	77.7514958638
347	480	1	0	1	92.2660298346
347	501	0	0	0	110.2736783
347	503	1	0	1	94.7291803112
347	507	1	0	1	157.509478667
347	512	1	0	1	132.982504343
347	524	1	0	1	96.4233154983
347	536	0	0	0	105.875809762
347	554	0	0	0	79.4123823433
347	563	1	0	1	65.1208509722
347	571	0	0	0	67.9301026863
347	573	17	0	17	54.4450722631
347	576	2	0	2	33.9992638044
347	577	4	0	4	38.7285060629
347	581	5	0	5	40.606779489
348	0	1	0	1	56.2491238656
348	1	7	1	6	68.6783484963
348	36	2	0	2	48.9368441577
348	39	1	0	1	47.3132671589
348	42	1	0	1	48.1299062646
348	70	171	0	171	25.0125054018
348	71	16	5	11	32.2866573355
348	72	9	2	7	27.8779076934
348	73	680	108	572	32.5922581769
348	74	37	8	29	30.923773671
348	75	32	0	32	34.1228965082
348	76	93	8	85	25.6718907647
348	77	11	0	11	29.4130855232
348	78	96	0	96	29.245224241
348	79	19	0	19	30.5795496667
348	80	7	0	7	29.2051268074
348	81	53	0	53	28.3089514765
348	82	80	19	61	27.8451945218
348	83	24	0	24	30.8866201075
348	84	56	4	52	32.3587473216
348	85	70	0	70	26.4526198479
348	86	20	3	17	30.5185795493
348	87	49	6	43	34.0108886427
348	88	13	0	13	33.7019521766
348	89	3	0	3	28.6719318522
348	90	28	0	28	20.7863627632
348	91	1	1	0	7.81582394074
348	92	17	0	17	24.2304797748
348	93	4	1	3	8.8764656038
348	94	3	1	2	12.3855355698
348	95	5	0	5	38.406141941
348	96	94	89	5	15.5558622967
348	97	29	23	6	5.05302316601
348	98	3	1	2	31.0499700383
348	99	1	0	1	47.4384407391
348	102	1	0	1	40.8760220282
348	103	18	1	17	38.3913616165
348	104	1	0	1	37.3757259975
348	107	1	0	1	36.9017101422
348	108	2	1	1	11.1116195451
348	109	20	14	6	19.4381392872
348	110	2	0	2	42.6707185137
348	111	15	7	8	23.0508473908
348	112	15	4	11	39.937144568
348	113	26	5	21	38.6643472806
348	114	1	0	1	45.0199056003
348	115	2	0	2	18.405141789
348	116	27	0	27	23.4960368881
348	117	1	0	1	36.2288631801
348	118	1	0	1	24.3769702054
348	119	6	1	5	25.3323031567
348	120	4	2	2	32.4254867026
348	121	3	0	3	37.3781413932
348	122	8	0	8	17.7762465849
348	140	2	0	2	44.6400207895
348	141	1	0	1	73.1533920996
348	142	4	0	4	52.6923609749
348	145	1	0	1	58.460894446
348	154	1	0	1	52.8670039827
348	155	21	0	21	22.8922318447
348	156	11	5	6	17.9084066075
348	158	1	0	1	37.9799614074
348	160	2	0	2	47.0053627078
348	162	8	1	7	16.5158026565
348	164	2	0	2	31.3119583722
348	166	22	0	22	23.1236968044
348	168	9	1	8	35.2414287066
348	169	89	11	78	11.3941169606
348	171	8	3	5	26.5554527506
348	172	5	0	5	39.9024260565
348	173	2	0	2	42.99233295
348	175	3	1	2	30.423995658
348	177	9	4	5	37.6577539375
348	179	34	19	15	7.099930814
348	183	2	0	2	84.615054467
348	208	1	0	1	55.5815847947
348	213	1	0	1	62.6278204232
348	220	1	0	1	97.3705589819
348	242	1	0	1	106.064693911
348	245	7	2	5	29.8306778894
348	247	3	0	3	14.402635825
348	251	10	0	10	16.6092775748
348	264	1	0	1	43.3473878516
348	267	1	0	1	65.4028009864
348	274	1	0	1	43.6172705398
348	277	8	1	7	49.033927319
348	282	1	0	1	38.7590608489
348	288	1	0	1	60.4525130775
348	293	1	0	1	34.7955081309
348	294	0	0	0	30.8169199156
348	310	37	6	31	18.6262929459
348	311	2	0	2	29.0036759889
348	313	2	0	2	14.2353836473
348	314	2	0	2	21.0228613697
348	315	2	0	2	23.806905096
348	316	1	0	1	22.6520985038
348	317	1	0	1	30.2666424145
348	318	1	0	1	30.0582663707
348	319	13	0	13	40.398010476
348	321	1	0	1	31.6724657161
348	323	1	0	1	41.7853137833
348	324	0	0	0	36.4588395359
348	326	1	0	1	25.2155870089
348	329	16	0	16	21.8739723088
348	333	0	0	0	36.5731208602
348	334	3	0	3	33.5729538156
348	335	3	0	3	34.9765126126
348	336	1	0	1	19.2367320262
348	338	25	9	16	25.3804777505
348	341	3	0	3	26.6518512221
348	342	2	1	1	32.951908443
348	345	4	0	4	55.2600614125
348	347	15	2	13	10.4654540912
348	349	13	1	12	24.4017040882
348	350	25	6	19	14.4107634784
348	351	2	1	1	19.6943395643
348	352	22	12	10	5.95483677281
348	353	43	0	43	12.4160597939
348	354	0	0	0	16.5746440626
348	359	0	0	0	42.2708957261
348	363	1	0	1	76.2550998478
348	365	0	0	0	33.6146048062
348	369	1	0	1	42.0606303335
348	372	1	0	1	47.4529099625
348	373	1	0	1	36.8039799741
348	375	19	2	17	44.405081065
348	377	2	0	2	29.6849025912
348	408	1	0	1	110.151439287
348	413	1	0	1	116.859822401
348	415	1	0	1	99.4631223221
348	426	1	0	1	147.982365413
348	469	0	0	0	94.302215247
348	493	0	0	0	124.652066164
348	503	1	0	1	101.527539442
348	524	1	0	1	106.635580534
348	536	1	0	1	116.272378489
348	540	0	0	0	128.056681375
348	563	1	1	0	75.4104453966
348	573	4	1	3	64.2361509476
348	576	1	0	1	43.7696578149
348	581	3	0	3	49.8481689364
349	1	5	1	4	88.3074192608
349	19	1	0	1	73.3783935696
349	23	5	0	5	87.8226473825
349	32	1	0	1	69.441196616
349	34	1	0	1	78.0226879339
349	35	1	0	1	77.4976067433
349	36	5	0	5	65.115988987
349	39	2	0	2	66.7164230229
349	41	3	0	3	70.7371257562
349	47	1	0	1	109.052645215
349	51	1	0	1	85.3301267893
349	56	1	0	1	99.1625682191
349	65	1	0	1	109.883277955
349	70	143	0	143	40.6935895416
349	71	26	0	26	42.387255157
349	72	6	0	6	44.5744501898
349	73	645	0	645	47.0397870323
349	74	43	0	43	43.3626433411
349	75	71	1	70	47.4683207437
349	76	136	15	121	39.6892441779
349	77	5	1	4	45.8760650976
349	78	98	4	94	41.7962560309
349	79	12	1	11	46.8692287677
349	80	6	0	6	44.9071370955
349	81	45	1	44	43.9616056592
349	82	99	0	99	41.7574509624
349	83	24	3	21	44.885846781
349	84	85	0	85	46.1287145293
349	85	61	11	50	38.0375332763
349	86	29	5	24	40.209677455
349	87	74	48	26	45.9382108148
349	88	26	0	26	44.6110492399
349	89	1	0	1	48.4251721616
349	90	29	0	29	32.4655753847
349	92	5	0	5	42.5925233728
349	94	2	1	1	34.4636631675
349	95	4	1	3	54.6508391687
349	96	38	15	23	28.6928793671
349	97	1	0	1	29.0010314662
349	98	2	0	2	38.1295383888
349	99	3	0	3	59.305375741
349	102	1	0	1	60.3337639896
349	103	23	0	23	51.8589873007
349	104	2	0	2	55.3849400211
349	105	1	0	1	53.5235203069
349	107	4	0	4	42.4536929427
349	109	31	8	23	35.474379652
349	110	7	1	6	55.3314746223
349	111	3	0	3	43.8633499477
349	112	23	1	22	54.4294860808
349	113	60	5	55	49.9926624931
349	114	1	0	1	60.0892418262
349	116	16	0	16	37.1990890054
349	117	5	0	5	46.9550084525
349	118	1	0	1	35.3594756605
349	119	8	1	7	33.8264726906
349	120	1	0	1	49.690696157
349	131	1	0	1	87.0358018488
349	138	1	0	1	68.7406927018
349	140	2	1	1	54.6721545508
349	142	9	0	9	59.7112883423
349	146	7	0	7	46.608926105
349	154	2	0	2	54.5339537752
349	155	158	26	132	26.2661954015
349	156	40	0	40	24.6384159408
349	158	9	0	9	33.3608923946
349	159	4	0	4	26.0622015025
349	160	1	0	1	48.3990369514
349	161	1	0	1	50.7656111166
349	162	12	1	11	20.1076968894
349	163	3	0	3	57.2023626455
349	164	9	1	8	36.439855225
349	166	441	11	430	18.5141544185
349	167	2	0	2	48.1842713378
349	168	32	10	22	37.8926540078
349	169	128	21	107	24.2153224621
349	170	4	0	4	28.0002096114
349	171	74	30	44	31.5392975399
349	172	39	2	37	40.9533577166
349	173	1	0	1	35.4337099329
349	175	5	0	5	31.6881431179
349	177	34	7	27	36.1741498651
349	179	6	0	6	22.1008641087
349	180	1	0	1	42.0477702911
349	183	3	0	3	107.808987703
349	208	2	0	2	72.6584152045
349	222	0	0	0	117.014491517
349	229	1	0	1	88.5927653217
349	245	4	1	3	52.7775079134
349	251	1	0	1	40.6548214597
349	253	2	0	2	50.3448164777
349	257	2	0	2	61.8013260958
349	258	2	0	2	67.247242725
349	264	7	1	6	66.5961746415
349	266	1	0	1	90.3893033445
349	277	5	0	5	73.3918604451
349	282	1	0	1	62.9332308264
349	286	1	0	1	57.61681181
349	293	3	0	3	56.6753519325
349	294	1	0	1	49.4504411657
349	303	7	0	7	86.7196994686
349	307	1	0	1	76.9580888856
349	310	20	1	19	32.7930112847
349	311	1	1	0	33.7386755272
349	312	7	2	5	33.2751898031
349	313	3	0	3	24.956854762
349	314	2	0	2	28.505604811
349	316	1	1	0	43.2418343527
349	317	1	0	1	45.6221571818
349	318	95	34	61	9.35320957182
349	319	808	118	690	20.5401526713
349	320	54	3	51	27.2707999851
349	321	59	19	40	13.0596789701
349	322	2	1	1	27.9801097569
349	323	74	4	70	27.1262644712
349	324	34	1	33	13.8277915678
349	325	3	1	2	29.8201629953
349	326	692	299	393	6.19381065863
349	327	14	2	12	18.6667506987
349	328	13	1	12	16.5247957298
349	329	738	362	376	11.1902521409
349	330	5	1	4	30.7263330483
349	331	7	1	6	21.5044004484
349	332	34	0	34	25.8068801724
349	333	7	0	7	27.8771030163
349	334	52	13	39	21.2818556622
349	335	2	1	1	31.6418392748
349	336	8	2	6	18.9552376367
349	337	2	0	2	20.4147153923
349	338	728	193	535	13.2794522118
349	339	15	1	14	21.4668972377
349	340	4	0	4	33.312195995
349	341	52	7	45	25.216124812
349	342	14	0	14	23.3673207942
349	344	7	3	4	18.6159282797
349	345	10	2	8	70.2914846582
349	347	67	0	67	15.9039272997
349	348	7	3	4	24.4017040882
349	350	17	5	12	35.0501110439
349	351	176	129	47	5.17919359718
349	352	1	0	1	23.9717750321
349	353	358	0	358	13.2684037098
349	354	53	10	43	10.0491499522
349	355	66	0	66	10.9593523012
349	356	2	0	2	28.127442512
349	357	283	15	268	7.35465078067
349	358	2	0	2	49.573117608
349	359	13	1	12	18.9036642981
349	361	27	17	10	14.4229612691
349	362	6	1	5	17.1785632779
349	363	0	0	0	52.5575112056
349	364	16	0	16	19.8863046676
349	365	24	0	24	11.257813273
349	366	5	0	5	24.4318415521
349	367	287	110	177	6.80893620017
349	369	1	0	1	49.7225532774
349	370	3	0	3	56.1409799746
349	372	1	0	1	61.1915350932
349	373	3	1	2	42.3859790533
349	375	23	2	21	55.2418218406
349	377	6	1	5	39.7698854887
349	379	2	0	2	82.1686531491
349	385	1	0	1	75.5931833047
349	387	1	0	1	81.0130181736
349	400	1	0	1	107.751549954
349	401	2	0	2	105.134001753
349	402	2	0	2	100.754289622
349	406	1	0	1	104.99536529
349	408	19	2	17	102.854351665
349	411	6	0	6	96.9583957296
349	415	2	0	2	92.4657706601
349	416	1	0	1	111.909942084
349	426	1	0	1	139.999049474
349	438	0	0	0	121.081067387
349	441	0	0	0	117.604904757
349	442	0	0	0	121.558698233
349	443	1	0	1	139.31732068
349	452	1	0	1	84.9040279779
349	453	1	0	1	90.5030299557
349	475	1	0	1	82.7771113194
349	507	2	1	1	146.778671368
349	509	0	0	0	152.962647167
349	512	2	0	2	125.003365276
349	520	1	0	1	95.2135579361
349	524	5	0	5	89.2464262957
349	550	1	0	1	141.029878981
349	554	1	0	1	72.183997288
349	555	3	0	3	61.1235430868
349	556	1	0	1	76.016702777
349	561	1	0	1	80.0833626025
349	563	1	0	1	57.9894668833
349	566	1	0	1	63.8129018615
349	568	1	0	1	53.6365795037
349	570	4	0	4	38.2111704321
349	572	1	0	1	40.140304647
349	573	83	4	79	50.715144751
349	574	1	0	1	71.6331320034
349	575	1	0	1	48.8593709279
349	576	5	2	3	32.1077874023
349	577	10	2	8	33.0037017206
349	579	8	0	8	36.7856636371
349	580	3	0	3	46.6354313736
349	581	10	1	9	40.1025456483
349	583	1	0	1	53.6625651439
349	585	12	0	12	41.6144123643
349	586	4	1	3	45.6466940962
349	588	1	0	1	57.3559587708
350	0	1	0	1	60.4967001078
350	1	4	0	4	71.3690961344
350	21	0	0	0	77.4640147688
350	24	1	0	1	73.0126215268
350	32	2	0	2	51.3814587134
350	36	1	0	1	55.7952998823
350	39	1	0	1	51.4169808116
350	70	145	0	145	34.84745682
350	71	22	0	22	43.938803887
350	72	9	0	9	36.5559527367
350	73	521	14	507	42.103110111
350	74	41	8	33	41.7047399023
350	75	29	4	25	44.0883437885
350	76	116	31	85	36.3553294283
350	77	1	0	1	38.0269585224
350	78	71	0	71	40.1715082446
350	79	7	1	6	39.1516447406
350	80	1	0	1	38.3710016923
350	81	47	1	46	37.6372068626
350	82	67	0	67	38.2672114726
350	83	26	7	19	40.862036321
350	84	63	5	58	42.2862688263
350	85	59	9	50	38.159552586
350	86	14	1	13	42.4978830601
350	87	50	0	50	44.7066906599
350	88	18	1	17	44.887403391
350	89	5	0	5	34.5135553515
350	90	24	1	23	33.2744670184
350	91	2	0	2	6.98274011202
350	92	9	0	9	32.2389334402
350	94	1	0	1	19.9936826367
350	95	4	0	4	46.0910589674
350	96	44	1	43	28.4899044729
350	97	5	0	5	14.3842586655
350	101	1	0	1	25.0379532201
350	103	11	3	8	47.8704306962
350	104	1	0	1	43.7442276605
350	109	9	0	9	30.1521789485
350	111	6	0	6	28.7664971829
350	112	12	1	11	48.6665747039
350	113	18	0	18	49.2224817582
350	114	1	0	1	52.954232718
350	116	10	0	10	34.684747252
350	117	1	0	1	47.2639525755
350	118	3	0	3	36.5925243122
350	119	2	0	2	38.2408131556
350	120	2	0	2	40.0148060347
350	121	1	0	1	48.5985962839
350	123	1	0	1	29.1268555107
350	141	1	0	1	86.6162545835
350	144	1	0	1	61.2417298712
350	155	21	0	21	37.0160995119
350	156	5	1	4	31.9883542306
350	162	1	0	1	30.9214844507
350	164	2	0	2	44.5626201269
350	166	22	0	22	37.4677666916
350	167	1	0	1	67.9947740305
350	168	4	1	3	48.7806414232
350	169	26	3	23	25.3047557943
350	171	10	0	10	40.1795682477
350	172	4	0	4	53.53512265
350	175	1	0	1	44.4131697577
350	177	11	0	11	51.7279719548
350	179	8	1	7	21.4353695697
350	182	1	0	1	81.398311218
350	183	2	0	2	72.8371287328
350	205	1	0	1	27.6787193141
350	207	1	0	1	40.6199317119
350	213	1	0	1	48.2177116409
350	220	1	0	1	84.1967537552
350	224	1	0	1	46.4578717368
350	245	12	1	11	30.6783158146
350	247	40	35	5	8.98302734579
350	251	14	1	13	17.4807715227
350	253	4	0	4	17.366313655
350	254	1	0	1	24.7050918314
350	271	1	0	1	48.93977374
350	276	1	0	1	26.2050006442
350	277	12	6	6	40.9518273578
350	282	1	0	1	29.8352643145
350	292	2	0	2	30.4593782294
350	293	10	0	10	21.640055947
350	294	48	8	40	16.40699844
350	296	5	0	5	10.8701278599
350	298	1	0	1	26.2615591027
350	300	1	0	1	10.3488220691
350	301	1	1	0	16.3445364436
350	310	367	7	360	9.17606479971
350	311	2	0	2	22.4663778548
350	312	2	0	2	27.9094281454
350	313	9	1	8	12.5203075109
350	314	17	1	16	16.0986483099
350	315	16	8	8	9.48388310024
350	316	29	3	26	8.47744844707
350	317	18	0	18	16.7120413661
350	319	17	0	17	53.451224443
350	320	2	1	1	60.0250853721
350	326	4	1	3	37.5735050434
350	329	10	3	7	35.4290648086
350	331	2	0	2	48.0227046005
350	332	4	0	4	31.8326294304
350	333	1	0	1	36.3118781247
350	334	1	0	1	36.0736437644
350	336	5	0	5	21.3805098794
350	337	1	0	1	16.7427896229
350	338	67	33	34	30.5423180594
350	339	3	0	3	30.6081173109
350	340	1	1	0	36.4101218602
350	341	7	0	7	25.1587256491
350	342	2	0	2	34.1077772743
350	344	2	1	1	39.4208732718
350	345	5	0	5	41.0678714657
350	347	7	0	7	24.2998485947
350	348	71	4	67	14.4107634784
350	349	14	1	13	35.0501110439
350	351	1	0	1	29.8784981602
350	352	32	7	25	11.3639387534
350	353	23	4	19	21.7894353052
350	357	1	0	1	41.6320027677
350	361	0	0	0	49.0905944137
350	365	0	0	0	41.6592259753
350	367	1	0	1	41.3505288598
350	369	1	0	1	31.212811515
350	370	1	0	1	27.0664776464
350	373	6	1	5	27.845658272
350	375	90	38	52	31.8287817185
350	376	1	0	1	37.1539777744
350	377	17	2	15	19.2829934162
350	378	2	0	2	23.3038423613
350	408	2	0	2	124.201857393
350	415	1	0	1	113.516096966
350	469	0	0	0	106.568245733
350	491	0	0	0	116.60018776
350	524	1	0	1	120.71858883
350	548	0	0	0	177.430992968
350	554	2	0	2	103.696046521
350	555	1	0	1	93.9443543113
350	566	1	0	1	90.0418353099
350	573	7	2	5	78.5808286044
350	574	1	0	1	99.0800509251
350	577	1	0	1	63.0116407616
350	579	1	0	1	65.2774102758
350	581	0	0	0	64.2589319282
350	583	1	0	1	87.9917092795
350	585	1	0	1	76.1229007673
350	588	1	0	1	92.3287613784
351	1	2	0	2	85.321993583
351	14	1	0	1	74.2960165308
351	38	1	0	1	71.0167293206
351	70	35	10	25	38.1231931798
351	71	6	4	2	41.0164674653
351	72	2	0	2	41.8905238903
351	73	103	21	82	44.8809924045
351	74	5	0	5	41.533722033
351	75	12	1	11	45.5506951539
351	76	16	0	16	37.4261337006
351	77	0	0	0	43.2684358748
351	78	15	1	14	39.8990748804
351	81	4	0	4	41.4816496743
351	82	10	2	8	39.5790180631
351	83	6	0	6	42.7720191065
351	84	7	1	6	44.0920439555
351	85	11	1	10	36.2111113435
351	86	6	3	3	38.8536027727
351	87	9	1	8	44.2828677599
351	88	5	0	5	43.1348398665
351	90	2	1	1	30.3605308645
351	92	2	1	1	39.5175620509
351	96	4	1	3	26.0532760919
351	97	1	0	1	24.474489228
351	103	5	0	5	50.0016268614
351	109	3	1	2	32.6586581394
351	110	1	0	1	53.7049758647
351	112	4	0	4	52.3941044825
351	113	15	1	14	48.5542008998
351	116	6	0	6	34.9114354643
351	120	1	0	1	46.9799443778
351	129	1	0	1	61.5550527374
351	142	1	0	1	59.3584867465
351	146	1	0	1	45.7305730399
351	155	19	5	14	25.4715395925
351	156	2	0	2	22.9181566804
351	158	1	0	1	34.8568982569
351	159	2	0	2	27.2368495601
351	160	2	0	2	49.0343890075
351	162	2	1	1	18.4499569748
351	164	2	0	2	35.9006874458
351	166	53	0	53	18.8250446589
351	168	4	0	4	37.9490875802
351	169	8	2	6	21.1874050473
351	171	14	1	13	30.7795763922
351	172	7	1	6	41.4647937938
351	175	3	0	3	31.7624480075
351	177	6	1	5	37.0748975639
351	179	3	1	2	18.3403756954
351	277	1	0	1	68.5209433113
351	310	2	2	0	27.7526539314
351	311	1	0	1	29.6573228163
351	312	1	0	1	29.8578255992
351	313	2	1	1	19.9090492015
351	314	1	0	1	23.869318824
351	317	1	0	1	40.6621333568
351	318	8	0	8	13.7644798421
351	319	93	33	60	25.1514287897
351	320	5	0	5	31.9148400108
351	321	4	2	2	17.0599197566
351	322	2	0	2	32.2288823844
351	323	7	0	7	30.726824999
351	324	3	0	3	18.8864357886
351	325	1	0	1	34.7655164449
351	326	47	1	46	9.46526288127
351	327	4	2	2	23.7673149153
351	328	1	0	1	19.4695125143
351	329	67	13	54	11.9686926198
351	330	2	0	2	35.2098630514
351	331	2	1	1	24.2943374555
351	332	6	1	5	23.4758359739
351	333	1	0	1	26.2499021549
351	334	10	1	9	20.3223690259
351	336	5	0	5	14.6324056454
351	338	203	27	176	11.2954149504
351	339	1	0	1	19.1568337921
351	341	15	2	13	21.7160837825
351	342	6	1	5	21.7126838616
351	344	1	0	1	18.9905672254
351	345	2	0	2	65.5060574991
351	347	22	1	21	12.377998934
351	348	2	0	2	19.6943395643
351	349	420	385	35	5.17919359718
351	350	1	0	1	29.8784981602
351	352	1	0	1	18.8546755856
351	353	134	0	134	8.11425490314
351	354	14	1	13	8.04296998956
351	355	1	0	1	16.1373717006
351	357	25	0	25	12.0652392984
351	358	1	0	1	54.1442488712
351	359	1	0	1	22.7379918475
351	360	1	0	1	41.744844751
351	364	2	0	2	25.0035969967
351	365	4	0	4	14.3030234694
351	367	26	1	25	11.7827135771
351	371	2	0	2	61.1227669415
351	373	1	0	1	38.4325538645
351	375	7	0	7	50.8033672791
351	377	2	0	2	35.194391274
351	385	1	0	1	79.0232232195
351	408	2	0	2	105.763418493
351	411	2	0	2	100.037119058
351	436	1	0	1	143.584643137
351	442	1	1	0	124.736170986
351	527	1	0	1	108.262668217
351	536	1	0	1	99.1497863828
351	555	0	0	0	65.9274203308
351	563	1	0	1	62.512360378
351	566	1	0	1	67.3710951868
351	573	13	0	13	54.4866382998
351	577	1	0	1	37.0394950262
351	579	1	0	1	40.5253387182
351	581	1	0	1	42.9442312992
351	585	1	0	1	46.7116870933
351	588	1	0	1	62.4923844258
352	0	1	0	1	61.4113665523
352	1	5	0	5	73.5379921718
352	3	1	1	0	57.3791052812
352	36	1	0	1	54.5579101351
352	70	113	0	113	30.8983628902
352	71	18	1	17	38.2193638992
352	72	9	1	8	33.6497110303
352	73	395	0	395	38.4814036241
352	74	25	0	25	36.877089357
352	75	22	0	22	40.0492622625
352	76	63	7	56	31.6168037593
352	77	2	0	2	35.1874310408
352	78	68	8	60	35.1995591295
352	79	12	0	12	36.3561433231
352	80	4	0	4	35.0455882095
352	81	37	8	29	34.1621709159
352	82	48	2	46	33.783075853
352	83	15	0	15	36.8061265861
352	84	45	2	43	38.2788482141
352	85	44	0	44	32.3930326458
352	86	15	1	14	36.4284897453
352	87	43	1	42	39.9644233426
352	88	6	1	5	39.6533715612
352	89	6	0	6	33.9441431642
352	90	26	0	26	26.675420823
352	91	0	0	0	7.15022515038
352	92	4	0	4	29.8625053172
352	94	1	0	1	17.5812465454
352	95	3	0	3	44.1050625655
352	96	35	0	35	21.4127545265
352	97	7	5	2	9.90078721781
352	98	1	1	0	36.8304967357
352	99	1	0	1	53.3671711538
352	103	6	1	5	44.2939365147
352	107	2	0	2	42.6551080529
352	109	13	0	13	25.3651609819
352	111	6	0	6	28.1867359025
352	112	7	1	6	45.7752359701
352	113	9	1	8	44.6177443934
352	114	1	0	1	50.7812394959
352	115	0	0	0	23.1519212179
352	116	24	3	21	29.4504892003
352	118	1	0	1	30.282346663
352	120	2	0	2	38.0712686706
352	121	1	0	1	43.3258163555
352	122	0	0	0	23.295253896
352	142	5	3	2	58.6090409784
352	155	28	1	27	28.0381729005
352	156	7	1	6	23.1796204052
352	159	1	0	1	35.3327538994
352	162	4	0	4	21.074400195
352	166	12	1	11	26.954166545
352	168	4	0	4	40.7289193894
352	169	36	6	30	16.9599234748
352	171	13	1	12	32.0580462665
352	172	7	1	6	45.3153678703
352	175	1	0	1	35.6357664064
352	177	2	0	2	42.7388875676
352	179	13	5	8	12.3425366307
352	207	1	0	1	51.7222974896
352	212	1	0	1	46.9321140183
352	245	3	0	3	33.8167757627
352	247	2	1	1	15.0694290288
352	251	2	1	1	19.9941709121
352	277	0	0	0	50.1055513167
352	284	1	0	1	42.1683939747
352	287	1	0	1	46.59454431
352	294	3	0	3	27.1886008303
352	300	1	0	1	19.4577920085
352	307	1	0	1	58.3449049421
352	310	129	58	71	13.167643789
352	311	3	1	2	23.0499950117
352	312	2	0	2	26.9232747376
352	313	13	0	13	8.29906537691
352	314	5	1	4	15.0708587547
352	315	1	0	1	19.9911907524
352	316	4	2	2	19.8147580412
352	317	2	0	2	25.5378409478
352	319	21	4	17	42.0922119072
352	321	1	0	1	33.3584163896
352	323	1	0	1	44.7953490345
352	325	1	0	1	52.369375277
352	326	3	0	3	26.2164601156
352	329	7	2	5	24.21374372
352	332	3	0	3	27.1027532597
352	334	2	0	2	29.2348179488
352	335	2	0	2	29.3503352424
352	336	2	1	1	14.3263058572
352	337	7	0	7	9.33274551607
352	338	47	5	42	21.8466366217
352	341	3	0	3	21.1471860587
352	342	1	0	1	28.1948846195
352	345	3	0	3	50.8268353857
352	347	17	7	10	13.4371231231
352	348	145	39	106	5.95483677281
352	349	15	0	15	23.9717750321
352	350	78	9	69	11.3639387534
352	353	113	2	111	10.7575320683
352	354	1	0	1	18.2698196885
352	365	1	0	1	31.6499728134
352	371	1	0	1	47.4686356885
352	372	1	0	1	42.6434302293
352	373	1	0	1	30.8915080955
352	374	1	0	1	46.5939056644
352	375	27	4	23	39.0440297213
352	376	1	0	1	42.0536413576
352	377	5	1	4	23.9932563697
352	408	2	0	2	115.095231701
352	417	1	0	1	104.750371372
352	507	0	0	0	169.752920092
352	572	1	0	1	62.0616022406
352	573	5	0	5	67.8712003049
352	577	1	0	1	51.8969967583
352	581	1	0	1	53.9858716869
353	1	1	0	1	80.2321226627
353	10	1	0	1	71.7526527725
353	32	1	0	1	60.5982717898
353	36	3	0	3	59.033611309
353	70	142	36	106	34.2995357303
353	71	15	1	14	39.1202292945
353	72	8	0	8	37.7682266673
353	73	554	234	320	41.5741080349
353	74	73	0	73	38.8648013363
353	75	24	1	23	42.6291694201
353	76	75	1	74	34.1537297253
353	77	6	0	6	39.2433579908
353	78	94	3	91	37.1654454229
353	79	5	0	5	40.3647185807
353	80	6	2	4	38.6696181678
353	81	24	9	15	37.7176862018
353	82	84	19	65	36.3812985358
353	83	21	0	21	39.5927182556
353	84	47	12	35	41.0080408388
353	85	55	1	54	33.7250939374
353	86	29	2	27	37.0528169278
353	87	31	7	24	41.8260202444
353	88	9	2	7	41.003315332
353	89	3	1	2	39.9362766764
353	90	13	9	4	27.6667445728
353	92	3	0	3	34.7785451914
353	93	1	0	1	21.0712045059
353	95	2	0	2	48.3617822462
353	96	24	1	23	22.6698278263
353	97	1	0	1	17.434123747
353	98	3	0	3	36.2696345083
353	99	1	0	1	55.601738901
353	102	2	0	2	52.1929200769
353	103	5	0	5	47.0837426525
353	107	2	0	2	41.6632063236
353	109	6	0	6	28.5979542553
353	110	3	0	3	51.0954928629
353	112	11	0	11	49.1402296508
353	113	27	0	27	46.3507041913
353	114	1	0	1	54.5811378586
353	116	26	3	23	31.6889874052
353	117	2	1	1	43.5400066004
353	118	2	0	2	31.1866866688
353	119	1	0	1	30.8784352448
353	121	1	0	1	44.4074940915
353	122	1	0	1	28.8705216004
353	140	2	0	2	51.8791591561
353	142	5	0	5	58.6919664889
353	146	2	0	2	44.4992094897
353	155	37	3	34	25.3100993355
353	156	12	2	10	21.4519696535
353	158	1	0	1	37.6139436926
353	159	1	0	1	29.9006824871
353	162	19	11	8	17.6551510275
353	164	6	0	6	35.5338049677
353	165	2	0	2	42.0539225248
353	166	80	2	78	21.0321313819
353	168	14	0	14	38.4347512502
353	169	73	8	65	17.4778561496
353	170	1	0	1	34.5192559934
353	171	6	1	5	30.3106585861
353	172	15	1	14	42.5321024301
353	173	1	0	1	41.4013551297
353	175	3	1	2	32.5467102014
353	177	17	0	17	38.8757206685
353	179	16	6	10	13.3950401628
353	183	2	0	2	94.5465183334
353	196	1	0	1	88.5455206467
353	224	1	0	1	67.5150575119
353	237	1	0	1	60.9608608219
353	247	1	0	1	25.5655044113
353	248	1	0	1	35.5743320261
353	270	2	0	2	72.22200184
353	277	1	0	1	60.6559265231
353	281	1	0	1	50.8478259265
353	294	1	0	1	36.6011902591
353	310	58	9	49	20.4340369601
353	311	6	1	5	24.9912078188
353	312	1	0	1	26.6806355189
353	313	19	3	16	12.7301676916
353	314	11	5	6	17.9867342511
353	315	1	0	1	29.4638383528
353	316	1	0	1	30.0392134415
353	318	2	0	2	21.0587690179
353	319	126	4	122	32.350509573
353	320	6	0	6	39.0731832497
353	321	7	0	7	23.8042796998
353	322	1	0	1	38.8445167287
353	323	7	0	7	36.5135208105
353	324	2	0	2	26.728126725
353	326	45	18	27	16.2811527451
353	327	2	0	2	31.6445832268
353	328	1	0	1	24.9296129833
353	329	73	34	39	16.002090653
353	331	1	0	1	29.279485631
353	332	27	3	24	22.9059137324
353	333	2	0	2	26.6797745796
353	334	20	3	17	22.3566103881
353	336	9	0	9	10.7046247762
353	337	10	3	7	8.98158437037
353	338	523	201	322	13.4887142034
353	339	3	1	2	19.115430693
353	340	5	1	4	30.3979118097
353	341	42	0	42	18.9429664129
353	342	4	1	3	22.5005010491
353	343	3	0	3	32.6056231231
353	344	2	0	2	22.9766233991
353	345	3	0	3	58.6633895706
353	347	208	101	107	9.21973250031
353	348	63	0	63	12.4160597939
353	349	237	54	183	13.2684037098
353	350	31	2	29	21.7894353052
353	351	40	7	33	8.11425490314
353	352	23	1	22	10.7575320683
353	354	51	0	51	9.9762132342
353	355	3	1	2	24.1961077356
353	356	1	0	1	40.6127909966
353	357	29	1	28	20.0802508763
353	359	5	0	5	30.0170281128
353	361	4	0	4	27.4807782895
353	364	2	0	2	33.1174118151
353	365	3	0	3	21.3007783283
353	366	1	0	1	37.5842874682
353	367	20	1	19	19.6219470128
353	373	1	0	1	33.7796496708
353	375	13	0	13	44.8615286682
353	377	5	1	4	29.1334321563
353	378	1	0	1	42.2229038967
353	385	1	0	1	84.0151240799
353	386	0	0	0	85.6577902773
353	394	1	0	1	95.4128982302
353	408	3	0	3	109.822143079
353	415	1	0	1	99.2167953369
353	418	1	0	1	102.469829617
353	419	2	0	2	117.915367207
353	425	1	0	1	129.759374414
353	455	1	0	1	73.8701503152
353	465	0	0	0	104.391608656
353	471	2	0	2	104.911353521
353	484	0	0	0	115.063203983
353	507	0	0	0	159.663799676
353	512	1	0	1	136.901498546
353	524	1	0	1	100.718257828
353	530	1	0	1	112.630945707
353	554	0	0	0	83.6186363099
353	555	0	0	0	73.1728537068
353	563	1	0	1	69.3014131347
353	566	1	0	1	72.628252191
353	567	1	0	1	70.8261346561
353	569	2	0	2	52.8114744549
353	572	0	0	0	52.343472675
353	573	24	0	24	60.1635287544
353	579	2	0	2	46.3124132534
353	581	5	2	3	47.4124563492
353	585	1	0	1	54.5287254371
353	586	5	0	5	58.8978632198
354	1	1	0	1	78.2592250624
354	25	1	0	1	97.0601256205
354	36	1	0	1	55.2170121267
354	70	60	4	56	30.6829378106
354	71	8	0	8	33.0171738833
354	72	1	0	1	34.5458234209
354	73	222	18	204	37.1763527385
354	74	22	3	19	33.6683490738
354	75	19	4	15	37.7279322513
354	76	30	9	21	29.7708964025
354	77	3	0	3	35.8624702572
354	78	37	6	31	32.059018914
354	79	8	2	6	36.8691742585
354	81	15	2	13	33.9770743518
354	82	29	6	23	31.8775895051
354	83	9	1	8	35.0401313982
354	84	22	5	17	36.3225629978
354	85	29	1	28	28.3352768038
354	86	8	1	7	30.8491140873
354	87	26	0	26	36.3597376801
354	88	8	2	6	35.1605573067
354	89	1	0	1	38.4130423311
354	90	10	0	10	22.5987517743
354	92	3	0	3	32.5509850963
354	95	1	0	1	44.6963841268
354	96	6	2	4	18.6543729616
354	103	6	0	6	42.1587325541
354	107	1	0	1	34.0471710854
354	109	4	0	4	25.4266300693
354	110	1	0	1	45.7827598119
354	111	1	0	1	33.9719786961
354	112	3	2	1	44.6337764811
354	113	8	0	8	40.5766522282
354	116	14	6	8	27.2667978308
354	118	4	1	3	25.657613715
354	142	1	0	1	51.3525250211
354	146	1	0	1	37.6876070734
354	154	1	0	1	47.5958444557
354	155	55	15	40	17.4495351897
354	156	13	0	13	14.9637465992
354	158	3	0	3	27.9655674464
354	159	1	0	1	20.2357020673
354	162	17	2	15	10.4540930607
354	164	2	0	2	27.8918322901
354	165	1	0	1	32.4243024682
354	166	118	15	103	11.4413040399
354	167	1	0	1	43.8154842999
354	168	4	0	4	30.0953022919
354	169	51	1	50	14.1998934554
354	170	2	1	1	24.5490989107
354	171	26	0	26	22.7499554255
354	172	13	1	12	33.7952976594
354	175	5	2	3	23.9548019469
354	177	15	3	12	29.676002157
354	179	13	6	7	12.5922683691
354	252	1	1	0	46.2083473574
354	258	1	0	1	57.3866094851
354	294	0	0	0	45.3777066411
354	303	1	0	1	76.7261155725
354	310	7	1	6	29.9435570662
354	311	1	0	1	34.8443698535
354	312	3	1	2	36.0641641181
354	313	0	0	0	22.4836439734
354	318	6	2	4	13.5113608557
354	319	83	5	78	23.9595661585
354	320	2	0	2	30.4621904041
354	321	5	1	4	15.2033409608
354	323	10	0	10	26.8210590007
354	324	1	0	1	19.9993883162
354	326	41	6	35	8.74725771271
354	328	3	1	2	15.2660760704
354	329	105	0	105	6.12658444497
354	331	1	0	1	19.3867228703
354	332	4	0	4	30.8216973056
354	334	3	1	2	28.2759933102
354	338	85	5	80	19.1238646874
354	339	2	0	2	26.6084227671
354	341	2	0	2	28.0491226242
354	342	1	0	1	29.4411963273
354	345	1	0	1	68.2674867252
354	347	141	74	67	6.50350240821
354	348	6	0	6	16.5746440626
354	349	176	1	175	10.0491499522
354	350	9	2	7	29.5785730926
354	351	18	17	1	8.04296998956
354	352	3	2	1	18.2698196885
354	353	240	16	224	9.9762132342
354	355	1	0	1	18.7106129226
354	356	1	0	1	37.5134368557
354	357	13	5	8	17.1263673032
354	359	1	0	1	28.9237615375
354	361	1	0	1	23.4308120001
354	364	0	0	0	28.108486176
354	367	26	0	26	13.5940829045
354	369	1	0	1	50.4420583531
354	373	1	0	1	43.6624993534
354	375	5	3	2	54.8040776674
354	385	1	0	1	74.0440736004
354	406	0	0	0	101.565792611
354	408	1	0	1	99.9183578875
354	417	1	0	1	89.1999509983
354	503	1	0	1	93.5171499552
354	506	1	0	1	117.643150182
354	511	1	0	1	157.079555079
354	512	1	0	1	127.83159493
354	524	1	0	1	91.4426016852
354	554	0	0	0	74.3665897401
354	566	1	0	1	62.6863640491
354	569	1	0	1	43.1784887098
354	570	1	0	1	40.1895467684
354	573	12	0	12	50.3271189907
354	576	1	0	1	30.1764583344
354	577	4	0	4	33.7851011172
354	579	2	0	2	36.5559084357
354	581	3	0	3	37.4376041805
354	585	2	0	2	46.9688865369
354	586	1	0	1	52.4846693561
355	5	1	0	1	102.110276417
355	70	11	2	9	47.350048622
355	71	3	0	3	46.8256168204
355	72	1	0	1	51.3197964818
355	73	57	0	57	52.7799932009
355	74	4	0	4	48.6123561306
355	75	9	2	7	52.7539688916
355	76	18	2	16	45.8438099947
355	77	1	0	1	52.4538635439
355	78	12	0	12	47.2244491653
355	79	1	0	1	53.3220209843
355	81	4	2	2	50.3636474077
355	82	13	0	13	47.6915688974
355	83	1	0	1	50.6055568334
355	84	8	0	8	51.6715212192
355	85	7	1	6	43.4848673313
355	86	3	0	3	44.7090729457
355	87	6	0	6	50.7830274227
355	88	3	0	3	49.1652237856
355	90	1	0	1	38.6577071144
355	95	1	0	1	60.6851208617
355	96	2	0	2	35.9518270522
355	98	2	0	2	41.8433009572
355	102	1	0	1	67.5161045414
355	103	4	0	4	56.9167239689
355	110	1	0	1	59.8689049939
355	111	1	0	1	52.1664372265
355	112	6	0	6	59.7625421817
355	113	2	0	2	54.3065597852
355	116	1	0	1	43.489086864
355	141	1	0	1	68.456447972
355	146	1	0	1	49.9507512229
355	155	19	0	19	30.6484273802
355	156	4	0	4	30.7299190552
355	160	1	0	1	48.590345974
355	162	1	0	1	26.5730471082
355	164	3	0	3	39.5840284248
355	166	34	1	33	22.013971916
355	168	4	0	4	39.7771600054
355	169	3	0	3	32.3059495606
355	170	1	0	1	25.5755438984
355	171	6	0	6	35.4165219679
355	172	6	1	5	41.7334627426
355	177	8	0	8	36.4070752043
355	183	1	0	1	118.683442034
355	222	0	0	0	127.953977773
355	271	1	0	1	94.6827496505
355	277	2	0	2	83.7363515638
355	281	0	0	0	73.8084638773
355	305	0	0	0	81.7860885055
355	307	1	0	1	85.3730342413
355	310	0	0	0	43.6084574482
355	318	17	1	16	6.72837224901
355	319	483	28	455	12.1326838523
355	320	28	13	15	18.2135816743
355	321	32	18	14	9.33814368536
355	322	2	0	2	20.2210438317
355	323	27	0	27	21.4551641166
355	324	86	25	61	4.00375545803
355	325	4	0	4	19.6224783327
355	326	41	16	25	10.1786258147
355	327	17	5	12	8.08639192836
355	328	5	4	1	14.7448403942
355	329	54	3	51	16.0504438349
355	330	4	0	4	22.0520013928
355	331	1	0	1	18.9247063886
355	332	1	0	1	33.1397856333
355	334	1	1	0	26.9387036673
355	338	37	7	30	21.5084683044
355	341	6	2	4	34.2039614973
355	342	2	0	2	29.8777595376
355	345	2	0	2	80.666482102
355	347	1	0	1	25.1983657317
355	349	173	4	169	10.9593523012
355	350	2	0	2	45.9854857491
355	351	6	1	5	16.1373717006
355	353	8	2	6	24.1961077356
355	354	3	0	3	18.7106129226
355	356	5	0	5	19.4011206595
355	357	66	61	5	6.29559327356
355	358	1	0	1	40.5615962193
355	359	2	0	2	14.2937989402
355	361	55	1	54	5.57976408476
355	362	2	1	1	10.485736878
355	363	0	0	0	44.7393854031
355	364	31	0	31	9.39884983532
355	365	7	2	5	12.0277697963
355	366	6	5	1	13.5101094234
355	367	67	2	65	5.11809745461
355	368	1	0	1	27.3797344192
355	373	1	0	1	51.6143514521
355	375	2	0	2	65.1122049631
355	385	1	0	1	68.8225563747
355	408	4	0	4	97.0733777971
355	433	1	0	1	125.897241379
355	501	1	0	1	111.78003367
355	509	1	0	1	142.047185392
355	512	1	0	1	114.892105616
355	519	0	0	0	99.2220889572
355	524	2	0	2	79.5749708224
355	540	1	0	1	96.8408786898
355	554	0	0	0	62.634224619
355	555	0	0	0	51.072868481
355	566	0	0	0	56.8733036013
355	569	2	0	2	34.9094275143
355	570	2	1	1	29.4691876982
355	573	25	0	25	43.4647829142
355	576	1	0	1	27.5040747729
355	577	4	1	3	25.6073367038
355	579	1	0	1	30.0556544316
355	581	4	0	4	35.58423166
355	585	4	0	4	30.8515336086
355	586	2	0	2	34.7018070134
355	587	3	0	3	19.4124565712
356	1	1	0	1	114.407314411
356	70	2	0	2	66.7491470592
356	71	2	0	2	65.8369131769
356	73	35	1	34	72.0737220891
356	74	7	0	7	67.8272136587
356	75	4	0	4	71.9535410734
356	76	4	0	4	65.2147768038
356	78	8	0	8	66.4846447202
356	79	1	0	1	72.7053258075
356	81	2	0	2	69.7471378508
356	82	7	0	7	67.032672825
356	83	1	0	1	69.9038858798
356	84	2	0	2	70.9325648737
356	85	7	2	5	62.7691429711
356	86	5	0	5	63.7608529974
356	87	5	0	5	69.8803951064
356	88	0	0	0	68.1897605071
356	103	1	0	1	76.0338454471
356	109	1	0	1	62.0983117911
356	111	1	0	1	71.3733727498
356	113	1	0	1	73.2029469201
356	118	1	0	1	60.2252634388
356	142	1	0	1	79.1862501498
356	154	1	0	1	70.5547133817
356	155	4	0	4	49.8507252844
356	156	1	0	1	50.1288946826
356	158	2	0	2	49.1341268095
356	166	6	1	5	41.2259374753
356	172	1	0	1	59.0605303065
356	177	0	0	0	53.6043952126
356	245	1	0	1	80.7096494551
356	294	1	1	0	74.0127582195
356	307	0	0	0	104.591285519
356	310	2	0	2	57.167373607
356	311	1	0	1	52.6774105287
356	313	2	0	2	49.9148400946
356	318	1	0	1	26.0205522604
356	319	385	23	362	24.7022486925
356	320	13	0	13	26.4169108291
356	321	8	0	8	27.6714248811
356	322	6	1	5	30.6205329082
356	323	23	0	23	34.8235186933
356	324	10	0	10	20.3003244039
356	325	6	1	5	23.1813210511
356	326	1	0	1	29.425581821
356	327	62	6	56	18.1915004611
356	328	2	0	2	32.8195235022
356	329	7	0	7	35.4461609566
356	332	2	0	2	39.3700349223
356	334	1	0	1	31.9585796526
356	336	1	0	1	41.5759788112
356	338	33	0	33	32.1312858343
356	339	1	0	1	36.7035437683
356	344	1	0	1	26.5038979852
356	345	1	0	1	90.9574730888
356	347	1	0	1	43.8280997158
356	349	12	0	12	28.127442512
356	351	3	0	3	32.7780477243
356	353	4	0	4	40.6127909966
356	355	10	2	8	19.4011206595
356	357	5	0	5	20.7922798988
356	358	42	2	40	21.45710257
356	359	28	11	17	11.942313852
356	360	21	13	8	9.5127581896
356	361	36	2	34	14.1287416251
356	362	2	2	0	11.1887260333
356	363	5	1	4	25.3874637122
356	364	56	13	43	11.1833044062
356	365	4	0	4	20.0916967504
356	366	9	2	7	15.4929662681
356	367	5	1	4	24.2946434402
356	368	41	16	25	8.44658893264
356	375	3	0	3	74.106460482
356	385	0	0	0	75.1329982912
356	396	1	0	1	101.684882953
356	404	1	0	1	99.0158168515
356	406	2	0	2	107.85359361
356	408	1	0	1	104.411702771
356	448	2	0	2	123.847131576
356	536	0	0	0	72.148451234
356	540	0	0	0	88.7755766681
356	552	1	0	1	51.6733375172
356	554	1	0	1	61.5612621112
356	555	3	0	3	48.7008617616
356	558	1	0	1	71.7782762033
356	563	0	0	0	49.6024249113
356	571	1	0	1	60.3471694341
356	573	8	6	2	50.5630620237
356	575	1	1	0	43.5819471041
356	576	1	0	1	41.0787746417
356	577	1	0	1	35.2433808746
356	579	1	0	1	40.041216601
356	580	1	0	1	51.399556079
356	581	2	0	2	48.2179134897
356	582	3	1	2	13.7988535242
356	583	11	2	9	26.5116353889
356	585	8	1	7	26.6040769662
356	586	12	2	10	24.3328212864
356	587	13	3	10	13.1679120923
357	1	3	0	3	95.1891443796
357	5	1	0	1	102.745814866
357	19	1	0	1	80.2585633146
357	28	1	0	1	91.3296370069
357	36	2	0	2	71.5876375691
357	39	1	0	1	73.6521662886
357	41	3	0	3	76.9762480161
357	48	2	0	2	101.634597522
357	70	57	8	49	47.4565985843
357	71	15	5	10	48.3025375615
357	72	4	0	4	51.3820133952
357	73	266	154	112	53.5052206367
357	74	19	3	16	49.6209935099
357	75	21	5	16	53.7607953674
357	76	46	3	43	46.2729355227
357	77	1	0	1	52.6333875757
357	78	38	3	35	48.1168677378
357	79	4	0	4	53.5881981778
357	80	2	0	2	51.5856708867
357	81	13	0	13	50.6522934529
357	82	32	2	30	48.2710700244
357	83	6	0	6	51.3342496947
357	84	34	7	27	52.5153610644
357	85	19	1	18	44.343044837
357	86	12	3	9	46.1370209879
357	87	40	2	38	52.0452981073
357	88	3	0	3	50.5891117147
357	89	2	0	2	55.5206762847
357	90	4	1	3	39.0172266384
357	95	2	1	1	61.2497895743
357	96	10	4	6	35.5844739187
357	99	1	0	1	65.1113232746
357	103	5	4	1	58.0789699378
357	107	1	0	1	47.5127644439
357	109	2	0	2	42.4010342284
357	110	1	0	1	61.3509883284
357	111	1	0	1	51.0845628797
357	112	15	0	15	60.7673089613
357	113	22	0	22	55.8951083162
357	116	7	0	7	43.817820805
357	118	1	1	0	41.6871633579
357	119	1	0	1	39.8560159056
357	120	1	0	1	56.4920470248
357	140	1	0	1	60.2266976579
357	142	1	0	1	64.5300580922
357	154	1	0	1	58.2292270583
357	155	33	5	28	31.9960749976
357	156	11	0	11	31.0726710684
357	157	1	0	1	47.7067645981
357	158	6	0	6	36.4648476946
357	159	2	0	2	29.8524555736
357	160	1	0	1	52.2482786042
357	162	2	0	2	26.6190700258
357	163	1	0	1	59.9441800796
357	164	4	0	4	41.7184809224
357	165	2	0	2	40.5287272652
357	166	120	29	91	23.6385605718
357	168	15	7	8	42.560749855
357	169	18	1	17	31.318187781
357	170	5	0	5	30.086065734
357	171	10	0	10	37.1101286932
357	172	18	0	18	45.0687205183
357	175	3	1	2	36.4806371569
357	177	21	0	21	39.9418609118
357	180	1	0	1	44.3323256409
357	183	2	0	2	114.46885072
357	225	1	0	1	89.1159673526
357	239	1	0	1	93.6601950165
357	241	1	0	1	134.29458507
357	243	1	0	1	127.093490225
357	245	1	0	1	60.109740455
357	248	1	0	1	54.5112172161
357	252	1	0	1	61.8584706608
357	270	1	0	1	91.6505630897
357	274	2	0	2	75.282110495
357	277	3	0	3	80.5812142527
357	296	0	0	0	52.4412530199
357	307	1	0	1	84.2304952673
357	310	8	0	8	38.4137635136
357	311	0	0	0	37.21874436
357	312	2	0	2	35.6337058563
357	313	2	0	2	30.7148781198
357	314	2	0	2	33.1854366511
357	318	49	24	25	9.84481300403
357	319	538	0	538	18.2972141863
357	320	22	0	22	24.5028147415
357	321	31	0	31	13.6042836866
357	322	4	0	4	26.3521975736
357	323	26	11	15	27.0614715817
357	324	46	13	33	10.2535019285
357	325	7	1	6	25.790042053
357	326	186	39	147	10.3733817008
357	327	14	0	14	14.2288528845
357	328	5	1	4	18.5937497684
357	329	207	12	195	16.6348614563
357	330	3	1	2	28.323858948
357	331	4	2	2	23.3237081855
357	332	23	1	22	26.8444450385
357	333	1	1	0	27.7620368827
357	334	16	10	6	20.7279926373
357	336	2	0	2	23.4436404236
357	337	1	0	1	26.0259368939
357	338	409	42	367	15.3364497962
357	339	10	2	8	22.8049779859
357	340	4	0	4	33.6892110519
357	341	28	9	19	28.0445551422
357	342	7	0	7	23.6068055155
357	344	12	1	11	16.4767234265
357	345	1	0	1	74.8906415924
357	347	22	4	18	23.2110255581
357	348	5	0	5	31.6711230199
357	349	1092	234	858	7.35465078067
357	350	2	0	2	41.6320027677
357	351	26	0	26	12.0652392984
357	352	1	0	1	30.8334841
357	353	77	0	77	20.0802508763
357	354	10	8	2	17.1263673032
357	355	125	4	121	6.29559327356
357	356	8	0	8	20.7922798988
357	358	1	0	1	42.2267612417
357	359	45	0	45	11.9706747099
357	361	82	0	82	7.4641517239
357	362	13	0	13	9.83540422469
357	364	29	15	14	13.3529755096
357	365	86	7	79	6.37118235275
357	366	7	2	5	19.0727002118
357	367	187	5	182	6.37995943305
357	368	3	1	2	27.7631300057
357	369	3	0	3	52.9633753256
357	371	1	0	1	70.0582198802
357	373	2	0	2	45.4464929865
357	375	11	2	9	59.1015517712
357	377	2	0	2	44.1036487573
357	383	1	0	1	97.6908656346
357	385	1	0	1	74.9130827641
357	396	1	0	1	98.7469660097
357	401	3	0	3	104.834461822
357	406	1	0	1	105.484502899
357	407	1	0	1	102.55942998
357	408	6	4	2	102.98159691
357	411	2	0	2	96.8111264243
357	415	1	0	1	92.8116127678
357	417	2	0	2	91.844677355
357	427	1	0	1	117.542431857
357	430	1	0	1	114.677424767
357	443	1	0	1	138.073558025
357	465	1	0	1	103.796623399
357	469	2	0	2	98.9373466037
357	475	2	0	2	85.080600098
357	507	1	0	1	141.393085387
357	512	2	0	2	120.947085153
357	524	1	0	1	85.7787214102
357	529	1	0	1	98.0652513613
357	554	3	0	3	68.8701122188
357	556	0	0	0	69.9724681131
357	563	1	0	1	54.9592499172
357	566	1	0	1	62.9798270151
357	567	1	0	1	57.9623844211
357	569	2	0	2	41.1055370621
357	572	1	0	1	36.3214172364
357	573	46	7	39	49.6023373844
357	576	1	0	1	32.8532168801
357	577	4	0	4	31.7060715258
357	579	3	0	3	36.038189519
357	580	1	0	1	46.7648750164
357	581	7	0	7	40.9849391347
357	583	4	0	4	46.5645013433
357	585	7	0	7	36.5560324255
357	587	3	1	2	24.1802340585
357	588	1	0	1	50.7395313055
358	1	0	0	0	135.108476604
358	17	1	0	1	129.494998627
358	41	1	0	1	114.600400701
358	70	4	0	4	87.6853182292
358	71	1	0	1	85.93995345
358	73	32	3	29	92.6263580003
358	74	2	0	2	88.2406583422
358	75	3	0	3	92.316389969
358	76	1	0	1	86.0034632037
358	78	4	1	3	86.9916868239
358	80	1	0	1	91.4433812089
358	81	1	0	1	90.5735112142
358	82	7	1	6	87.7225976565
358	84	6	0	6	91.4194835452
358	85	4	0	4	83.3443880965
358	86	2	0	2	83.9396944644
358	87	0	0	0	90.0822644901
358	88	1	0	1	88.2928461717
358	92	1	0	1	90.5867552258
358	113	1	0	1	93.0820610159
358	116	1	0	1	83.7347788495
358	142	0	0	0	97.3993851042
358	146	1	0	1	87.9893615696
358	155	4	0	4	70.3737552151
358	166	8	2	6	61.8540247197
358	168	1	0	1	76.9650118612
358	169	1	0	1	72.8339240115
358	172	3	1	2	77.4595599434
358	177	4	1	3	72.0529927451
358	252	1	0	1	103.966955447
358	256	1	0	1	108.364040623
358	310	1	1	0	77.2204473476
358	319	177	23	154	43.0076887757
358	320	8	0	8	42.0567579159
358	322	1	0	1	46.5455238463
358	323	7	0	7	51.8537625958
358	324	0	0	0	40.7592035318
358	325	3	0	3	37.0560090765
358	327	5	1	4	37.457855564
358	329	5	1	4	56.5636465479
358	330	2	0	2	44.2915024303
358	334	1	0	1	49.7902800648
358	336	1	0	1	61.6918771605
358	338	14	4	10	52.1885548272
358	341	1	0	1	62.042677782
358	342	1	0	1	53.063706637
358	347	0	0	0	65.2791985901
358	349	3	0	3	49.573117608
358	353	2	0	2	61.8518884365
358	356	17	2	15	21.45710257
358	357	1	0	1	42.2267612417
358	359	6	0	6	32.1081929008
358	360	19	3	16	13.9106967799
358	361	2	0	2	35.5126872353
358	362	1	0	1	32.4918412154
358	363	130	54	76	8.74003884846
358	364	13	3	10	31.528150195
358	365	1	0	1	40.8154140714
358	366	5	0	5	32.5020434578
358	368	46	3	43	15.5331159843
358	373	1	0	1	76.6344405176
358	375	3	0	3	91.2566230986
358	385	0	0	0	82.4199822366
358	392	0	0	0	84.0396077726
358	393	0	0	0	97.2660332035
358	400	1	0	1	115.264540911
358	406	1	0	1	115.561389486
358	408	7	1	6	111.362811885
358	424	1	0	1	142.09686331
358	426	0	0	0	142.711871745
358	438	1	0	1	119.732124325
358	507	1	0	1	112.960477276
358	520	0	0	0	90.1878715409
358	524	1	0	1	75.0735607786
358	528	1	0	1	99.2757129613
358	530	1	0	1	60.3064602987
358	536	1	0	1	59.993613133
358	540	1	0	1	79.2251252894
358	551	1	0	1	46.3984077134
358	554	1	0	1	62.3126718278
358	555	11	1	10	49.8384099524
358	563	1	0	1	54.1124463916
358	569	1	0	1	53.5100369638
358	570	2	0	2	46.6941756318
358	572	1	0	1	39.9611690173
358	573	12	1	11	60.8167155793
358	576	1	0	1	57.5390294706
358	577	1	0	1	49.7952862364
358	579	1	0	1	54.0674619719
358	580	1	0	1	64.39921933
358	581	2	0	2	63.3174769657
358	582	2	0	2	17.3868861269
358	583	188	40	148	11.2002722347
358	584	0	0	0	29.1053108137
358	585	12	2	10	32.2426078354
358	586	28	0	28	23.6128914703
358	587	15	1	14	26.313325956
358	588	4	1	3	21.5528393292
359	70	8	5	3	59.4106348074
359	71	1	0	1	60.153067274
359	73	55	4	51	65.4709531178
359	74	3	1	2	61.559608515
359	75	8	1	7	65.7029168673
359	76	11	0	11	58.2434366512
359	77	1	0	1	64.5898717841
359	78	8	1	7	60.0672936536
359	81	1	0	1	62.6172849743
359	82	12	1	11	60.240662964
359	83	1	0	1	63.2990357212
359	84	5	0	5	64.4729685981
359	85	8	1	7	56.2937303358
359	86	1	0	1	57.9958417026
359	87	2	1	1	63.9468935866
359	88	4	1	3	62.4554533
359	89	1	0	1	67.3267145774
359	90	1	0	1	50.9878135214
359	95	1	0	1	73.220457109
359	98	1	0	1	55.4237094618
359	103	1	0	1	70.0030669285
359	112	1	0	1	72.7139618299
359	113	5	0	5	67.7273920697
359	116	1	0	1	55.7869453552
359	122	1	0	1	56.6799671409
359	142	2	0	2	75.772371311
359	146	1	0	1	63.7089800207
359	154	1	0	1	68.6792710064
359	155	8	0	8	43.8399772603
359	156	1	0	1	43.0425296388
359	159	1	0	1	40.8104115942
359	162	1	0	1	38.5886279642
359	163	2	0	2	69.5293586977
359	166	17	0	17	35.3613344552
359	168	2	0	2	53.8496577324
359	169	2	0	2	43.1137498038
359	171	3	0	3	48.8762545375
359	172	3	1	2	55.9762395166
359	175	1	0	1	47.8998780189
359	177	1	1	0	50.6776650302
359	223	1	0	1	106.600640115
359	239	2	0	2	100.18427305
359	241	1	0	1	139.047549013
359	307	1	0	1	95.7679290293
359	310	1	0	1	45.4107969711
359	312	1	0	1	37.5317156695
359	313	3	0	3	38.3260370585
359	314	1	0	1	38.9231109861
359	317	1	0	1	56.7504250754
359	318	5	0	5	20.5593013781
359	319	320	39	281	24.7180554321
359	320	14	5	9	29.1433889205
359	321	8	3	5	23.6159548134
359	322	1	0	1	32.397621946
359	323	20	1	19	34.9144980307
359	324	9	0	9	17.3613337089
359	325	6	3	3	28.0665349693
359	326	19	0	19	22.2348703322
359	327	10	1	9	18.3795407022
359	328	2	0	2	29.0055729515
359	329	31	0	31	28.5354795401
359	332	10	0	10	27.6843352804
359	333	1	0	1	26.6199409621
359	334	10	1	9	20.3016203041
359	336	1	0	1	29.8120226457
359	338	123	0	123	20.3142695487
359	339	2	0	2	24.8222004802
359	341	8	2	6	31.4464119649
359	342	4	1	3	23.7733866539
359	344	8	1	7	14.8152439886
359	345	0	0	0	79.0761256029
359	347	3	0	3	34.7342670643
359	348	1	0	1	42.2708957261
359	349	76	1	75	18.9036642981
359	351	1	0	1	22.7379918475
359	353	9	2	7	30.0170281128
359	354	1	0	1	28.9237615375
359	355	22	11	11	14.2937989402
359	356	40	26	14	11.942313852
359	357	77	0	77	11.9706747099
359	358	5	1	4	32.1081929008
359	360	2	0	2	21.4388254818
359	361	88	22	66	9.33630222373
359	362	33	3	30	4.40822393433
359	364	54	15	39	12.4481710654
359	365	52	22	30	8.75094004529
359	366	3	1	2	19.729194962
359	367	14	1	13	17.6153630092
359	368	4	0	4	16.8088274152
359	369	1	0	1	55.3210393137
359	373	0	0	0	47.8321593116
359	375	5	0	5	62.3123855272
359	401	1	0	1	110.315946862
359	408	3	0	3	109.070186722
359	409	1	0	1	115.978809291
359	411	1	0	1	102.577351686
359	416	1	0	1	118.52243612
359	419	1	0	1	114.963870005
359	438	2	0	2	123.991597952
359	442	1	0	1	126.344455193
359	453	1	0	1	97.9737286755
359	472	1	0	1	106.500060779
359	512	1	0	1	120.009960068
359	520	1	0	1	96.037909751
359	524	2	0	2	86.3448795628
359	534	1	0	1	86.3570896999
359	550	1	0	1	128.794405616
359	554	1	0	1	70.0314938687
359	559	0	0	0	62.864375251
359	565	1	0	1	74.9971924624
359	570	1	0	1	39.7573876408
359	572	1	0	1	37.8973829415
359	573	13	0	13	54.8947498055
359	577	1	0	1	37.6965250153
359	579	3	1	2	42.4520865839
359	581	2	0	2	49.0915028375
359	583	2	0	2	38.3479052859
359	585	8	3	5	35.4629033205
359	586	5	0	5	35.3033737135
359	587	4	0	4	21.4693561152
360	1	1	0	1	121.263847544
360	70	3	0	3	73.9470845876
360	71	1	0	1	72.034966719
360	73	11	0	11	78.769057238
360	74	2	0	2	74.3633200193
360	75	1	0	1	78.4304679399
360	76	1	0	1	72.2112152974
360	78	4	0	4	73.1298732009
360	82	1	0	1	73.8998154178
360	85	1	0	1	69.4986424008
360	87	2	1	1	76.182094936
360	88	1	0	1	74.3872719077
360	90	1	0	1	65.1883921785
360	96	0	0	0	62.9190972626
360	109	2	0	2	69.6103088
360	112	1	0	1	85.3281420713
360	113	1	0	1	79.1714417073
360	155	2	1	1	56.531659767
360	156	1	0	1	57.41373697
360	166	3	0	3	48.052748068
360	168	1	0	1	63.090960669
360	172	1	0	1	63.6862449298
360	177	2	0	2	58.2607715052
360	256	1	0	1	94.7726481587
360	272	1	0	1	108.96083594
360	303	1	0	1	121.11284086
360	307	1	0	1	112.460173686
360	310	0	0	0	66.6547867484
360	319	125	6	119	29.1381259543
360	320	7	1	6	28.6467207113
360	321	2	0	2	34.1987335096
360	322	1	0	1	33.1358515459
360	323	3	1	2	38.2431146995
360	324	2	0	2	27.009689476
360	325	5	0	5	24.0034444247
360	326	2	0	2	37.3427691395
360	327	15	3	12	23.5573427197
360	328	1	0	1	38.870489446
360	329	3	0	3	43.0054243738
360	331	1	0	1	40.9846917069
360	336	1	0	1	51.0708847222
360	337	1	1	0	54.6837620213
360	338	8	0	8	41.6390946635
360	347	1	0	1	52.2442662447
360	348	0	0	0	61.2920245577
360	349	4	0	4	36.8904258175
360	353	0	0	0	49.7126932012
360	354	1	0	1	45.8038188381
360	355	2	0	2	27.1664348203
360	356	27	10	17	9.5127581896
360	357	2	0	2	29.6798586854
360	358	56	9	47	13.9106967799
360	359	5	0	5	21.4388254818
360	361	7	1	6	22.5043435305
360	363	6	1	5	20.3171885124
360	364	10	5	5	17.8934045361
360	366	9	0	9	18.6642849395
360	367	1	0	1	32.2655562172
360	368	29	1	28	9.77520325585
360	373	1	0	1	68.8196729152
360	385	0	0	0	72.989290889
360	408	0	0	0	102.283425338
360	524	3	0	3	71.1153513885
360	528	1	0	1	94.5912771239
360	539	1	0	1	54.8269570121
360	551	1	0	1	37.0792502717
360	554	3	0	3	56.3664127957
360	555	4	1	3	43.4229028411
360	564	2	0	2	34.2263761044
360	570	1	0	1	34.7232886594
360	572	1	0	1	28.9766713864
360	573	5	1	4	49.7021261804
360	577	1	0	1	36.8263046205
360	579	1	0	1	41.3355439531
360	581	0	0	0	50.3280245022
360	582	4	1	3	6.56185672735
360	583	19	3	16	17.0489184255
360	585	9	0	9	22.4787953536
360	586	14	0	14	17.1311913116
360	587	18	0	18	12.8919995202
361	70	2	0	2	52.7546079432
361	71	2	0	2	52.4005465627
361	73	53	1	52	58.2956044919
361	74	3	0	3	54.1568996993
361	75	5	0	5	58.3009709597
361	76	8	0	8	51.3077044361
361	78	6	0	6	52.7557518595
361	80	1	0	1	56.7146750287
361	82	7	0	7	53.1819758197
361	83	1	0	1	56.1198420065
361	84	6	0	6	57.2008054573
361	85	6	3	3	49.0085957028
361	86	2	0	2	50.2812715625
361	87	6	0	6	56.3488526542
361	88	1	0	1	54.7387822126
361	89	1	0	1	61.3675294783
361	90	2	1	1	44.0974764646
361	92	1	0	1	55.3371420067
361	97	1	0	1	43.3319064029
361	100	1	0	1	72.4970808321
361	112	5	0	5	65.3128535926
361	113	1	0	1	59.8856279965
361	116	2	0	2	48.9316662987
361	120	1	0	1	61.784901848
361	146	1	0	1	55.5194353077
361	154	2	0	2	59.5753939274
361	155	2	0	2	36.204773814
361	156	1	0	1	36.146119515
361	158	1	0	1	37.6999153206
361	164	1	0	1	45.1561141617
361	166	11	0	11	27.5752906874
361	168	3	2	1	45.2844942862
361	169	1	0	1	37.3648408638
361	171	3	2	1	40.9943571349
361	172	3	1	2	47.1217118688
361	175	2	1	1	39.5066750103
361	177	4	0	4	41.7551954237
361	276	1	0	1	74.8572430759
361	277	1	0	1	87.8141350497
361	310	1	0	1	45.7841177428
361	314	2	0	2	40.321605683
361	318	9	2	7	12.2998629462
361	319	383	82	301	15.4716138156
361	320	20	5	15	20.4135080293
361	321	12	2	10	14.7587113437
361	322	2	0	2	23.3202577364
361	323	24	8	16	25.5904761448
361	324	32	0	32	8.05963077281
361	325	3	0	3	20.3140289151
361	326	16	1	15	15.3149231289
361	327	45	1	44	9.45780284498
361	328	4	0	4	20.1640258801
361	329	18	0	18	21.4219621288
361	330	1	0	1	24.3625546187
361	331	4	0	4	24.0817441622
361	332	3	0	3	32.3607979286
361	334	2	0	2	25.5133549715
361	338	36	0	36	21.9554360033
361	341	2	0	2	34.5039724117
361	342	2	0	2	28.7576524522
361	345	1	0	1	81.8357598674
361	347	1	0	1	29.8079666337
361	348	2	0	2	38.8085525701
361	349	62	2	60	14.4229612691
361	350	2	2	0	49.0905944137
361	351	1	0	1	19.4029986457
361	353	2	0	2	27.4807782895
361	354	2	0	2	23.4308120001
361	355	46	0	46	5.57976408476
361	356	6	0	6	14.1287416251
361	357	40	14	26	7.4641517239
361	359	23	9	14	9.33630222373
361	362	2	1	1	5.12896372004
361	363	1	0	1	39.325731897
361	364	77	12	65	6.02551380938
361	365	12	1	11	10.3511228868
361	366	5	0	5	12.6078108209
361	367	22	0	22	10.1946411279
361	368	1	0	1	21.8918625268
361	373	0	0	0	51.7662821388
361	375	0	0	0	65.7458383291
361	377	1	0	1	51.0406589713
361	386	0	0	0	71.7928386803
361	404	1	0	1	96.1380699749
361	406	1	0	1	103.078166363
361	407	1	0	1	100.497848202
361	408	3	0	3	100.238200275
361	409	1	0	1	106.945360315
361	411	1	0	1	93.8376374538
361	416	1	0	1	109.640799423
361	438	1	0	1	115.902854273
361	466	1	0	1	111.486767521
361	475	1	0	1	84.6362632785
361	536	0	0	0	80.9671034895
361	554	0	0	0	63.2774295019
361	555	2	1	1	51.1997740217
361	563	1	0	1	49.7193755106
361	568	0	0	0	52.8200850718
361	571	0	0	0	58.0187733155
361	573	21	3	18	46.1947549399
361	577	5	1	4	28.6837903304
361	579	3	0	3	33.3723416519
361	581	0	0	0	39.7757254568
361	583	2	0	2	39.2412553513
361	585	5	0	5	29.8950428215
361	586	2	0	2	32.1817667994
361	587	1	0	1	16.9231945648
362	1	1	0	1	104.694441688
362	70	3	0	3	56.9310379555
362	71	1	0	1	57.0654350027
362	73	25	0	25	62.716490048
362	74	1	0	1	58.6733438884
362	75	1	0	1	62.8217063145
362	76	6	0	6	55.6108019482
362	77	1	0	1	62.0892145308
362	78	3	0	3	57.2302815277
362	81	1	0	1	60.0601231847
362	82	1	0	1	57.5438899903
362	83	1	0	1	60.5398348044
362	84	3	0	3	61.6633752266
362	86	1	0	1	54.9277717938
362	87	0	0	0	60.9522424829
362	89	1	0	1	65.229332348
362	103	2	0	2	67.0560872906
362	112	1	0	1	69.8397726768
362	113	2	1	1	64.5943718425
362	117	1	0	1	61.5296986289
362	146	1	0	1	60.363961644
362	155	7	0	7	40.7940968842
362	156	1	1	0	40.3964333729
362	164	1	0	1	49.9887806152
362	165	2	0	2	46.4725257199
362	166	10	0	10	32.2080253497
362	168	2	1	1	50.2605705495
362	170	1	0	1	35.7177393587
362	171	2	0	2	45.6993796901
362	177	2	0	2	46.839586363
362	183	1	0	1	123.198185636
362	223	1	0	1	108.076201415
362	294	1	0	1	63.2178343292
362	310	0	0	0	46.3151361708
362	318	6	0	6	17.0654891793
362	319	155	90	65	20.3436291659
362	320	6	0	6	24.7511611798
362	321	5	2	3	19.7959346225
362	323	9	2	7	30.5859803602
362	324	5	0	5	13.1821963571
362	326	17	0	17	19.434483544
362	327	8	0	8	13.9716185789
362	329	16	0	16	25.7048433644
362	331	2	0	2	29.2019452545
362	332	2	0	2	30.411648052
362	334	4	0	4	23.1848685981
362	335	1	0	1	36.4256873205
362	336	1	0	1	30.7937071303
362	338	52	6	46	21.5244001546
362	341	4	2	2	33.4800343746
362	344	3	0	3	17.787493839
362	345	2	1	1	81.1529608758
362	347	1	0	1	33.0450224557
362	349	58	24	34	17.1785632779
362	351	1	0	1	21.6525002611
362	353	3	0	3	29.4303175839
362	355	16	0	16	10.485736878
362	356	9	5	4	11.1887260333
362	357	62	15	47	9.83540422469
362	358	2	0	2	32.4918412154
362	359	58	1	57	4.40822393433
362	361	57	13	44	5.12896372004
362	364	38	0	38	8.26837238443
362	365	25	2	23	9.26715164841
362	366	1	0	1	15.5894561488
362	367	9	2	7	14.4903252627
362	368	0	0	0	17.9400504942
362	371	1	0	1	75.9777566029
362	375	1	0	1	64.652214928
362	408	1	0	1	104.682241016
362	416	1	0	1	114.128481778
362	438	1	0	1	119.763479365
362	441	0	0	0	116.933741766
362	507	2	0	2	135.031663257
362	571	0	0	0	61.9602163431
362	573	7	1	6	50.519352627
362	576	1	0	1	36.8703212509
362	577	2	0	2	33.2884413294
362	579	2	0	2	38.0443574765
362	581	1	0	1	44.7469022347
362	583	2	0	2	37.5146502859
362	585	1	0	1	31.9201743101
362	586	1	0	1	32.671813007
362	587	1	0	1	18.1179192305
363	25	1	0	1	157.104638238
363	36	1	0	1	115.308578811
363	48	1	0	1	140.344471727
363	70	2	0	2	92.0741237389
363	71	2	0	2	91.173798983
363	73	12	0	12	97.4609892092
363	74	2	0	2	93.2099326323
363	75	3	0	3	97.3332318288
363	76	4	0	4	90.5813143923
363	78	1	0	1	91.8716647393
363	81	1	0	1	95.1028917843
363	82	0	0	0	92.4127821527
363	84	2	0	2	96.3194396412
363	85	0	0	0	88.1565093649
363	86	1	0	1	89.1109431406
363	87	1	0	1	95.2384884951
363	88	0	0	0	93.528510024
363	89	1	0	1	100.626066921
363	111	1	0	1	96.3266196063
363	113	1	0	1	98.4929100383
363	155	1	0	1	75.2356043293
363	156	1	0	1	75.4583784163
363	166	2	0	2	66.6129865488
363	168	2	0	2	82.8273871657
363	177	2	0	2	78.2457527957
363	182	1	0	1	163.110475794
363	211	1	0	1	115.758590987
363	258	1	0	1	119.741098857
363	310	0	0	0	77.5459353154
363	319	51	7	44	49.0450364467
363	320	5	0	5	48.9592501712
363	321	1	0	1	53.0018613635
363	322	1	0	1	53.4452428224
363	323	2	0	2	58.4760542647
363	327	2	0	2	42.9883775729
363	330	1	0	1	51.5383915217
363	336	1	0	1	62.3287466774
363	338	7	1	6	53.0020648371
363	347	0	0	0	68.4589281279
363	349	2	0	2	52.5575112056
363	350	1	0	1	83.5430726371
363	353	0	0	0	63.9628479884
363	354	1	0	1	62.3547984806
363	355	2	0	2	44.7393854031
363	356	6	3	3	25.3874637122
363	357	1	0	1	45.2615619768
363	358	240	5	235	8.74003884846
363	359	4	0	4	33.9863727944
363	360	4	0	4	20.3171885124
363	361	6	0	6	39.325731897
363	364	3	0	3	36.3893872932
363	366	3	0	3	38.7458840776
363	367	0	0	0	49.515898221
363	368	16	0	16	17.5160295652
363	375	0	0	0	89.2461368711
363	408	1	0	1	120.033051772
363	411	0	0	0	112.991835961
363	415	1	0	1	111.893516898
363	416	0	0	0	129.597736741
363	442	1	0	1	133.909895993
363	469	0	0	0	129.337206671
363	524	1	0	1	83.5708856072
363	528	0	0	0	107.825681662
363	551	1	0	1	54.9547520311
363	554	1	0	1	71.026420251
363	555	2	0	2	58.5769096706
363	564	0	0	0	48.3952871707
363	573	9	0	9	69.0382844249
363	577	0	0	0	57.1039088647
363	581	0	0	0	70.6216149997
363	583	53	7	46	19.2362889716
363	585	9	3	6	40.6358131744
363	586	3	0	3	32.2882653535
363	587	4	0	4	33.2061965245
363	588	3	0	3	29.6955634433
364	1	2	0	2	103.647706016
364	6	1	0	1	114.719888353
364	15	1	0	1	95.1751469986
364	23	1	0	1	101.73883056
364	31	1	0	1	79.6136169944
364	59	1	0	1	117.209097974
364	70	18	0	18	56.1577755308
364	71	3	1	2	54.7890476631
364	72	2	1	1	60.1258427766
364	73	144	0	144	61.2112076162
364	74	12	2	10	56.8936666808
364	75	14	0	14	61.0019556066
364	76	18	1	17	54.497728646
364	77	1	0	1	61.1955139622
364	78	28	1	27	55.5941628738
364	79	4	0	4	62.0138443545
364	80	1	0	1	59.9367522115
364	81	6	0	6	59.0610609024
364	82	19	5	14	56.247417874
364	83	6	0	6	59.0503373476
364	84	11	1	10	60.0357762145
364	85	15	0	15	51.9115972799
364	86	4	0	4	52.7339953529
364	87	15	0	15	58.8672187466
364	88	2	0	2	57.1442466483
364	90	2	0	2	47.4097643529
364	92	0	0	0	59.0975189483
364	95	2	0	2	69.1675787171
364	96	3	2	1	45.0316906192
364	103	2	0	2	65.0239526824
364	112	2	0	2	67.9627726539
364	113	10	2	8	62.1061486333
364	117	1	0	1	59.077571819
364	119	4	1	3	46.9635577453
364	146	1	0	1	57.3435596256
364	154	2	1	1	59.6195460019
364	155	14	0	14	38.9503137335
364	156	3	0	3	39.5802503076
364	158	0	0	0	38.0486620863
364	159	0	0	0	33.4204479583
364	162	1	0	1	35.6000441157
364	165	1	0	1	41.2596424499
364	166	33	0	33	30.3749113924
364	168	6	0	6	46.6539645025
364	169	3	2	1	41.5809213018
364	170	1	0	1	30.6007640421
364	171	7	0	7	43.3798167447
364	172	14	2	12	47.9163146442
364	175	3	0	3	41.2374190589
364	177	14	0	14	42.4644265327
364	179	2	0	2	40.6851653227
364	183	1	0	1	127.655548187
364	220	1	0	1	138.488734507
364	225	1	0	1	102.432706013
364	277	2	0	2	93.0759026642
364	310	0	0	0	51.7564984462
364	313	1	0	1	44.067838582
364	314	0	0	0	46.3463152084
364	318	15	0	15	15.4691327564
364	319	1358	277	1081	13.8928059037
364	320	54	9	45	17.0533325576
364	321	33	1	32	16.6304449907
364	322	7	3	4	20.7418825832
364	323	65	4	61	24.2344251879
364	324	52	25	27	9.2772682583
364	325	20	8	12	15.6189743551
364	326	20	2	18	19.5168687885
364	327	269	84	185	7.20708058207
364	328	6	1	5	21.6755080484
364	329	31	5	26	25.1126586738
364	330	11	5	6	20.8824389957
364	331	5	0	5	24.6550804984
364	334	2	0	2	31.0061423299
364	336	3	0	3	36.6401496374
364	337	1	0	1	39.3779651588
364	338	52	7	45	27.9533045771
364	339	1	0	1	34.4776166768
364	341	5	0	5	40.4453962752
364	342	1	0	1	34.3394760994
364	345	1	0	1	87.8469573415
364	347	3	0	3	34.5971813194
364	348	1	0	1	44.0470306654
364	349	69	0	69	19.8863046676
364	350	1	0	1	54.8393303986
364	351	3	0	3	25.0035969967
364	353	3	0	3	33.1174118151
364	354	1	0	1	28.108486176
364	355	44	21	23	9.39884983532
364	356	43	1	42	11.1833044062
364	357	32	0	32	13.3529755096
364	358	14	4	10	31.528150195
364	359	28	1	27	12.4481710654
364	360	4	0	4	17.8934045361
364	361	168	52	116	6.02551380938
364	362	5	0	5	8.26837238443
364	363	3	0	3	36.3893872932
364	365	2	0	2	16.1149555004
364	366	20	5	15	7.32115797894
364	367	24	0	24	14.5144577178
364	368	4	1	3	19.6108935726
364	369	0	0	0	65.1989447692
364	375	2	0	2	71.7008677976
364	385	3	0	3	67.8487271725
364	394	1	0	1	80.6370998574
364	396	1	0	1	93.4811467045
364	406	1	0	1	99.8992281669
364	408	4	0	4	96.8179957193
364	438	1	0	1	111.54632639
364	442	2	0	2	113.938469553
364	443	0	0	0	129.498830119
364	475	1	0	1	83.0424300847
364	493	1	0	1	126.578052134
364	512	1	0	1	108.893974951
364	524	4	0	4	74.5329532819
364	525	1	0	1	77.4258492164
364	551	1	0	1	35.452168342
364	554	0	0	0	57.9859180761
364	555	0	0	0	45.6927012945
364	566	0	0	0	55.955599723
364	568	0	0	0	50.5657390156
364	569	2	1	1	33.8708197794
364	570	1	0	1	27.3570042331
364	572	2	0	2	25.5895490194
364	573	46	1	45	42.6132705696
364	576	3	1	2	30.5655879393
364	577	12	0	12	25.836861027
364	579	6	0	6	30.6608030642
364	580	1	0	1	42.0965498892
364	581	8	0	8	38.0889450983
364	583	2	0	2	34.0721290612
364	585	20	4	16	24.0762130146
364	586	8	0	8	26.1779965368
364	587	16	0	16	10.8977369783
364	588	1	0	1	37.493297854
365	1	1	0	1	99.3933407545
365	3	2	0	2	81.7846593676
365	70	11	0	11	51.8850391474
365	71	2	0	2	53.575084307
365	73	42	0	42	58.2940861755
365	74	4	1	3	54.6148689475
365	75	4	0	4	58.7238769432
365	76	12	1	11	50.9317822788
365	77	1	0	1	57.0640367847
365	78	9	0	9	53.0524026746
365	81	2	0	2	55.175487368
365	82	8	2	6	53.0087308072
365	83	4	0	4	56.1416821864
365	84	6	1	5	57.3864692607
365	85	5	1	4	49.2919786948
365	86	6	0	6	51.3986780393
365	87	9	1	8	57.1715889365
365	88	1	0	1	55.816843917
365	92	1	0	1	53.6097026893
365	96	1	0	1	39.8451872683
365	103	1	0	1	63.1097902407
365	107	1	0	1	53.2783733714
365	111	1	0	1	54.560804187
365	112	5	0	5	65.6871956253
365	113	5	1	4	61.1830393759
365	116	1	0	1	48.4368044438
365	142	2	0	2	70.4207586295
365	146	1	0	1	57.6329922863
365	155	9	2	7	37.3659570738
365	156	3	0	3	35.8955670656
365	159	2	0	2	35.9857028853
365	160	1	0	1	58.4240661568
365	162	1	0	1	31.365495767
365	164	0	0	0	47.3675252121
365	166	31	0	31	29.2856999572
365	169	3	1	2	35.2110402855
365	171	4	0	4	42.5897875435
365	172	2	0	2	51.1661489385
365	177	3	1	2	46.1137392
365	208	1	0	1	75.3733700097
365	237	1	0	1	78.7330739571
365	277	0	0	0	81.7547563648
365	310	4	1	3	37.1128647724
365	312	2	0	2	31.4007711597
365	313	3	0	3	29.8239467705
365	318	14	0	14	16.1946560316
365	319	119	22	97	24.1459630809
365	320	8	1	7	29.9800508826
365	321	14	0	14	19.9754643782
365	323	6	0	6	33.306210555
365	324	13	0	13	16.0071939856
365	325	2	0	2	30.5186524191
365	326	48	0	48	16.0584797731
365	327	5	1	4	19.2066115886
365	328	1	0	1	24.9231363985
365	329	30	0	30	22.0508124486
365	330	1	0	1	33.887382231
365	331	1	0	1	29.6866512223
365	332	9	2	7	22.0096754113
365	333	2	1	1	22.2555976869
365	334	16	10	6	15.2464511399
365	335	1	0	1	28.150170887
365	338	249	5	244	12.2601181956
365	339	3	0	3	18.3639453188
365	340	1	0	1	28.2999298316
365	341	15	1	14	24.4178519783
365	342	1	0	1	18.4288178008
365	344	22	0	22	10.4551441524
365	347	7	1	6	26.5739431932
365	348	1	0	1	33.6146048062
365	349	211	0	211	11.257813273
365	350	1	0	1	41.6592259753
365	351	11	0	11	14.3030234694
365	353	16	2	14	21.3007783283
365	354	2	0	2	21.2022090395
365	355	26	1	25	12.0277697963
365	356	2	0	2	20.0916967504
365	357	217	46	171	6.37118235275
365	359	49	17	32	8.75094004529
365	361	23	7	16	10.3511228868
365	362	5	0	5	9.26715164841
365	364	7	1	6	16.1149555004
365	366	3	0	3	22.9589271849
365	367	25	2	23	12.691699441
365	368	1	0	1	25.5597443632
365	375	6	1	5	55.6675492096
365	385	1	0	1	80.83556673
365	389	1	0	1	97.048427073
365	397	1	0	1	101.935305016
365	408	3	0	3	109.091395949
365	412	1	0	1	118.75370188
365	453	1	0	1	97.3470807702
365	471	1	0	1	115.314009278
365	520	1	0	1	98.4703458536
365	524	2	0	2	90.3217360874
365	525	1	0	1	93.4420493735
365	548	0	0	0	138.382620441
365	550	1	0	1	136.370021225
365	555	1	0	1	61.5488218355
365	568	1	0	1	60.7275169363
365	569	1	0	1	46.8643673327
365	570	1	0	1	41.1924581107
365	573	10	1	9	55.4617815922
365	577	0	0	0	37.6281076712
365	581	1	0	1	47.3027934997
365	583	1	0	1	46.5914238543
365	586	2	0	2	41.7529397579
365	587	1	0	1	26.8247244355
366	1	0	0	0	103.220780511
366	35	1	0	1	88.6956339381
366	36	1	0	1	78.0394698637
366	70	16	2	14	56.4385888037
366	71	1	0	1	53.7183854017
366	73	132	0	132	60.7475497075
366	74	11	2	9	56.2478117497
366	75	15	2	13	60.252811366
366	76	8	2	6	54.5040428778
366	78	29	1	28	55.1035729793
366	79	3	0	3	61.999186263
366	81	2	0	2	59.0899700316
366	82	11	2	9	56.0553622754
366	83	3	0	3	58.6347984474
366	84	10	2	8	59.4781682012
366	85	9	0	9	51.5677709765
366	86	9	0	9	51.7802536873
366	87	8	0	8	57.9054442602
366	88	6	0	6	56.0598779838
366	90	2	0	2	47.7119937343
366	95	2	0	2	68.7084968786
366	96	3	0	3	46.101041877
366	98	1	0	1	48.2939885853
366	103	3	0	3	64.0219286762
366	112	6	0	6	67.0670044135
366	113	9	0	9	60.7182589089
366	116	2	0	2	52.3860647368
366	117	1	0	1	57.7687472867
366	119	2	0	2	46.4836406852
366	142	1	0	1	65.0586548145
366	143	1	0	1	68.2893183617
366	154	2	1	1	55.7237093328
366	155	9	0	9	38.6984875116
366	156	1	0	1	40.2411147958
366	158	1	0	1	34.8914746646
366	159	2	0	2	31.5877088322
366	160	2	1	1	50.6807169761
366	162	1	0	1	36.7483576793
366	164	4	0	4	45.6183320751
366	166	27	3	24	30.5360649845
366	168	8	0	8	44.466900778
366	169	4	0	4	43.3281021268
366	170	0	0	0	27.3446518007
366	171	3	0	3	42.5339275324
366	172	9	0	9	45.0271901858
366	175	1	0	1	39.6239947297
366	177	13	1	12	39.59786375
366	179	2	1	1	43.2116649478
366	226	1	0	1	107.885854049
366	257	1	0	1	81.1423677648
366	277	1	1	0	96.202285334
366	310	3	0	3	57.1142399591
366	314	1	0	1	52.2129946499
366	317	1	0	1	69.7738966592
366	318	6	0	6	17.4940691809
366	319	1811	43	1768	10.519159465
366	320	113	35	78	10.9242092822
366	321	39	4	35	16.9447446916
366	322	8	1	7	15.1833373821
366	323	92	0	92	19.7880939742
366	324	28	0	28	11.0323489084
366	325	88	2	86	8.394236916
366	326	19	1	18	22.2746179597
366	327	142	14	128	6.22231457498
366	328	10	1	9	20.8671584176
366	329	17	1	16	26.7557134268
366	330	12	0	12	14.4099181841
366	331	4	2	2	22.4314420171
366	332	1	0	1	44.9686011472
366	334	3	0	3	38.0789621245
366	338	33	0	33	34.2895479004
366	341	3	0	3	46.9477435428
366	342	3	0	3	41.3526669405
366	345	1	0	1	93.95956622
366	349	34	1	33	24.4318415521
366	351	1	0	1	29.5947114267
366	352	1	0	1	48.09834637
366	353	4	0	4	37.5842874682
366	354	4	1	3	30.9907761383
366	355	12	0	12	13.5101094234
366	356	4	1	3	15.4929662681
366	357	8	0	8	19.0727002118
366	358	5	0	5	32.5020434578
366	359	5	0	5	19.729194962
366	360	2	0	2	18.6642849395
366	361	21	0	21	12.6078108209
366	364	71	2	69	7.32115797894
366	365	3	2	1	22.9589271849
366	367	4	1	3	18.0045252759
366	368	5	1	4	23.5774456099
366	375	3	0	3	78.1211322376
366	377	1	0	1	63.176014499
366	385	0	0	0	60.8117799076
366	391	1	0	1	65.722733292
366	394	1	0	1	73.6417453187
366	396	1	0	1	86.7835874238
366	401	1	0	1	90.8897842515
366	406	2	0	2	93.107108614
366	408	4	0	4	89.8997009447
366	411	2	0	2	83.2824728461
366	415	1	0	1	80.3621700448
366	416	1	0	1	99.4208760686
366	418	0	0	0	79.8214782881
366	438	1	0	1	104.271851727
366	441	0	0	0	101.530901049
366	442	1	0	1	106.803528494
366	491	1	0	1	106.263573909
366	507	2	0	2	122.458171088
366	511	1	0	1	127.572619514
366	512	1	0	1	102.074676282
366	524	2	0	2	67.3976030983
366	530	1	0	1	75.1480431184
366	536	1	0	1	69.5570527732
366	550	1	0	1	116.739862324
366	553	1	0	1	62.4449167083
366	554	2	0	2	50.7573152027
366	555	5	2	3	38.5965693499
366	563	4	0	4	37.4089165773
366	566	1	0	1	48.9728056115
366	569	1	0	1	27.0368428304
366	570	1	0	1	20.314967981
366	572	8	1	7	18.2818123743
366	573	67	19	48	35.732942049
366	575	3	0	3	29.9052101515
366	576	5	1	4	25.8838801609
366	577	24	1	23	19.7592901479
366	579	21	0	21	24.5695334771
366	580	1	0	1	35.9630680582
366	581	5	0	5	32.7774348046
366	582	1	0	1	16.5284686543
366	583	14	3	11	32.5540248737
366	585	14	10	4	17.4837358708
366	586	15	0	15	21.5099596981
366	587	27	9	18	6.92902942583
367	1	1	0	1	90.3251160462
367	24	1	0	1	86.6445969754
367	31	1	0	1	67.8040037639
367	36	1	0	1	66.2631481757
367	50	1	0	1	89.6409193965
367	70	40	19	21	42.5802972572
367	71	10	1	9	42.6136811934
367	72	5	0	5	46.5432378333
367	73	131	1	130	48.2397309535
367	74	11	0	11	44.1830186504
367	75	16	0	16	48.3313820949
367	76	44	0	44	41.1787233143
367	77	2	0	2	47.7161161494
367	78	29	3	26	42.7423492662
367	79	2	0	2	48.6141931876
367	80	1	0	1	46.5709776382
367	81	22	0	22	45.6585378311
367	82	19	2	17	43.0854624138
367	83	2	0	2	46.0629052961
367	84	25	0	25	47.177600113
367	85	24	5	19	38.9799503592
367	86	6	0	6	40.4678838164
367	87	16	1	15	46.4734874573
367	88	1	0	1	44.931284471
367	90	10	0	10	33.9501854646
367	92	1	0	1	45.1454108904
367	93	1	0	1	38.4663393051
367	95	2	0	2	56.0939666198
367	96	3	0	3	31.0251811295
367	98	1	0	1	37.8186058675
367	103	4	0	4	52.570354712
367	109	3	0	3	37.8209181766
367	110	6	2	4	55.6808136593
367	112	6	0	6	55.3494532603
367	113	11	1	10	50.1653540486
367	116	7	3	4	38.7837368738
367	119	1	0	1	34.3027598986
367	120	1	0	1	51.6163028168
367	131	2	0	2	84.7137682024
367	142	3	0	3	58.3144717034
367	146	2	0	2	46.0937815501
367	155	43	0	43	26.3205973787
367	156	4	0	4	25.9873024434
367	158	1	0	1	30.0855414569
367	159	1	0	1	23.5201681092
367	160	3	0	3	45.8859486951
367	162	3	0	3	21.7164900055
367	164	2	0	2	35.7229094492
367	166	120	46	74	17.7726073458
367	168	7	3	4	36.3517538122
367	169	16	0	16	27.2523283399
367	170	2	0	2	23.7798023109
367	171	12	0	12	31.287642889
367	172	14	0	14	38.7429402527
367	173	1	0	1	31.1574555614
367	175	2	0	2	30.3338376879
367	177	8	0	8	33.5842031548
367	236	1	0	1	87.7726532668
367	303	4	0	4	89.4453837809
367	310	4	1	3	39.5288332948
367	312	1	0	1	39.599531116
367	313	1	0	1	31.6857469203
367	318	85	34	51	3.53451393206
367	319	382	99	283	13.8495681864
367	320	18	0	18	20.5322173491
367	321	28	9	19	7.44252171521
367	323	26	0	26	21.3779917297
367	324	27	12	15	7.11635014311
367	325	1	0	1	23.0213177594
367	326	184	14	170	5.1325431089
367	327	8	1	7	12.0244593138
367	328	7	1	6	12.2315028919
367	329	191	88	103	11.2602370254
367	330	2	0	2	24.0755506554
367	331	2	0	2	17.0244155196
367	332	5	0	5	31.5389190878
367	333	1	0	1	33.0367418037
367	334	3	0	3	26.1138788434
367	336	2	0	2	25.7226441715
367	338	100	26	74	19.2466118139
367	339	2	0	2	27.2876999589
367	340	0	0	0	38.7761205519
367	341	12	0	12	31.6485806997
367	342	2	1	1	28.6727702982
367	344	2	0	2	22.382605663
367	345	0	0	0	77.100375296
367	347	13	0	13	20.0859118554
367	348	4	0	4	29.7181556562
367	349	749	391	358	6.80893620017
367	350	2	0	2	41.3505288598
367	351	10	1	9	11.7827135771
367	353	43	1	42	19.6219470128
367	354	8	0	8	13.5940829045
367	355	67	0	67	5.11809745461
367	356	3	0	3	24.2946434402
367	357	109	6	103	6.37995943305
367	358	1	0	1	45.5825869302
367	359	3	1	2	17.6153630092
367	361	22	3	19	10.1946411279
367	362	1	0	1	14.4903252627
367	363	1	0	1	49.515898221
367	364	12	0	12	14.5144577178
367	365	8	2	6	12.691699441
367	366	3	0	3	18.0045252759
367	368	3	0	3	32.0577046006
367	369	1	0	1	56.3475573954
367	372	0	0	0	67.9958804654
367	373	3	0	3	48.9533470762
367	375	4	0	4	61.9893160217
367	385	0	0	0	69.6873516015
367	396	1	0	1	92.9563600967
367	406	3	0	3	99.7518469141
367	408	1	0	1	97.3963176464
367	411	2	0	2	91.3441643901
367	413	1	0	1	101.012683553
367	414	1	0	1	106.999736045
367	445	1	0	1	116.75252298
367	470	1	1	0	85.4520545936
367	480	1	0	1	97.3400089318
367	503	1	0	1	93.4112727286
367	507	2	0	2	140.111502029
367	512	1	0	1	118.197729775
367	524	2	0	2	82.4832674898
367	529	1	0	1	97.2823760718
367	540	1	0	1	100.761274175
367	551	1	0	1	42.6498224341
367	555	2	0	2	54.3168658665
367	556	1	0	1	69.6687448891
367	563	0	0	0	51.2740801897
367	566	1	0	1	57.8185114587
367	567	0	0	0	53.7156907848
367	569	0	0	0	36.3093564576
367	570	1	0	1	31.5780760097
367	572	1	0	1	33.3320509605
367	573	17	0	17	44.5693935717
367	576	4	2	2	26.8933690193
367	577	5	0	5	26.7122465253
367	581	4	0	4	35.0160072107
367	583	1	0	1	48.5821024427
367	585	3	0	3	34.9448451243
367	586	2	0	2	39.4438675569
368	36	1	0	1	98.0888847621
368	70	1	0	1	74.6373850996
368	71	1	0	1	74.0845954104
368	73	17	3	14	80.1596613725
368	74	3	0	3	75.9754366326
368	75	3	0	3	80.1126860521
368	76	3	0	3	73.198693352
368	78	3	0	3	74.5996613101
368	81	1	0	1	77.6996969798
368	82	1	0	1	75.0649357139
368	83	2	1	1	77.9852864191
368	84	2	0	2	79.0474533304
368	85	1	0	1	70.8634614885
368	86	2	1	1	71.991522908
368	87	1	0	1	78.0941900424
368	88	0	0	0	76.4336669538
368	89	1	0	1	83.1175221647
368	155	6	0	6	57.9997778074
368	166	4	1	3	49.3627443077
368	169	2	0	2	58.982585809
368	171	1	0	1	62.6576717297
368	172	1	0	1	67.5064399538
368	177	4	1	3	62.0505806845
368	277	1	0	1	107.312407323
368	310	1	1	0	61.6915038065
368	319	197	17	180	33.114788462
368	320	9	1	8	34.4488094131
368	321	4	1	3	35.9723418673
368	323	12	1	11	43.1574017239
368	324	8	0	8	28.6243171677
368	325	4	2	2	30.7256881052
368	326	3	1	2	37.1425883273
368	327	29	0	29	26.6356500577
368	329	2	0	2	43.3080064119
368	330	1	0	1	37.6689260538
368	332	1	0	1	41.6645476156
368	338	14	0	14	36.6831312806
368	341	0	0	0	46.5953939091
368	342	1	0	1	37.7688428894
368	344	0	0	0	29.3219579001
368	347	0	0	0	50.9716137447
368	349	5	0	5	35.0799220874
368	351	1	0	1	39.3349016722
368	353	5	0	5	46.7978048263
368	355	5	0	5	27.3797344192
368	356	64	15	49	8.44658893264
368	357	4	0	4	27.7631300057
368	358	78	28	50	15.5331159843
368	359	9	0	9	16.8088274152
368	360	29	5	24	9.77520325585
368	361	11	2	9	21.8918625268
368	363	24	1	23	17.5160295652
368	364	19	5	14	19.6108935726
368	365	3	0	3	25.5597443632
368	366	3	1	2	23.5774456099
368	367	3	0	3	32.0577046006
368	375	3	0	3	76.253737793
368	377	0	0	0	63.7849047497
368	379	1	0	1	89.5241186293
368	408	2	0	2	111.028764133
368	438	1	0	1	122.657680966
368	448	1	0	1	130.226820627
368	524	3	0	3	80.888955114
368	528	1	0	1	104.323616454
368	551	1	0	1	46.1589486254
368	554	0	0	0	66.0402498759
368	555	3	0	3	53.0895255495
368	572	1	0	1	37.4629258742
368	573	5	0	5	57.6895574565
368	576	1	0	1	49.3723675519
368	577	1	0	1	43.1753846611
368	581	2	0	2	56.3494296736
368	582	3	0	3	16.2649438938
368	583	14	0	14	23.592413571
368	585	10	0	10	31.7125650487
368	586	8	3	5	26.9039585552
368	587	6	3	3	19.8889378891
369	1	1	0	1	100.649275676
369	36	0	0	0	86.9128553701
369	53	1	0	1	133.897856958
369	70	7	0	7	65.7164819934
369	73	63	0	63	73.1226374076
369	74	2	0	2	72.3260827794
369	75	3	0	3	75.0105357499
369	76	23	1	22	66.9612453986
369	78	6	5	1	70.7165324075
369	81	3	0	3	68.6584227508
369	82	9	1	8	68.9931243202
369	83	4	1	3	71.7556571313
369	84	4	0	4	73.2051918573
369	85	3	2	1	68.2779248754
369	86	1	0	1	72.4663222353
369	87	4	0	4	75.387053255
369	92	1	0	1	63.4027447184
369	96	2	0	2	57.6099649153
369	106	1	0	1	67.6248722508
369	109	1	0	1	60.6507702165
369	112	1	0	1	79.8410429934
369	113	1	0	1	79.9865065473
369	155	3	0	3	64.0878973228
369	162	1	0	1	56.7314497213
369	166	2	0	2	61.3730747803
369	169	1	0	1	53.2759222329
369	177	0	0	0	78.5650568113
369	181	1	0	1	66.7444536829
369	183	1	0	1	78.023387848
369	188	1	0	1	67.5828570118
369	199	1	0	1	40.3671901545
369	204	1	0	1	30.5474715752
369	205	2	0	2	24.640991432
369	206	1	0	1	32.6150985075
369	208	2	0	2	30.6064970396
369	211	1	0	1	34.2373381327
369	212	2	0	2	36.4071904225
369	213	1	0	1	36.8695421822
369	215	0	0	0	20.7024608413
369	225	1	0	1	44.5357759032
369	237	4	0	4	40.2112869662
369	277	4	0	4	60.4621283238
369	292	1	0	1	39.3796685237
369	294	7	0	7	23.7376997903
369	297	2	0	2	25.2694444369
369	310	22	3	19	23.5823948568
369	311	8	3	5	15.9873751207
369	312	8	0	8	17.8003325929
369	313	2	0	2	28.8171767181
369	314	5	1	4	22.5456207095
369	317	5	0	5	16.9665393215
369	319	7	0	7	70.1966443737
369	323	1	0	1	76.3182985091
369	326	1	0	1	55.0744929633
369	329	2	1	1	56.3558637792
369	332	5	0	5	27.6441277792
369	333	1	0	1	29.5002117211
369	334	1	0	1	35.0502715379
369	336	2	0	2	30.9849136165
369	338	56	0	56	37.6271680437
369	339	2	0	2	30.7643044816
369	341	11	2	9	24.9188235179
369	342	2	0	2	31.5759038528
369	343	1	0	1	29.2383737758
369	344	2	0	2	40.5265791085
369	345	39	1	38	25.11729689
369	346	2	0	2	43.5581777065
369	347	0	0	0	48.2576333135
369	348	3	0	3	42.0606303335
369	349	2	0	2	49.7225532774
369	350	16	2	14	31.212811515
369	353	2	0	2	40.4809160778
369	357	2	1	1	52.9633753256
369	370	5	1	4	16.4531185315
369	371	14	9	5	19.2414538228
369	372	10	0	10	16.2685981314
369	373	67	21	46	7.55552784665
369	374	7	2	5	10.3887475301
369	375	799	342	457	7.82213637924
369	376	15	1	14	5.94206338659
369	377	48	3	45	12.3959046692
369	378	1	0	1	20.419127975
369	408	0	0	0	150.260559876
369	416	1	0	1	158.859337836
369	453	3	0	3	137.201808825
369	524	3	0	3	138.670516155
369	554	1	0	1	121.685673376
369	555	0	0	0	110.158992695
369	566	1	0	1	112.860167016
369	573	5	0	5	100.088156768
369	577	1	0	1	82.6219370184
370	1	1	0	1	89.3574687367
370	43	1	0	1	134.286218456
370	70	6	0	6	60.980961284
370	71	2	0	2	70.5996285285
370	72	0	0	0	62.0484883546
370	73	24	0	24	67.8037538876
370	74	2	0	2	68.0474244768
370	75	1	0	1	69.9703832487
370	76	3	1	2	62.7890976685
370	78	3	0	3	66.6101254041
370	79	1	0	1	64.4504954118
370	81	3	0	3	63.4172632817
370	82	2	0	2	64.5402533589
370	83	2	1	1	66.8480417743
370	84	1	0	1	68.2029692634
370	85	2	0	2	64.9179598311
370	86	1	0	1	69.2894196185
370	87	4	0	4	70.9438912125
370	90	1	0	1	60.2712073264
370	92	1	0	1	57.6446716581
370	96	1	0	1	55.552642189
370	103	1	0	1	73.3587585525
370	109	1	0	1	56.7756310309
370	142	1	0	1	90.5647671939
370	155	2	0	2	63.9110855896
370	156	2	0	2	58.9008014665
370	166	2	0	2	63.4016475786
370	177	3	0	3	78.6678333584
370	183	1	0	1	61.8142578965
370	187	0	0	0	46.9734480297
370	191	1	0	1	56.6044026377
370	198	0	0	0	56.072414968
370	204	4	0	4	14.1291844599
370	205	25	0	25	8.22057283495
370	206	4	1	3	16.505888483
370	207	5	0	5	20.4064316173
370	208	20	1	19	16.8361818473
370	211	4	0	4	22.966392407
370	212	6	1	5	19.9941235891
370	213	3	1	2	24.0060523381
370	214	6	5	1	10.7092990794
370	215	7	3	4	6.76943898556
370	225	1	0	1	29.6290038185
370	232	1	0	1	29.5617720389
370	236	1	0	1	34.2065855112
370	237	1	0	1	23.9026219396
370	250	0	0	0	45.4772537069
370	253	1	0	1	30.9980092287
370	277	6	0	6	45.5620311457
370	291	1	0	1	26.0348700117
370	292	4	1	3	23.4036609266
370	293	9	2	7	20.5826355118
370	294	54	9	45	12.275625035
370	297	23	6	17	10.1873520625
370	298	1	0	1	17.0056220386
370	310	14	0	14	23.9239543026
370	311	4	2	2	25.4742938895
370	315	1	0	1	17.7044510923
370	316	2	1	1	20.6484732738
370	317	16	0	16	10.9438031059
370	319	4	0	4	76.4032063377
370	324	1	0	1	69.9318418819
370	330	0	0	0	86.3417984595
370	332	1	0	1	39.4925575845
370	334	3	0	3	46.6158772882
370	338	18	0	18	46.3140195734
370	341	6	0	6	34.5982932651
370	342	2	0	2	43.321062803
370	345	89	0	89	14.4093594988
370	346	1	0	1	36.9066436961
370	349	1	0	1	56.1409799746
370	350	15	1	14	27.0664776464
370	352	1	0	1	36.4602111215
370	353	4	0	4	44.3005791224
370	369	5	0	5	16.4531185315
370	371	21	0	21	11.4549798506
370	372	37	4	33	6.8181793363
370	373	13	7	6	21.0115964865
370	374	6	1	5	19.9229612014
370	375	457	36	421	10.1568349346
370	376	1	0	1	20.0080001513
370	377	26	3	23	17.3453172194
370	378	18	0	18	5.46776153
370	385	1	0	1	127.11022736
370	408	1	0	1	151.170361597
370	457	1	0	1	133.695560137
370	476	1	0	1	120.240962873
370	563	1	0	1	113.586218571
370	568	0	0	0	102.738880446
370	573	2	0	2	104.114205798
370	581	0	0	0	90.4423440646
370	583	0	0	0	104.131924773
371	35	0	0	0	102.099623612
371	56	4	0	4	125.348186958
371	70	8	3	5	72.4045690945
371	73	42	7	35	79.1732474331
371	74	4	0	4	79.4825101891
371	75	1	0	1	81.3580514275
371	76	3	0	3	74.2332873755
371	77	1	0	1	74.7467583556
371	78	2	0	2	78.0528824044
371	81	2	0	2	74.8033266493
371	82	9	0	9	75.972114823
371	84	7	0	7	79.5968614314
371	85	4	0	4	76.3729315898
371	87	5	0	5	82.3680181698
371	103	1	0	1	84.6907991215
371	111	1	0	1	64.5023436901
371	112	1	0	1	84.9029198924
371	113	1	0	1	86.6979991488
371	116	1	0	1	72.7934322335
371	117	1	0	1	85.0453758473
371	121	1	0	1	86.4497186972
371	147	1	0	1	117.168380567
371	155	1	0	1	75.1675240191
371	166	1	0	1	74.3058077458
371	168	2	0	2	87.2258324719
371	172	1	0	1	91.9663760889
371	177	0	0	0	89.9327114961
371	183	0	0	0	61.620382925
371	186	1	0	1	48.1888114243
371	196	2	0	2	34.9967033717
371	199	2	0	2	21.2635193721
371	200	3	0	3	28.2282787447
371	204	3	1	2	19.7172979166
371	205	5	1	4	15.3294879052
371	206	5	1	4	18.0742630443
371	207	14	0	14	19.6372607366
371	208	18	0	18	12.6128748054
371	209	3	0	3	19.234083325
371	210	2	1	1	22.4158702828
371	211	6	1	5	14.9994733448
371	212	8	0	8	22.9429171921
371	213	7	0	7	17.8990723923
371	214	4	3	1	12.5287928827
371	215	13	5	8	7.0739687804
371	224	2	0	2	26.0796831849
371	225	4	0	4	26.6192956185
371	229	3	1	2	29.7766985699
371	230	2	0	2	35.1386111124
371	233	2	1	1	27.2382469207
371	236	1	0	1	35.8565751341
371	237	8	1	7	25.5809225619
371	239	2	0	2	33.2492103444
371	242	1	0	1	63.3322116863
371	266	1	0	1	59.5322146754
371	277	3	0	3	52.8277942801
371	291	2	0	2	30.6371858639
371	292	4	0	4	29.7850427152
371	293	4	1	3	29.7867816035
371	294	1	0	1	23.5064733829
371	297	2	0	2	19.8425942081
371	303	2	0	2	91.2530420196
371	310	16	1	15	34.5740833159
371	311	3	1	2	33.1090442246
371	312	3	0	3	36.4235104986
371	313	1	0	1	41.91602143
371	315	2	0	2	29.1515668742
371	316	1	0	1	32.052154527
371	317	4	1	3	22.0103730646
371	319	5	0	5	86.2525830183
371	320	0	0	0	93.0098948495
371	324	1	0	1	79.4118965623
371	329	1	0	1	70.5090127399
371	332	3	0	3	46.3030129971
371	335	1	0	1	41.0778346941
371	338	27	4	23	54.9145676174
371	339	0	0	0	48.9411769058
371	341	2	0	2	42.504593459
371	344	1	0	1	59.0992007019
371	345	682	4	678	6.02604806705
371	346	18	1	17	26.2009245209
371	347	0	0	0	60.745077604
371	348	3	1	2	52.2757265192
371	349	2	1	1	65.7763538704
371	350	7	0	7	38.4665830388
371	353	1	0	1	54.6109792356
371	354	1	0	1	64.3885047644
371	357	2	0	2	70.0582198802
371	364	1	0	1	82.8583268702
371	365	0	0	0	66.9095911681
371	366	1	0	1	89.125284312
371	369	8	1	7	19.2414538228
371	370	6	0	6	11.4549798506
371	372	68	40	28	4.82744259525
371	373	18	0	18	26.2250527365
371	374	3	1	2	16.0797515535
371	375	446	0	446	11.5835517297
371	377	9	1	8	26.0253488148
371	378	3	0	3	16.221594008
371	406	0	0	0	163.355391571
371	408	1	0	1	162.425621806
371	414	1	0	1	169.054243529
371	426	0	0	0	200.256044172
371	458	1	0	1	144.636091228
371	470	1	0	1	135.647902018
371	529	1	0	1	167.237372734
371	555	1	0	1	126.876720366
371	566	1	0	1	126.932868726
371	568	0	0	0	113.811994512
371	573	3	0	3	114.715620389
371	581	0	0	0	101.341296796
371	585	1	0	1	106.607942052
371	586	1	0	1	108.637417928
372	1	1	0	1	95.5287457429
372	28	2	0	2	90.4763695699
372	70	6	2	4	67.7834857902
372	71	2	0	2	77.3632388257
372	73	29	7	22	74.6206953389
372	74	1	0	1	74.8413856399
372	75	2	0	2	76.7847247312
372	76	4	0	4	69.5734356703
372	78	4	0	4	73.3960718417
372	82	6	0	6	71.3371030752
372	84	3	0	3	75.0160676909
372	85	1	0	1	71.663621518
372	87	5	0	5	77.7454895665
372	88	1	0	1	78.1314814924
372	96	1	0	1	62.1710023429
372	109	1	1	0	63.5363557746
372	112	3	0	3	80.4573029938
372	142	0	0	0	97.3635775174
372	155	1	0	1	70.345065461
372	177	1	0	1	85.1104839905
372	191	1	0	1	53.5583745103
372	204	2	1	1	17.5763317021
372	205	11	0	11	12.3302351842
372	206	5	0	5	17.5224884471
372	207	2	1	1	20.1779101778
372	208	20	1	19	14.3398104077
372	209	1	0	1	20.3826239517
372	211	5	1	4	18.5919780785
372	212	5	0	5	22.0195857359
372	213	3	0	3	20.7425365642
372	215	2	2	0	5.06187232846
372	222	1	0	1	67.3990300868
372	224	1	0	1	27.1443706976
372	225	1	0	1	28.3278975256
372	226	1	0	1	25.3916782997
372	229	1	0	1	32.0958168563
372	236	4	1	3	35.7501151797
372	237	5	2	3	25.2723169636
372	238	1	0	1	42.1939815538
372	247	1	0	1	39.9311780459
372	277	2	0	2	50.4365125645
372	291	1	0	1	29.2074207828
372	292	1	0	1	27.5913617508
372	294	7	3	4	19.0605922799
372	297	4	1	3	16.0963205269
372	298	1	0	1	21.7669186379
372	303	1	0	1	88.0387568014
372	310	6	2	4	29.7717823529
372	311	2	0	2	28.932953844
372	312	2	1	1	32.6414996916
372	313	3	1	2	37.1646223143
372	314	1	0	1	32.6871176311
372	315	1	0	1	24.424611284
372	317	4	0	4	17.186394952
372	319	4	0	4	81.6314374916
372	323	1	0	1	86.3791331659
372	326	1	0	1	65.7892266212
372	332	2	0	2	42.4508665073
372	333	1	0	1	44.9655114393
372	336	1	0	1	42.3475182012
372	338	22	1	21	50.575202596
372	339	1	0	1	44.8747386036
372	340	1	0	1	40.3960500894
372	341	2	0	2	38.3140906229
372	345	161	5	156	9.38305013597
372	346	9	0	9	30.9307259025
372	349	3	0	3	61.1915350932
372	350	7	1	6	33.6883189411
372	353	1	0	1	49.875790056
372	357	1	0	1	65.6284302016
372	367	0	0	0	67.9958804654
372	369	14	0	14	16.2685981314
372	370	16	6	10	6.8181793363
372	371	43	5	38	4.82744259525
372	373	10	1	9	22.6605058173
372	374	5	0	5	15.8613128011
372	375	483	134	349	8.47071723987
372	376	1	0	1	17.7799003479
372	377	7	1	6	21.527375386
372	378	6	2	4	11.9568665698
372	379	1	0	1	138.721160759
372	396	0	0	0	151.455344896
372	408	0	0	0	157.601293229
372	412	0	0	0	167.511676578
372	457	1	0	1	140.263153992
372	475	1	0	1	130.664483857
372	546	1	0	1	203.480013265
372	573	2	0	2	109.947334134
372	579	1	0	1	96.1595483545
372	581	1	0	1	96.5297599129
372	585	2	0	2	102.184123361
373	1	2	0	2	98.8417099499
373	28	1	0	1	93.9086934928
373	36	1	0	1	83.478322028
373	70	15	2	13	61.2388795647
373	71	6	0	6	69.0885838765
373	72	1	0	1	63.5226726609
373	73	82	14	68	68.7627510047
373	74	6	0	6	67.5769767415
373	75	8	0	8	70.5168578277
373	76	16	4	12	62.2487051729
373	77	1	0	1	65.0418505756
373	78	15	0	15	65.9248788432
373	79	2	0	2	66.1988650595
373	81	6	0	6	64.3320661318
373	82	12	7	5	64.3558402639
373	83	5	2	3	67.253393866
373	84	12	1	11	68.7200587873
373	85	9	0	9	63.2485956914
373	86	3	0	3	67.3173261771
373	87	10	4	6	70.6609983037
373	88	2	0	2	70.4596388842
373	92	1	0	1	59.3748220818
373	95	1	0	1	73.5172207202
373	96	6	1	5	52.3005685095
373	97	2	0	2	39.6938112368
373	103	1	0	1	74.6005732813
373	106	1	0	1	64.8373042162
373	111	2	0	2	56.4031769204
373	112	2	0	2	75.7513592583
373	113	7	0	7	75.3018113394
373	120	1	0	1	67.4065453709
373	142	2	0	2	89.4952178252
373	155	3	0	3	58.0781648758
373	162	1	0	1	50.5775312536
373	164	1	0	1	67.594130464
373	166	13	0	13	54.7969453113
373	167	2	0	2	87.3548015559
373	168	1	0	1	71.1190067621
373	169	4	1	3	47.7034404315
373	171	1	0	1	62.5527079278
373	172	1	0	1	75.531843563
373	177	3	0	3	72.3349352105
373	179	1	0	1	42.9946762642
373	183	4	0	4	82.6902174172
373	194	1	0	1	67.811576975
373	196	1	0	1	60.9982262452
373	205	1	0	1	28.6772375269
373	208	3	1	2	36.7630479002
373	209	1	0	1	42.1693885103
373	212	2	0	2	40.7319964652
373	215	2	0	2	26.4863769427
373	230	1	0	1	60.8191459427
373	236	1	0	1	54.8994990612
373	245	1	0	1	58.2770403695
373	253	1	0	1	41.2918323082
373	272	1	0	1	51.3771830378
373	277	1	0	1	61.6674480311
373	292	2	0	2	42.1663147628
373	294	15	0	15	24.6915688946
373	307	1	0	1	80.3447458386
373	310	88	0	88	19.1642830816
373	311	87	23	64	8.83186737656
373	312	73	18	55	10.3033036355
373	313	3	0	3	22.8988305145
373	314	7	2	5	16.2237952935
373	315	2	1	1	23.3018058714
373	316	1	0	1	27.5883340084
373	317	16	2	14	17.2083144324
373	318	0	0	0	51.7374909992
373	319	31	1	30	62.8006984909
373	320	1	0	1	69.436730109
373	321	3	0	3	55.3420445379
373	323	1	0	1	69.159145406
373	326	1	0	1	47.8636868566
373	329	5	1	4	49.4607319838
373	330	1	0	1	73.0287850733
373	332	13	4	9	20.1899778385
373	333	8	1	7	22.3477268936
373	334	8	0	8	27.6011876521
373	335	2	0	2	14.8596874011
373	338	210	0	210	30.1148105404
373	339	4	0	4	23.2151756788
373	340	2	0	2	17.8018558433
373	341	69	9	60	17.4104207816
373	342	11	0	11	24.13352239
373	344	2	0	2	33.0619324014
373	345	43	14	29	31.8910617238
373	347	4	0	4	41.9895995573
373	348	3	0	3	36.8039799741
373	349	15	5	10	42.3859790533
373	350	52	9	43	27.845658272
373	351	1	0	1	38.4325538645
373	352	1	0	1	30.8915080955
373	353	5	1	4	33.7796496708
373	355	1	0	1	51.6143514521
373	357	4	0	4	45.4464929865
373	359	0	0	0	47.8321593116
373	364	4	1	3	57.6434475319
373	367	1	0	1	48.9533470762
373	369	38	36	2	7.55552784665
373	370	1	0	1	21.0115964865
373	371	9	0	9	26.2250527365
373	372	5	2	3	22.6605058173
373	374	4	1	3	17.337212582
373	375	674	0	674	14.6463426657
373	376	16	0	16	11.9390120632
373	377	167	80	87	8.82709335306
373	378	1	0	1	23.5818344485
373	385	3	0	3	117.37853772
373	398	1	0	1	151.458209622
373	401	1	0	1	146.37318935
373	408	3	0	3	143.580290112
373	412	0	0	0	153.493298608
373	414	1	0	1	151.618620234
373	438	1	0	1	163.05766662
373	453	1	0	1	130.637698806
373	512	1	0	1	166.343759781
373	524	2	0	2	131.187235092
373	534	1	0	1	133.928133601
373	556	1	0	1	112.869195384
373	566	0	0	0	105.783789844
373	568	3	0	3	94.1984045056
373	573	10	0	10	92.9132925649
373	580	1	0	1	88.0871883842
373	581	1	0	1	80.9958187938
373	585	3	0	3	81.661324412
374	1	1	0	1	108.388549831
374	35	1	1	0	108.792835834
374	70	10	1	9	75.5252882785
374	71	1	0	1	84.1833724175
374	73	31	0	31	82.8451103998
374	74	1	0	1	82.2487227018
374	76	13	0	13	76.8809526568
374	78	3	0	3	80.6631484178
374	80	1	0	1	79.1199700316
374	81	1	0	1	78.3778335918
374	82	3	0	3	78.8708752528
374	84	1	0	1	82.9939215161
374	86	1	0	1	82.5638392491
374	87	1	0	1	85.2912629942
374	92	1	0	1	72.9790019045
374	96	1	0	1	67.7952160763
374	103	2	0	2	88.6213046702
374	109	1	0	1	70.5916591281
374	112	1	0	1	89.388949308
374	113	1	0	1	89.8599653843
374	136	0	0	0	112.777390754
374	169	4	0	4	63.5484017814
374	172	1	0	1	91.8406313366
374	173	0	0	0	92.2284160566
374	177	1	0	1	88.9444837904
374	205	3	0	3	27.5876542863
374	208	1	0	1	28.6925616858
374	212	1	0	1	37.8788553719
374	213	1	0	1	33.5231273819
374	214	4	1	3	27.2245885968
374	215	1	0	1	20.909645577
374	223	1	0	1	52.2382532518
374	272	1	0	1	51.489916161
374	277	1	0	1	65.4747375995
374	285	1	0	1	59.4256904947
374	293	1	0	1	40.3910907712
374	294	4	0	4	30.5436545834
374	307	1	0	1	88.463456868
374	310	18	3	15	33.6879543075
374	311	3	1	2	26.1140063186
374	312	2	1	1	26.9281698838
374	314	3	0	3	32.9260258536
374	316	2	0	2	37.2024653451
374	317	4	1	3	25.0651776131
374	319	3	0	3	80.0840042805
374	325	0	0	0	88.3267716769
374	331	1	0	1	79.793270944
374	332	3	1	2	36.3715581088
374	338	32	0	32	47.2591003103
374	340	1	0	1	31.7306216671
374	341	6	0	6	34.6174761168
374	344	0	0	0	49.1026132821
374	345	36	3	33	21.8902703824
374	346	3	0	3	35.8486187009
374	347	1	0	1	58.6448909049
374	348	3	0	3	52.2727025866
374	349	4	0	4	59.7106452735
374	350	10	0	10	40.7522568018
374	352	1	0	1	46.5939056644
374	353	2	0	2	50.8335885066
374	365	1	0	1	58.2732877464
374	369	28	0	28	10.3887475301
374	370	6	0	6	19.9229612014
374	371	9	2	7	16.0797515535
374	372	8	0	8	15.8613128011
374	373	25	0	25	17.337212582
374	375	625	94	531	10.1196806264
374	376	35	2	33	5.66133458737
374	377	17	1	16	22.6024866817
374	378	1	0	1	25.1719824294
374	379	2	0	2	140.766780086
374	385	1	0	1	134.654902363
374	386	1	0	1	136.067937183
374	392	1	0	1	132.730142095
374	401	1	0	1	163.532115923
374	408	2	0	2	160.635004233
374	555	1	0	1	119.681909708
374	567	1	0	1	119.950935626
374	573	2	0	2	110.24617593
374	581	0	0	0	98.1930011422
375	1	6	0	6	98.3086681387
375	5	1	0	1	108.653630037
375	8	1	0	1	118.596931089
375	21	0	0	0	105.556496011
375	24	1	0	1	101.9059853
375	28	2	0	2	93.2664298262
375	35	2	0	2	99.0866254116
375	36	0	0	0	86.4173499238
375	39	1	0	1	80.4738945295
375	53	1	0	1	131.903167061
375	56	17	1	16	122.691167425
375	59	3	0	3	140.28355888
375	70	68	7	61	66.6604313585
375	71	12	2	10	75.6983276169
375	72	2	0	2	68.20823502
375	73	547	25	522	73.839192451
375	74	48	0	48	73.5326950382
375	75	30	0	30	75.872318585
375	76	136	4	132	68.1803659274
375	77	1	0	1	69.644759503
375	78	64	0	64	71.9933590403
375	79	4	0	4	70.7434373493
375	80	4	1	3	70.0860162447
375	81	33	0	33	69.3829562256
375	82	115	21	94	70.0951438174
375	83	22	1	21	72.6606985849
375	84	62	2	60	74.0742300877
375	85	36	0	36	69.88430391
375	86	12	1	11	74.1858473783
375	87	38	1	37	76.5349936183
375	88	15	2	13	76.7026853441
375	89	2	0	2	65.3837117374
375	90	5	0	5	64.7442733898
375	92	2	0	2	63.8379907344
375	94	1	0	1	51.8059627867
375	95	2	0	2	77.2942252861
375	96	8	7	1	59.7149780093
375	103	9	1	8	79.5583573331
375	106	1	0	1	66.5997524142
375	109	2	0	2	61.955412364
375	110	5	0	5	83.9163707793
375	111	2	0	2	59.8890232441
375	112	9	0	9	80.1679860303
375	113	11	0	11	81.0418921877
375	116	5	0	5	66.4681406962
375	117	1	0	1	79.089731078
375	119	1	0	1	69.5555606657
375	120	1	0	1	71.3222142419
375	142	4	0	4	96.0096313559
375	155	19	3	16	67.0811486161
375	158	1	0	1	81.4836232417
375	160	1	0	1	91.4046924265
375	162	1	0	1	60.0201974249
375	163	2	0	2	103.132424272
375	164	2	0	2	75.6812760369
375	165	2	0	2	85.7911806249
375	166	14	0	14	65.2743831635
375	167	1	0	1	97.5201095156
375	168	10	0	10	79.645485748
375	169	17	0	17	55.7958923019
375	171	6	0	6	70.9591611106
375	172	6	1	5	84.2908671064
375	175	1	0	1	74.6762111261
375	177	13	0	13	81.7745922533
375	180	1	0	1	90.994170215
375	183	11	0	11	70.6498581112
375	188	1	0	1	59.933746389
375	194	1	0	1	53.662473936
375	196	2	0	2	46.41611683
375	198	1	0	1	57.3112313975
375	199	2	0	2	32.8343006777
375	204	1	0	1	24.0784592917
375	205	7	1	6	18.2336241848
375	206	3	1	2	25.3474556172
375	207	4	0	4	28.4371079044
375	208	28	6	22	22.8081244673
375	209	8	1	7	28.7933935363
375	211	9	0	9	26.5225730939
375	212	23	0	23	29.4570881739
375	213	12	2	10	29.056176212
375	214	5	0	5	19.1542218106
375	215	9	2	7	13.1045177175
375	217	1	0	1	67.844143598
375	218	1	0	1	61.3042194784
375	219	1	0	1	71.70267816
375	220	1	0	1	74.1148406906
375	221	1	0	1	69.25736676
375	223	2	0	2	47.4085401736
375	224	3	0	3	35.5003176493
375	225	2	1	1	36.7883982889
375	228	1	0	1	37.453775345
375	229	7	0	7	40.550312813
375	230	1	0	1	46.4550720658
375	233	2	0	2	35.3223827985
375	234	2	1	1	43.9514130222
375	235	1	0	1	48.854004196
375	236	2	0	2	43.5236279933
375	237	10	0	10	33.0550323059
375	239	4	0	4	43.1279662359
375	242	2	0	2	74.8818219193
375	245	1	0	1	59.1155027135
375	247	1	0	1	39.3953251884
375	252	3	0	3	48.0525838213
375	255	1	0	1	61.59654706
375	264	1	0	1	66.8026806936
375	265	1	0	1	71.2803506539
375	272	2	0	2	42.3113724068
375	276	2	0	2	39.8859394528
375	277	13	0	13	55.6277467144
375	281	1	0	1	50.3836545087
375	287	1	1	0	46.2717572487
375	291	1	0	1	36.005223076
375	292	9	0	9	33.5528811326
375	293	2	0	2	30.3542690765
375	294	78	4	74	20.4538099408
375	297	5	1	4	20.1115685251
375	298	2	0	2	27.1571833665
375	307	2	0	2	78.3442505417
375	310	284	26	258	25.8776417819
375	311	58	26	32	21.9121434499
375	312	30	1	29	24.8803993497
375	313	14	0	14	32.4550363452
375	314	16	0	16	27.0121206595
375	315	8	0	8	23.5768488291
375	316	15	1	14	27.4491856125
375	317	80	23	57	15.4575405222
375	318	2	0	2	64.4847186718
375	319	110	15	95	75.781155655
375	320	2	0	2	82.509743777
375	321	1	0	1	67.8612073662
375	323	4	0	4	81.2456920277
375	325	3	0	3	84.7116541958
375	326	6	0	6	60.2412502961
375	327	1	0	1	73.1984136077
375	328	1	0	1	69.7038657058
375	329	10	0	10	60.8635566456
375	331	4	0	4	74.1391929595
375	332	37	4	33	34.7720446138
375	333	10	0	10	36.9761875677
375	334	12	0	12	42.1720229314
375	335	5	0	5	29.4947743319
375	336	2	0	2	36.289277288
375	337	4	0	4	35.9113143408
375	338	367	9	358	43.8345515368
375	339	5	0	5	37.5399164412
375	340	10	0	10	32.1641759073
375	341	47	0	47	31.2583009822
375	342	12	2	10	38.7177356319
375	343	1	0	1	37.0063714408
375	344	2	0	2	47.6042582316
375	345	559	100	459	17.3493249855
375	346	34	2	32	36.8724378453
375	347	1	0	1	51.8355963031
375	348	17	1	16	44.405081065
375	349	46	27	19	55.2418218406
375	350	153	4	149	31.8287817185
375	351	5	0	5	50.8033672791
375	352	6	1	5	39.0440297213
375	353	21	0	21	44.8615286682
375	355	1	0	1	65.1122049631
375	357	3	0	3	59.1015517712
375	358	2	0	2	91.2566230986
375	364	3	1	2	71.7008677976
375	365	1	0	1	55.6675492096
375	366	1	0	1	78.1211322376
375	367	1	0	1	61.9893160217
375	369	208	32	176	7.82213637924
375	370	61	0	61	10.1568349346
375	371	170	31	139	11.5835517297
375	372	138	77	61	8.47071723987
375	373	264	0	264	14.6463426657
375	374	65	1	64	10.1196806264
375	376	59	12	47	9.94928079274
375	377	293	2	291	15.7300201884
375	378	26	1	25	15.1714742719
375	379	0	0	0	134.61655771
375	381	1	0	1	138.213324356
375	385	9	0	9	128.82288201
375	390	0	0	0	133.690332921
375	392	0	0	0	126.616123745
375	401	2	0	2	157.181257013
375	406	1	0	1	155.22182173
375	408	13	0	13	154.009888568
375	409	2	0	2	157.871393039
375	411	1	0	1	148.829037182
375	412	2	0	2	163.937233795
375	417	1	0	1	143.539595427
375	423	1	0	1	207.001575882
375	426	1	0	1	191.791494505
375	441	0	0	0	170.652907758
375	442	2	0	2	173.619915982
375	453	1	0	1	140.760922788
375	458	1	0	1	136.53811865
375	464	1	0	1	137.776055004
375	466	1	0	1	151.836305332
375	468	1	0	1	124.264778009
375	469	1	0	1	138.285097559
375	475	1	0	1	128.248209132
375	507	2	0	2	199.680723651
375	509	1	0	1	204.900451547
375	512	2	0	2	180.004179028
375	524	2	0	2	144.47191157
375	535	0	0	0	167.353250282
375	546	1	0	1	196.191921765
375	549	1	0	1	185.385758615
375	554	1	0	1	127.421455457
375	555	1	0	1	116.16278003
375	562	1	0	1	139.815621236
375	563	1	0	1	113.228712366
375	566	3	0	3	117.48715214
375	568	4	0	4	104.958535275
375	569	0	0	0	97.4130734641
375	573	28	2	26	104.975161964
375	577	4	0	4	87.7974468046
375	579	1	0	1	91.0698168646
375	581	3	0	3	92.1456745788
375	583	0	0	0	99.7123474723
375	585	4	0	4	95.5828636723
375	588	1	0	1	106.687021816
376	1	2	1	1	106.316037098
376	36	1	0	1	92.836437452
376	70	6	5	1	71.6370196586
376	71	1	0	1	79.9882975923
376	72	1	0	1	73.6160880062
376	73	47	10	37	79.0529459598
376	74	3	0	3	78.2228756326
376	75	5	0	5	80.932467051
376	76	10	7	3	72.860122046
376	78	6	0	6	76.607624201
376	81	2	1	1	74.5896375804
376	82	10	0	10	74.9007410023
376	83	3	0	3	77.6760935248
376	84	1	1	0	79.1273152754
376	85	6	0	6	74.1336567839
376	86	3	0	3	78.3030485604
376	87	1	0	1	81.2875082508
376	95	1	1	0	83.2433019541
376	96	1	0	1	63.4044783441
376	111	1	0	1	65.8902697442
376	112	3	0	3	85.7820294674
376	119	1	0	1	73.1580448079
376	142	1	0	1	100.420898457
376	146	1	0	1	86.0747062515
376	155	1	0	1	69.6732494529
376	164	1	0	1	78.9741048237
376	169	2	0	2	59.0002901451
376	171	2	0	2	74.0073345636
376	177	2	0	2	84.0597362239
376	199	1	0	1	39.5073009733
376	212	1	0	1	39.3651044503
376	237	3	0	3	42.882317131
376	275	0	0	0	71.9743548207
376	277	1	0	1	65.1500712237
376	292	3	0	3	43.3973896265
376	293	1	0	1	39.6348483842
376	294	2	0	2	28.9390989756
376	310	28	10	18	29.4566212781
376	311	7	0	7	20.770001598
376	312	2	1	1	21.2885259335
376	313	1	0	1	34.3802584832
376	314	2	0	2	27.9102139351
376	315	1	0	1	30.3808062385
376	317	5	1	4	22.5568876914
376	319	13	0	13	74.5237141464
376	321	1	1	0	67.1982649248
376	323	1	0	1	81.0629276216
376	326	1	0	1	59.7553180638
376	329	1	0	1	61.396533379
376	332	3	0	3	30.7111519232
376	333	1	0	1	31.8126878252
376	334	3	0	3	37.9816330027
376	338	47	3	44	41.6547975639
376	339	2	1	1	34.2777127977
376	340	1	0	1	26.2037691125
376	341	6	2	4	29.0484931481
376	342	1	0	1	34.5342538402
376	345	39	0	39	25.3974585412
376	346	3	0	3	41.2069173725
376	347	1	0	1	53.7134949455
376	348	2	0	2	47.8487075055
376	349	6	0	6	54.2001577223
376	350	8	0	8	37.1539777744
376	352	1	0	1	42.0536413576
376	353	2	0	2	45.6710828885
376	358	1	0	1	85.3559527343
376	369	93	82	11	5.94206338659
376	370	7	0	7	20.0080001513
376	371	12	1	11	19.3777912873
376	372	11	2	9	17.7799003479
376	373	56	0	56	11.9390120632
376	374	26	3	23	5.66133458737
376	375	831	471	360	9.94928079274
376	377	19	4	15	18.2611460431
376	385	2	0	2	129.313034885
376	408	1	0	1	155.490202824
376	438	1	0	1	174.985880866
376	520	1	0	1	149.412690321
376	566	1	0	1	117.706444597
376	568	0	0	0	106.120723816
376	573	3	1	2	104.805290783
376	579	1	0	1	90.8441294317
376	581	1	0	1	92.9324343051
377	1	2	0	2	90.0346550847
377	36	1	0	1	75.0669518
377	70	39	2	37	53.4075234411
377	71	4	0	4	61.7389050215
377	73	244	0	244	60.853076671
377	74	12	0	12	59.9639418348
377	75	12	0	12	62.7045645533
377	76	54	0	54	54.6023934619
377	78	23	0	23	58.3469800062
377	79	2	0	2	58.1194564292
377	81	12	0	12	56.3953366343
377	82	39	5	34	56.6497473797
377	83	5	0	5	59.4452013069
377	84	19	2	17	60.9002048796
377	85	10	0	10	55.8844137793
377	86	6	1	5	60.0704188994
377	87	12	2	10	63.0303331578
377	88	5	1	4	62.9676563904
377	92	3	0	3	51.2408449325
377	96	4	0	4	45.2259307319
377	103	5	0	5	66.6755385827
377	107	1	0	1	66.5851037542
377	109	1	0	1	48.2873167048
377	112	2	0	2	67.6713240955
377	113	7	2	5	67.6396625714
377	116	1	0	1	52.6674038361
377	119	1	0	1	55.0171561519
377	142	2	0	2	82.1697727713
377	147	1	0	1	95.5223656716
377	155	9	2	7	51.9080664778
377	156	2	0	2	47.1280073763
377	165	1	0	1	70.3332869361
377	166	3	0	3	49.6611117174
377	168	1	0	1	64.7121549763
377	169	6	0	6	40.945943179
377	171	1	0	1	56.0479549782
377	172	3	0	3	69.271621028
377	177	3	0	3	66.488631472
377	178	1	0	1	88.9521683961
377	179	2	0	2	36.3319887488
377	183	1	0	1	77.0972216542
377	190	1	0	1	84.5689368126
377	196	0	0	0	60.8148542925
377	208	3	0	3	34.1665199452
377	209	1	0	1	38.577828571
377	212	1	0	1	35.36472178
377	225	1	0	1	46.7413032583
377	234	2	0	2	51.6556738167
377	247	2	0	2	28.0657492146
377	251	1	0	1	36.7320268785
377	264	1	0	1	59.5932013015
377	276	1	0	1	37.1014316738
377	277	9	1	8	53.5014528743
377	293	3	0	3	28.5025946381
377	294	42	0	42	17.0207688128
377	297	2	0	2	21.4516366108
377	300	1	0	1	27.4007194129
377	310	258	0	258	11.1956678974
377	311	69	22	47	8.35978541086
377	312	12	0	12	13.7244792228
377	313	12	6	6	16.8410537109
377	314	31	0	31	11.3312207165
377	315	3	0	3	14.5850482599
377	316	3	0	3	18.8306857287
377	317	59	42	17	9.67273848055
377	318	1	0	1	48.9288745029
377	319	16	0	16	60.2758930213
377	320	1	0	1	67.0258710442
377	321	2	0	2	52.230699385
377	323	1	0	1	65.5299515062
377	326	1	0	1	44.5977060279
377	329	4	0	4	45.1354579221
377	332	8	0	8	22.4504340875
377	333	4	1	3	25.8948955271
377	334	3	0	3	29.3894672497
377	335	2	0	2	18.9361408599
377	336	5	0	5	20.8544168984
377	337	3	0	3	20.1818120868
377	338	109	48	61	29.1236381195
377	339	3	0	3	24.0588686676
377	340	1	0	1	22.9994053835
377	341	22	0	22	17.2581174978
377	342	3	1	2	26.174466449
377	345	33	1	32	30.7993829259
377	346	2	0	2	52.1366712011
377	347	1	0	1	36.3188306175
377	348	13	0	13	29.6849025912
377	349	11	2	9	39.7698854887
377	350	71	0	71	19.2829934162
377	352	4	0	4	23.9932563697
377	353	10	0	10	29.1334321563
377	357	2	0	2	44.1036487573
377	366	1	0	1	63.176014499
377	367	1	0	1	46.5593249446
377	368	1	0	1	63.7849047497
377	369	16	0	16	12.3959046692
377	370	11	0	11	17.3453172194
377	371	6	0	6	26.0253488148
377	372	6	3	3	21.527375386
377	373	115	94	21	8.82709335306
377	374	2	0	2	22.6024866817
377	375	551	52	499	15.7300201884
377	376	4	1	3	18.2611460431
377	378	4	1	3	17.944503119
377	379	0	0	0	118.964129358
377	385	0	0	0	113.117208727
377	391	1	0	1	113.955477351
377	392	1	0	1	110.953920722
377	401	1	0	1	141.583886992
377	408	2	0	2	138.500310378
377	416	0	0	0	146.988400908
377	417	1	0	1	127.962376002
377	453	1	0	1	125.329137666
377	475	1	0	1	113.392403933
377	512	1	0	1	164.733034842
377	524	2	0	2	129.004253279
377	540	2	0	2	146.631391753
377	573	8	0	8	89.250076838
377	581	0	0	0	76.4579793218
377	583	2	0	2	86.7986804579
377	585	2	0	2	80.6583392692
378	1	1	0	1	83.8901085272
378	70	6	0	6	56.3561528704
378	73	15	0	15	63.0231145464
378	74	2	0	2	63.4665723501
378	76	2	1	1	58.2661464368
378	78	5	1	4	62.0736352315
378	82	3	0	3	59.9470466751
378	83	2	0	2	62.1503670131
378	84	3	0	3	63.4794557038
378	85	1	0	1	60.5521112759
378	87	2	0	2	66.3132969768
378	88	2	0	2	66.8003111535
378	92	2	0	2	52.8453886922
378	104	1	0	1	62.1215750483
378	110	1	0	1	72.7748435265
378	113	1	0	1	70.5937196609
378	142	0	0	0	85.9358895195
378	155	1	0	1	60.3192296977
378	169	1	0	1	48.6036883907
378	177	0	0	0	75.0197664933
378	183	4	1	3	59.3412512418
378	196	1	1	0	46.6881537937
378	202	1	0	1	44.9939578202
378	204	7	1	6	10.9001741773
378	205	34	0	34	5.67598535798
378	207	1	0	1	19.694111385
378	208	25	1	24	18.2405493905
378	209	3	0	3	21.2842162949
378	211	2	0	2	25.3663373047
378	212	10	5	5	17.452840353
378	213	1	0	1	25.465805691
378	214	21	0	21	10.7626769909
378	215	2	0	2	10.0222612165
378	222	1	0	1	66.1780960212
378	229	2	1	1	34.1745680648
378	233	1	0	1	24.4289201505
378	236	2	1	1	31.449485714
378	237	4	0	4	21.6539102632
378	245	1	0	1	45.8062955891
378	247	2	0	2	28.483826819
378	252	1	0	1	33.7719945051
378	253	2	1	1	25.5980498212
378	272	2	0	2	28.0736920739
378	274	1	0	1	40.2045369066
378	276	2	1	1	24.7390278145
378	277	15	4	11	40.4872951246
378	280	1	0	1	41.2566255101
378	281	0	0	0	35.3318369199
378	282	1	0	1	31.0716021629
378	284	2	0	2	25.4488296776
378	286	0	0	0	30.344210575
378	291	1	0	1	22.2730225868
378	292	1	0	1	18.9696630293
378	293	29	0	29	15.2212805805
378	294	143	10	133	7.36193181319
378	297	27	2	25	4.95814318621
378	298	10	0	10	12.3671559182
378	301	1	0	1	11.5093130018
378	310	12	0	12	21.8646883682
378	311	1	0	1	26.3027946041
378	314	1	0	1	27.0661509755
378	315	2	0	2	13.8265033259
378	316	2	0	2	16.0685131166
378	317	16	3	13	9.17627279539
378	319	2	1	1	74.5541406331
378	320	0	0	0	81.2897680651
378	338	6	0	6	45.805799073
378	340	1	0	1	40.5496673068
378	345	20	3	17	17.8481935066
378	346	2	0	2	40.4430203234
378	348	1	0	1	37.6189585884
378	350	14	1	13	23.3038423613
378	353	1	0	1	42.2229038967
378	369	1	0	1	20.419127975
378	370	27	25	2	5.46776153
378	371	1	0	1	16.221594008
378	372	6	2	4	11.9568665698
378	373	7	1	6	23.5818344485
378	375	123	0	123	15.1714742719
378	376	1	0	1	24.7030819726
378	377	14	2	12	17.944503119
378	466	1	0	1	142.060230407
378	524	1	0	1	142.851790703
378	555	0	0	0	115.388990062
378	573	2	0	2	101.396974754
378	581	1	0	1	87.378539734
379	36	1	0	1	80.4147264821
379	45	1	0	1	67.9669358901
379	70	3	0	3	78.0605301728
379	73	46	1	45	74.9269538676
379	74	5	1	4	71.7233477039
379	75	6	0	6	72.6380375949
379	76	2	0	2	75.3981731228
379	78	9	0	9	72.3391311713
379	81	5	0	5	77.6169348852
379	82	7	0	7	74.7447808919
379	83	3	0	3	74.3235677714
379	84	10	1	9	73.6856895056
379	85	1	0	1	71.9732432658
379	87	4	0	4	70.132579698
379	88	1	0	1	68.5678082545
379	103	2	0	2	72.410977313
379	110	1	0	1	70.3386887627
379	112	1	0	1	74.681920225
379	113	5	1	4	68.0479961408
379	116	1	0	1	75.568516899
379	117	1	0	1	67.5444636202
379	124	1	0	1	57.7986429811
379	142	3	1	2	56.2169750671
379	154	1	0	1	45.8548997875
379	155	1	0	1	68.8420762514
379	156	1	0	1	73.8657386389
379	164	1	0	1	63.1032707809
379	166	2	0	2	69.3526626291
379	168	3	0	3	58.5009486616
379	170	1	0	1	55.4549691931
379	171	1	0	1	66.3931553876
379	172	7	0	7	53.8178361286
379	173	1	0	1	48.7832593853
379	176	3	0	3	28.9152690627
379	177	8	0	8	54.3416702282
379	319	8	1	7	63.7705348858
379	323	5	0	5	55.115726756
379	324	1	0	1	71.9004115342
379	327	1	0	1	69.4101330713
379	338	0	0	0	95.4273795444
379	380	3	0	3	15.344020601
379	381	4	1	3	15.6660420435
379	382	0	0	0	27.2349035268
379	383	3	1	2	21.4955726468
379	385	499	0	499	7.94159022247
379	386	27	1	26	10.7916428443
379	387	15	1	14	8.8702627727
379	388	6	4	2	7.46165421919
379	389	11	3	8	16.2479698215
379	390	22	1	21	6.24642182145
379	391	91	51	40	6.61556476528
379	392	92	0	92	8.04464047333
379	393	2	0	2	14.9991246173
379	394	187	1	186	5.47495173799
379	395	9	0	9	9.91779909828
379	396	29	7	22	19.9213914771
379	397	9	4	5	18.5674941697
379	398	3	1	2	29.5555627209
379	400	1	0	1	26.1055600392
379	401	5	0	5	22.9803670125
379	404	3	1	2	18.2699650479
379	405	2	0	2	27.2012278014
379	406	61	0	61	25.2509838313
379	407	7	0	7	24.4971187611
379	408	409	133	276	21.5624057497
379	409	3	0	3	29.8524790248
379	410	40	6	34	17.5443129432
379	411	194	59	135	14.9803450006
379	412	1	0	1	30.9260184473
379	413	6	0	6	25.3636232721
379	414	7	0	7	33.6577662385
379	415	57	39	18	13.0494353889
379	416	5	0	5	31.1343264182
379	417	134	56	78	10.3880446881
379	418	3	3	0	12.511017482
379	419	1	0	1	28.023388291
379	425	2	0	2	40.3294261375
379	427	2	0	2	35.8330183604
379	430	1	1	0	43.2556593139
379	438	2	0	2	40.3058072734
379	441	0	0	0	36.0951689783
379	442	14	0	14	39.3904702514
379	445	1	0	1	46.0632549236
379	448	2	0	2	41.2548498115
379	450	1	0	1	13.391740908
379	451	1	0	1	18.5344215485
379	453	5	0	5	13.8864372445
379	454	4	1	3	15.8956150748
379	455	13	0	13	21.0074370064
379	457	2	0	2	19.0868753998
379	458	1	0	1	14.8933593046
379	459	67	9	58	5.96357442969
379	460	27	0	27	15.9855928789
379	462	1	0	1	11.3193274479
379	471	1	0	1	62.9174473748
379	475	6	0	6	29.6414778154
379	497	1	0	1	22.3255010296
379	503	2	0	2	26.6140090445
379	507	2	0	2	103.51480778
379	516	1	0	1	51.3232927077
379	524	12	2	10	38.2885118362
379	537	1	0	1	57.3311406263
379	540	1	0	1	67.9482722359
379	554	3	0	3	34.2575193261
379	555	1	0	1	42.6887007875
379	561	1	0	1	45.1885518354
379	563	1	0	1	36.4922569765
379	566	55	1	54	19.3904780437
379	567	2	0	2	29.9808980483
379	568	2	0	2	29.7361479902
379	569	1	0	1	41.4601595245
379	573	107	12	95	32.7128775724
379	577	1	0	1	50.2925725597
379	578	2	0	2	22.9205311224
379	579	1	1	0	45.8382225793
379	581	3	0	3	42.5738020856
379	586	1	0	1	66.7710130394
380	70	1	0	1	63.069310935
380	71	1	0	1	53.0120682535
380	73	34	9	25	60.3461565292
380	74	8	0	8	56.9225890407
380	75	4	0	4	58.1178239409
380	76	1	0	1	60.3778875066
380	78	4	0	4	57.4414839667
380	81	1	0	1	62.8022579171
380	82	3	0	3	59.8325460191
380	84	4	0	4	59.0550936233
380	85	3	0	3	56.8867401364
380	86	2	0	2	53.0637427911
380	87	5	1	4	55.5183486425
380	88	1	0	1	53.8621989805
380	89	1	0	1	71.9377337716
380	92	2	0	2	67.985109927
380	103	1	0	1	58.2660159803
380	107	1	0	1	45.1146678092
380	110	1	0	1	56.5872862183
380	111	1	0	1	73.3466406486
380	113	6	0	6	53.7914804003
380	116	1	0	1	60.4419999275
380	129	1	1	0	58.2145647305
380	141	1	0	1	19.3278577807
380	142	1	0	1	43.3341542882
380	146	2	0	2	48.4518338366
380	147	1	0	1	27.8129412207
380	154	3	1	2	31.9341251104
380	155	2	0	2	53.5006418621
380	157	1	0	1	31.0981026904
380	158	1	0	1	38.2131593248
380	159	1	0	1	45.5273887893
380	160	1	0	1	34.3685340834
380	161	1	0	1	25.8959116529
380	163	6	0	6	23.3896543047
380	164	2	0	2	47.8962451364
380	167	1	1	0	22.5995034685
380	168	2	0	2	43.2866940837
380	171	2	0	2	51.0778038629
380	172	7	2	5	38.6541740699
380	174	1	0	1	20.1871514731
380	175	3	0	3	46.3413340997
380	176	3	0	3	15.3183539489
380	177	13	3	10	39.0068649919
380	319	8	1	7	50.3520266835
380	323	1	0	1	41.0258787027
380	338	0	0	0	81.0444567496
380	349	2	0	2	67.7656398455
380	351	1	0	1	70.6994000115
380	373	1	0	1	108.667375912
380	379	8	1	7	15.344020601
380	384	8	1	7	4.70500821091
380	385	67	1	66	12.0142277568
380	386	4	3	1	16.1978116714
380	387	1	1	0	18.7206238908
380	389	1	0	1	30.1120653254
380	390	2	0	2	14.6031685225
380	391	5	3	2	10.1902695151
380	392	35	1	34	7.82662293327
380	393	1	0	1	30.0646578081
380	394	4	0	4	20.6232247979
380	395	2	0	2	23.1674741941
380	396	6	3	3	30.7716731337
380	398	1	0	1	44.791526245
380	401	1	0	1	37.7326632985
380	402	1	0	1	35.7770151065
380	406	12	1	11	37.4259678736
380	408	53	4	49	35.0909085031
380	410	1	0	1	30.635680783
380	411	13	0	13	29.4120332202
380	412	1	0	1	44.9381927852
380	415	11	1	10	24.756427575
380	416	1	0	1	44.1986097462
380	417	7	0	7	24.1883988567
380	418	1	0	1	27.787079177
380	438	1	0	1	55.6497708968
380	442	6	0	6	54.1965736518
380	449	1	0	1	15.3266445305
380	450	4	0	4	5.07595186643
380	451	2	0	2	25.3375464138
380	454	8	2	6	11.277022205
380	455	25	4	21	9.45834154661
380	459	5	1	4	18.5024021905
380	460	20	3	17	17.1003408571
380	461	3	1	2	6.58908343387
380	462	1	1	0	12.2558429776
380	467	2	0	2	17.910785371
380	471	1	0	1	60.4088616536
380	475	2	0	2	26.3633713922
380	524	1	0	1	44.9892877843
380	554	3	0	3	34.8677160903
380	555	1	0	1	38.685995189
380	558	1	0	1	26.7868036774
380	566	26	11	15	11.0605246829
380	568	6	0	6	14.5174997614
380	569	3	0	3	29.3424457894
380	573	82	4	78	21.0269493646
380	574	1	0	1	17.007568216
380	576	2	0	2	35.6579444909
380	577	1	0	1	37.0947114444
380	578	5	1	4	8.54522137534
380	579	2	0	2	32.3695790806
380	581	9	0	9	27.7551901291
380	585	1	0	1	49.3866722026
381	70	0	0	0	86.9306561413
381	71	1	1	0	77.2348533519
381	73	17	5	12	84.8970489226
381	74	5	0	5	81.2033667108
381	75	4	0	4	82.7475171871
381	78	2	0	2	81.5501606472
381	81	1	0	1	87.0150335343
381	82	1	0	1	83.8921145823
381	83	3	0	3	83.9800053968
381	84	3	0	3	83.5557974166
381	85	0	0	0	80.5585292798
381	87	3	0	3	80.0625552198
381	88	1	0	1	78.3055712057
381	107	1	0	1	69.3095691236
381	113	2	0	2	78.6667536602
381	118	1	0	1	80.3056085983
381	141	1	0	1	42.6644175425
381	142	1	0	1	68.5427468754
381	147	1	0	1	52.3679652991
381	154	1	0	1	57.0790219565
381	155	1	0	1	75.1497325683
381	157	1	0	1	54.8619119432
381	168	2	0	2	66.7019475168
381	172	2	0	2	62.3537496946
381	176	1	0	1	40.5252827824
381	177	1	0	1	61.6026658717
381	319	1	0	1	63.8815025841
381	323	1	0	1	57.0062904563
381	338	0	0	0	96.7336880903
381	379	10	4	6	15.6660420435
381	382	1	0	1	20.2036596463
381	383	3	0	3	15.7651997159
381	385	95	46	49	13.2993452651
381	386	10	5	5	9.12441146641
381	387	16	2	14	7.17149207818
381	388	17	0	17	12.4697296823
381	389	25	2	23	9.86365444641
381	390	1	0	1	21.912435513
381	391	8	1	7	21.1143844337
381	392	13	1	12	18.1298845108
381	393	1	0	1	14.3229262817
381	394	8	4	4	16.5095436898
381	395	29	1	28	7.59799647989
381	396	11	0	11	32.3297935587
381	397	2	1	1	32.2505339467
381	398	2	1	1	26.3734564842
381	399	1	0	1	43.735046582
381	401	6	0	6	28.2060768267
381	402	1	0	1	18.9041062431
381	404	3	0	3	21.5498145997
381	405	1	0	1	33.3524212669
381	406	11	5	6	35.4630976832
381	407	1	0	1	36.7688795264
381	408	163	13	150	30.2820355763
381	409	4	1	3	40.5051843187
381	410	5	0	5	27.8610770718
381	411	58	6	52	23.3700083815
381	412	2	0	2	37.1234545234
381	413	3	0	3	26.2147917859
381	414	3	1	2	43.983907298
381	415	7	0	7	26.051216621
381	416	2	0	2	39.2644204424
381	417	17	0	17	21.7840849605
381	418	8	4	4	18.1289587147
381	426	0	0	0	59.9985309111
381	435	1	0	1	37.1299057518
381	438	0	0	0	38.1926312596
381	441	1	0	1	35.7745954568
381	442	5	1	4	42.1592494491
381	447	1	0	1	55.5515058261
381	448	1	0	1	46.8749329989
381	453	1	0	1	28.28922602
381	455	1	0	1	33.7218146389
381	457	1	0	1	34.501160115
381	459	4	1	3	20.5026172637
381	460	4	1	3	31.6208897949
381	471	1	0	1	78.5721675254
381	475	1	0	1	45.1919928441
381	491	1	0	1	70.5400937452
381	507	1	0	1	88.3410880098
381	512	4	0	4	53.576308514
381	520	17	4	13	12.2728019258
381	521	1	0	1	20.3877858831
381	522	3	0	3	17.5852545209
381	524	41	9	32	22.6561450939
381	526	2	0	2	25.1667479718
381	527	1	0	1	36.5252971958
381	528	1	0	1	26.982286111
381	538	0	0	0	38.3572211029
381	540	6	0	6	52.282694027
381	554	18	4	14	22.0006801309
381	555	4	2	2	33.2963873711
381	556	1	0	1	56.7742737774
381	557	1	0	1	16.282850468
381	558	23	2	21	8.48203654218
381	559	2	1	1	34.5981056851
381	561	1	0	1	30.8382941009
381	562	6	1	5	12.6553133203
381	563	1	0	1	29.6846848959
381	566	13	0	13	21.3306566475
381	567	1	0	1	24.6735576938
381	568	1	0	1	36.7500957396
381	571	4	0	4	20.0486103791
381	572	1	0	1	48.1975918039
381	573	22	1	21	33.2428588136
381	575	1	0	1	36.2173968112
381	576	1	0	1	53.4281275285
381	577	2	0	2	50.8092951721
381	581	2	0	2	47.0616091739
381	585	3	2	1	53.0672916027
382	1	1	0	1	128.556049221
382	36	1	0	1	107.570086161
382	59	2	0	2	97.630512162
382	70	1	0	1	104.788043222
382	73	6	1	5	101.982469999
382	74	2	0	2	98.638394121
382	75	4	0	4	99.7206083127
382	78	3	0	3	99.1699893112
382	81	1	0	1	104.522555773
382	82	2	0	2	101.561255268
382	84	1	0	1	100.714133543
382	85	1	0	1	98.5706875485
382	87	2	0	2	97.1675998954
382	88	1	0	1	95.5485186434
382	92	1	0	1	109.709399023
382	155	2	0	2	94.2557936512
382	171	1	0	1	92.357120064
382	177	3	0	3	80.2180040538
382	310	0	0	0	133.192807879
382	319	3	0	3	84.0844528667
382	320	1	0	1	77.8808535388
382	323	1	0	1	77.1038598895
382	328	1	0	1	88.5603974985
382	338	1	0	1	116.932183072
382	375	2	0	2	158.225389
382	379	4	0	4	27.2349035268
382	381	5	3	2	20.2036596463
382	383	43	9	34	5.74014778847
382	385	11	3	8	30.3188506889
382	386	3	0	3	27.8240813528
382	387	1	0	1	23.8209255451
382	388	1	0	1	19.800884961
382	389	3	1	2	11.7451590298
382	391	3	0	3	33.8177508211
382	392	1	0	1	33.9022525239
382	394	1	0	1	23.4377260171
382	395	5	0	5	18.6459425355
382	396	10	1	9	31.7029318067
382	398	105	0	105	8.00475273149
382	400	1	0	1	24.7790056858
382	401	16	0	16	19.4102136503
382	402	16	6	10	8.77925970812
382	404	13	2	11	14.9632942314
382	405	1	0	1	23.5636310457
382	406	17	0	17	30.5161940003
382	407	3	1	2	34.6784147097
382	408	247	63	184	25.0792584475
382	409	2	0	2	34.946778789
382	410	4	0	4	25.9026134814
382	411	34	0	34	21.557615471
382	412	4	0	4	26.2546280297
382	413	34	2	32	12.8695909715
382	414	4	0	4	37.2375790553
382	415	6	2	4	28.6765286637
382	416	6	2	4	30.3799635127
382	417	5	0	5	24.6344442291
382	418	3	0	3	17.8893620093
382	419	3	1	2	18.9189189535
382	421	1	0	1	36.4570622031
382	425	1	0	1	29.1721841144
382	427	7	3	4	29.5870058406
382	430	6	0	6	16.0894164544
382	433	3	0	3	29.9418839551
382	435	1	0	1	22.19296585
382	436	1	0	1	45.6978581191
382	438	7	0	7	18.8757032984
382	439	3	0	3	23.9206759656
382	440	13	8	5	12.5933925381
382	441	6	2	4	18.0253514876
382	442	22	1	21	26.3481706088
382	444	2	0	2	36.3211602746
382	445	4	0	4	19.5177950713
382	446	0	0	0	40.482523831
382	448	1	0	1	33.448534675
382	460	2	0	2	40.5227168287
382	496	0	0	0	48.4322571698
382	503	1	1	0	42.0260737273
382	507	1	0	1	82.3539577557
382	511	1	0	1	89.1835222164
382	512	1	0	1	44.6846985667
382	515	3	0	3	31.1239609802
382	516	9	3	6	24.0884437535
382	520	37	0	37	10.7243772627
382	521	4	0	4	13.0891589743
382	522	3	0	3	20.4859967357
382	523	4	0	4	26.7994103522
382	524	14	0	14	29.5248995736
382	527	1	0	1	35.437851244
382	528	11	1	10	13.4800141217
382	534	1	0	1	54.9543676661
382	540	3	0	3	53.1902811564
382	554	2	0	2	38.5453310585
382	555	1	0	1	51.2185231507
382	557	1	0	1	35.0126386898
382	558	1	0	1	26.9220123548
382	561	1	0	1	42.4788608554
382	562	6	1	5	24.5357411493
382	566	1	0	1	40.8368127035
382	573	9	0	9	53.3356253543
382	581	0	0	0	66.5657235826
382	585	2	0	2	72.2994955645
383	70	2	0	2	99.1174647498
383	72	1	0	1	100.838218588
383	73	8	0	8	96.2634474759
383	74	1	0	1	92.9389498636
383	75	2	0	2	93.9977021897
383	78	0	0	0	93.4828758719
383	82	0	0	0	95.8767131415
383	84	1	0	1	94.9987877431
383	85	1	0	1	92.9180989506
383	86	1	0	1	89.1124296018
383	113	2	0	2	89.4823786758
383	131	1	0	1	71.4672552767
383	140	1	0	1	85.8302455721
383	142	2	1	1	77.6699319081
383	158	1	0	1	73.2535213959
383	177	1	0	1	74.6608783254
383	319	2	0	2	79.407440379
383	338	0	0	0	112.143906641
383	345	1	0	1	166.061285716
383	350	1	0	1	125.420304613
383	358	1	0	1	98.0354239136
383	379	1	0	1	21.4955726468
383	381	6	2	4	15.7651997159
383	382	35	7	28	5.74014778847
383	385	16	0	16	24.7814624419
383	386	0	0	0	22.5913245935
383	388	2	0	2	14.0680751056
383	389	10	0	10	6.37162395041
383	390	1	0	1	26.1412910003
383	391	2	1	1	28.0822432978
383	392	1	0	1	28.2233287079
383	393	3	0	3	7.03154269833
383	394	1	1	0	17.8084404691
383	395	5	3	2	13.0791628065
383	396	12	0	12	27.5124881077
383	397	2	0	2	29.2766686417
383	398	47	2	45	10.6139719585
383	401	12	0	12	16.9721943603
383	402	36	18	18	5.24078064309
383	404	15	2	13	11.1946282206
383	405	2	0	2	21.781829912
383	406	20	2	18	27.3879889873
383	407	4	0	4	30.9265541758
383	408	220	3	217	21.7776517451
383	409	3	1	2	32.145216502
383	410	5	0	5	21.7674748748
383	411	17	0	17	17.1100460976
383	412	1	0	1	25.0298545892
383	413	41	2	39	12.040780219
383	414	1	0	1	34.8621702523
383	415	6	2	4	23.7442770434
383	416	0	0	0	28.5324391787
383	417	9	0	9	19.4924861469
383	418	4	0	4	12.7806914281
383	419	1	0	1	18.1032534753
383	425	1	0	1	29.9347309164
383	427	1	0	1	29.0365083198
383	429	1	0	1	45.4470471559
383	433	1	0	1	34.4734909638
383	438	1	1	0	22.4274789989
383	439	2	0	2	28.6425671558
383	440	2	0	2	17.5479232444
383	441	1	0	1	20.2645490718
383	442	8	0	8	27.4966472681
383	447	1	0	1	42.4549489518
383	451	1	0	1	32.3845532012
383	460	1	0	1	35.0481204734
383	465	0	0	0	53.6176331588
383	475	1	0	1	48.3612281506
383	507	1	0	1	86.4738532755
383	516	3	0	3	29.8282540929
383	520	16	0	16	9.75191475025
383	521	1	1	0	15.6599852475
383	522	1	0	1	20.7946764285
383	524	6	0	6	29.4709600737
383	525	2	0	2	36.2369997856
383	526	1	0	1	24.4564213304
383	528	1	1	0	18.1842244581
383	548	1	0	1	96.3444591596
383	554	1	0	1	35.9284865523
383	566	1	0	1	35.6262165511
383	567	1	0	1	40.4385314279
383	571	1	0	1	35.5824321149
383	573	4	0	4	48.4021289077
383	576	1	0	1	68.1350214941
383	581	1	0	1	61.2495716876
384	70	4	1	3	65.6227896136
384	71	2	1	1	55.7662443715
384	73	43	4	39	63.3309007246
384	74	6	3	3	59.7190594404
384	75	8	0	8	61.1603527427
384	76	1	0	1	62.9013643748
384	78	6	0	6	60.1306610291
384	81	8	0	8	65.5620580835
384	82	4	1	3	62.4954945875
384	83	1	0	1	62.465280758
384	84	7	0	7	62.0027320691
384	85	6	0	6	59.3253463997
384	86	3	0	3	55.6629354658
384	87	4	0	4	58.4948783003
384	88	1	0	1	56.7649249726
384	89	1	0	1	74.7680659239
384	107	1	0	1	47.8381982348
384	112	1	0	1	64.1340403531
384	113	3	0	3	57.04241318
384	142	1	0	1	47.2840379709
384	146	1	0	1	51.5139874817
384	154	6	0	6	35.5464557727
384	155	5	0	5	54.9977095175
384	156	1	0	1	59.9906739908
384	157	2	0	2	33.5068334538
384	158	1	0	1	39.5050027125
384	159	2	0	2	46.5064415051
384	163	2	0	2	27.1163023954
384	165	3	0	3	35.6937994187
384	167	2	0	2	24.5979336499
384	168	6	0	6	45.5494634215
384	169	1	0	1	66.6691962747
384	171	1	0	1	52.9736492692
384	172	10	0	10	41.0574480999
384	173	1	0	1	34.479547473
384	176	1	0	1	19.407030865
384	177	8	0	8	40.8352034069
384	307	1	0	1	98.5865041101
384	319	13	0	13	49.293385148
384	320	1	0	1	44.244920395
384	322	1	0	1	41.2444891136
384	323	2	0	2	40.4843559457
384	324	1	0	1	57.4043298932
384	349	0	0	0	67.5245655097
384	356	1	0	1	69.273508105
384	366	1	0	1	54.4171366699
384	375	1	0	1	120.177819113
384	379	19	0	19	14.6444807
384	380	16	5	11	4.70500821091
384	381	2	0	2	21.624921585
384	385	147	5	142	9.06870954742
384	386	3	0	3	12.5012311706
384	387	3	0	3	15.7228499293
384	388	1	0	1	21.056940469
384	389	1	0	1	27.6458547735
384	390	3	0	3	15.8442250443
384	391	14	0	14	11.3515023556
384	392	63	25	38	6.62853746373
384	393	1	0	1	28.3939315356
384	394	4	0	4	20.1194321664
384	395	4	1	3	20.7555111082
384	396	4	1	3	32.4116399843
384	398	2	0	2	43.179191625
384	401	1	0	1	37.6147404909
384	406	9	1	8	38.6973891608
384	407	2	0	2	36.6832034474
384	408	89	19	70	35.7396529239
384	409	1	0	1	42.8261222234
384	410	1	0	1	31.4378972531
384	411	7	0	7	29.5046380031
384	412	2	1	1	45.3722207466
384	414	3	1	2	46.646267188
384	415	10	0	10	25.9466759845
384	416	3	1	2	45.1406537399
384	417	11	1	10	24.5517351802
384	418	1	0	1	27.0567076793
384	421	2	0	2	55.5645748979
384	433	1	0	1	67.3584196169
384	441	0	0	0	50.4815544797
384	442	7	0	7	54.0349457119
384	450	3	0	3	8.89881972563
384	451	4	0	4	27.9404571165
384	454	1	0	1	15.338549416
384	455	9	1	8	14.1445365427
384	459	3	0	3	19.0827118527
384	460	7	1	6	20.515870469
384	461	1	0	1	10.3268528633
384	462	1	0	1	15.1321986141
384	491	1	0	1	60.0790761008
384	507	1	0	1	108.055585765
384	520	0	0	0	33.7002568745
384	524	5	1	4	40.5324032415
384	535	1	0	1	80.162543503
384	536	1	0	1	70.4172365551
384	548	0	0	0	112.847947856
384	551	1	0	1	32.3388047071
384	554	3	0	3	30.1672296709
384	555	1	0	1	34.3596989551
384	557	2	0	2	22.7629354527
384	561	1	0	1	42.9019852684
384	563	3	0	3	26.6311903126
384	566	122	90	32	6.85217259888
384	568	7	0	7	15.7868814501
384	569	2	0	2	27.3810102996
384	571	2	0	2	13.6348446343
384	573	183	75	108	18.71742354
384	574	3	0	3	12.4247030841
384	575	0	0	0	26.8732552123
384	577	2	0	2	35.8490832372
384	578	10	0	10	8.47832837549
384	579	1	0	1	31.302534692
384	580	2	0	2	20.9254128384
384	581	10	0	10	28.0427603122
384	586	1	0	1	55.2587706007
385	1	1	0	1	102.07317253
385	36	1	0	1	79.384228263
385	47	1	0	1	81.8160544129
385	50	1	0	1	77.9910190784
385	70	5	0	5	74.6372724049
385	71	3	2	1	64.7189305996
385	73	114	3	111	72.1923967959
385	74	13	0	13	68.6587928351
385	75	14	4	10	69.9917649318
385	76	6	1	5	71.9216111943
385	78	24	0	24	69.1066378852
385	79	1	0	1	75.8909726593
385	81	8	0	8	74.5174169558
385	82	6	0	6	71.4803188731
385	83	7	0	7	71.3804334131
385	84	14	0	14	70.881164536
385	85	3	0	3	68.3609462386
385	86	5	0	5	64.6621466894
385	87	12	1	11	67.3580578761
385	88	2	0	2	65.6607416871
385	90	1	0	1	70.3526009095
385	92	1	0	1	79.5766487638
385	95	1	0	1	76.8545207138
385	103	6	1	5	70.2388096827
385	109	1	0	1	75.6577912947
385	112	1	0	1	72.7273909627
385	113	7	0	7	65.7473516211
385	116	1	0	1	71.8502755169
385	120	1	0	1	78.312289496
385	142	2	0	2	55.2727854457
385	146	1	0	1	60.3298477969
385	154	4	1	3	43.9477951731
385	155	4	0	4	64.007855689
385	156	1	0	1	68.9896094193
385	158	1	0	1	48.4892064052
385	160	1	0	1	46.2325225982
385	163	3	0	3	35.4030681913
385	164	1	0	1	59.2074084018
385	166	3	1	2	63.7419182487
385	167	3	1	2	33.661382071
385	168	4	0	4	54.6044607372
385	171	1	0	1	62.0384905148
385	172	13	1	12	50.0899474517
385	173	3	2	1	43.3453663072
385	174	1	0	1	31.6043897998
385	176	2	1	1	27.2657359275
385	177	17	0	17	49.899485733
385	182	1	0	1	170.583114029
385	183	1	0	1	162.645513967
385	186	1	0	1	155.659219696
385	277	2	0	2	122.677273134
385	319	32	3	29	56.6916586861
385	320	2	0	2	51.1766907847
385	323	3	0	3	48.4672083188
385	325	1	0	1	52.4438463491
385	329	1	0	1	68.0455598665
385	338	4	0	4	88.7957276221
385	345	0	0	0	141.459086846
385	349	1	0	1	75.5931833047
385	357	1	0	1	74.9130827641
385	358	2	0	2	82.4199822366
385	367	1	0	1	69.6873516015
385	375	2	0	2	128.82288201
385	379	142	16	126	7.94159022247
385	380	9	0	9	12.0142277568
385	381	15	0	15	13.2993452651
385	383	7	0	7	24.7814624419
385	384	6	1	5	9.06870954742
385	386	85	28	57	4.73349648623
385	387	16	2	14	6.74594837801
385	388	16	1	15	12.5852676456
385	389	9	1	8	18.5774395784
385	390	13	0	13	12.4445465023
385	391	94	15	79	9.50927576331
385	392	159	38	121	4.96175270716
385	393	2	0	2	19.5910269179
385	394	63	3	60	12.8868669526
385	395	11	1	10	11.7023013558
385	396	26	2	24	27.803872417
385	397	6	0	6	26.2130829857
385	398	3	0	3	34.3128551364
385	399	2	1	1	39.4957523041
385	401	8	0	8	30.1113272658
385	402	3	0	3	25.4062700401
385	404	5	1	4	24.6440586111
385	405	1	0	1	34.6351998605
385	406	43	3	40	33.1801433593
385	407	8	1	7	32.3589657364
385	408	388	39	349	29.3279787606
385	409	5	0	5	37.7936344278
385	410	17	2	15	25.4326331156
385	411	102	23	79	22.5206587594
385	412	4	1	3	38.4273624583
385	414	4	0	4	41.5993472511
385	415	44	2	42	20.9418379038
385	416	8	0	8	38.9290991074
385	417	59	0	59	18.2601455373
385	418	8	0	8	19.1208113096
385	421	1	0	1	49.1841563284
385	426	1	0	1	64.7303135423
385	427	5	0	5	43.3498971151
385	430	2	0	2	45.6839926043
385	432	1	0	1	58.8065425922
385	438	9	3	6	45.7274696558
385	440	1	0	1	42.2225841183
385	441	2	0	2	42.0305490129
385	442	9	0	9	46.2633427634
385	444	1	0	1	53.3946346387
385	449	3	0	3	21.7432128083
385	450	4	0	4	12.9679427669
385	451	1	0	1	25.5700257911
385	452	2	1	1	17.2404032546
385	453	3	1	2	21.3729316761
385	454	10	0	10	18.1412762023
385	455	35	3	32	20.4617985808
385	456	2	0	2	27.4068249553
385	457	4	1	3	25.3916170326
385	458	7	0	7	21.3494535375
385	459	18	1	17	13.767601424
385	460	31	4	27	20.8187368786
385	469	0	0	0	47.8356513254
385	475	1	0	1	33.5877696769
385	485	0	0	0	73.0984263541
385	507	4	0	4	101.254523348
385	519	1	0	1	57.9967232279
385	520	3	0	3	24.964732855
385	524	20	6	14	34.3771300865
385	529	1	0	1	72.8377646
385	530	2	0	2	78.7974443388
385	537	2	1	1	53.0760086707
385	540	3	0	3	64.1509977013
385	551	1	0	1	36.1195945033
385	554	13	1	12	27.5524284133
385	555	4	0	4	35.0307364611
385	557	0	0	0	19.9984892128
385	558	5	0	5	16.5045760409
385	562	2	0	2	24.2135788473
385	563	2	0	2	28.598329533
385	566	183	76	107	11.9609457362
385	567	1	0	1	22.0523742603
385	568	6	0	6	24.8426092308
385	569	2	0	2	34.106157333
385	571	2	0	2	15.3933130003
385	573	211	1	210	25.401166668
385	574	6	2	4	9.06338349715
385	575	3	0	3	31.6682958321
385	576	2	0	2	43.9479124945
385	577	10	1	9	43.2183247979
385	578	2	0	2	17.4401144943
385	579	1	0	1	38.9395463016
385	581	15	4	11	36.7120897325
385	585	3	0	3	50.6748169807
386	33	1	0	1	86.522350358
386	70	2	0	2	77.9335995865
386	72	1	0	1	79.9794592953
386	73	26	0	26	75.8000338545
386	74	3	0	3	72.1380895891
386	75	2	0	2	73.6417792621
386	76	1	0	1	75.2012169287
386	78	2	0	2	72.5095986157
386	82	2	0	2	74.860718818
386	84	4	0	4	74.4639566152
386	85	1	0	1	71.5872228817
386	86	1	0	1	68.0102742211
386	103	1	0	1	74.0683317641
386	110	0	0	0	72.5817933252
386	113	2	0	2	69.5436306844
386	128	1	0	1	52.3122120029
386	141	1	0	1	34.3366390998
386	154	1	0	1	47.9763871697
386	161	2	0	2	41.3535769901
386	163	2	0	2	39.4874813297
386	164	2	1	1	62.3302827707
386	165	1	0	1	47.4691043648
386	166	1	0	1	65.7495650583
386	167	2	0	2	36.8032460943
386	168	1	0	1	57.751970755
386	172	3	0	3	53.3505950803
386	174	1	0	1	36.1263805684
386	176	1	0	1	31.5148949612
386	177	6	0	6	52.7796352171
386	319	5	2	3	57.2481882865
386	323	1	0	1	49.6126484255
386	329	2	0	2	69.6559499486
386	336	1	0	1	94.9052858032
386	349	1	0	1	76.671134139
386	379	31	12	19	10.7916428443
386	380	1	1	0	16.1978116714
386	381	17	0	17	9.12441146641
386	383	1	0	1	22.5913245935
386	384	3	1	2	12.5012311706
386	385	385	37	348	4.73349648623
386	387	22	5	17	4.40226387759
386	388	12	6	6	12.6832126323
386	389	4	3	1	16.2216353067
386	390	1	0	1	16.3353893467
386	391	32	0	32	14.0053539901
386	392	39	1	38	9.67509889564
386	393	2	0	2	18.5002494378
386	394	25	0	25	14.5520188995
386	395	9	0	9	9.99059060254
386	396	6	0	6	30.4643934916
386	397	3	1	2	29.3348587485
386	398	1	0	1	32.7269960408
386	401	2	0	2	30.6258104149
386	404	2	1	1	24.5749614073
386	405	1	0	1	35.4594710988
386	406	18	3	15	35.1946708748
386	408	119	27	92	30.8174342462
386	410	8	0	8	27.3300261469
386	411	27	8	19	23.7682253118
386	413	1	0	1	30.7469618421
386	414	2	0	2	43.7575451134
386	415	12	0	12	23.6262136035
386	416	2	0	2	40.3740408632
386	417	24	0	24	20.2745880779
386	418	2	0	2	19.5361818287
386	427	1	0	1	44.2005873319
386	438	1	0	1	44.4241959772
386	442	4	0	4	46.2440442987
386	448	1	0	1	49.5498824034
386	450	1	0	1	17.6513363208
386	451	1	0	1	29.2358461936
386	452	1	0	1	21.1400423615
386	454	4	0	4	22.8625795868
386	455	6	0	6	25.0229816532
386	456	1	0	1	31.9791212694
386	459	8	2	6	16.7244202126
386	460	13	0	13	25.258595773
386	462	1	0	1	19.7391379754
386	506	1	0	1	51.4765687143
386	515	1	0	1	52.1173408554
386	520	1	0	1	21.2537411011
386	522	2	0	2	26.1271199548
386	524	10	3	7	29.6437993254
386	527	1	0	1	44.6062024815
386	528	1	0	1	35.9805430305
386	535	1	0	1	69.9316199259
386	540	1	0	1	59.4185395339
386	554	8	0	8	23.5279616766
386	555	3	0	3	32.1019723498
386	557	4	2	2	16.1412530978
386	558	2	0	2	11.8336892016
386	562	2	0	2	19.4847696299
386	563	2	0	2	26.4398642611
386	566	31	8	23	13.0366649916
386	567	1	0	1	20.252150395
386	568	3	0	3	27.8004400805
386	569	1	0	1	34.4523890067
386	571	5	0	5	14.1030627418
386	573	56	13	43	25.993214721
386	574	3	0	3	6.26658660667
386	575	2	0	2	30.8800500033
386	578	1	1	0	20.2789514961
386	581	1	0	1	38.7435083981
386	585	3	0	3	49.271708937
386	586	1	0	1	56.9384806355
387	36	1	0	1	86.0035492743
387	72	1	0	1	83.2659639444
387	73	18	2	16	78.9373910751
387	74	1	0	1	75.3934606118
387	76	0	0	0	78.6222437432
387	78	6	0	6	75.8306351702
387	81	1	0	1	81.2483846817
387	82	2	0	2	78.2008926475
387	83	2	0	2	78.1199396486
387	84	4	0	4	77.6249918585
387	85	1	0	1	75.0481881229
387	86	1	0	1	71.3756569059
387	87	3	0	3	74.1028490102
387	88	2	0	2	72.4026575693
387	90	1	0	1	76.948800806
387	103	1	0	1	76.9737920108
387	110	1	0	1	75.3024965923
387	113	2	0	2	72.4867739973
387	142	0	0	0	61.8537196764
387	155	1	0	1	70.4368314403
387	159	1	0	1	61.6265158155
387	166	1	0	1	69.8546622094
387	168	5	0	5	61.2660652987
387	172	1	0	1	56.7801040419
387	177	3	0	3	56.4658838122
387	296	1	0	1	114.674726705
387	305	1	0	1	118.044594935
387	319	4	0	4	61.6405578709
387	338	0	0	0	94.131570338
387	349	1	0	1	81.0130181736
387	357	1	1	0	79.9325794273
387	379	29	3	26	8.8702627727
387	380	1	0	1	18.7206238908
387	381	16	1	15	7.17149207818
387	382	0	0	0	23.8209255451
387	383	1	0	1	18.4328555894
387	385	201	67	134	6.74594837801
387	386	37	11	26	4.40226387759
387	388	24	2	22	8.57326730637
387	389	12	0	12	12.1020670835
387	390	1	0	1	15.0498323711
387	391	18	0	18	13.9494936354
387	392	24	1	23	11.2328041621
387	394	25	3	22	11.2189466184
387	395	14	2	12	5.60590912347
387	396	6	0	6	27.4149933753
387	397	1	0	1	26.7162855931
387	398	2	0	2	28.411234952
387	399	1	0	1	39.125920956
387	401	5	1	4	26.416790405
387	402	3	0	3	19.766197699
387	404	1	0	1	20.2509506753
387	406	15	1	14	31.633871559
387	407	1	0	1	31.9887010032
387	408	141	0	141	26.9972200044
387	409	3	1	2	36.5534803647
387	410	4	1	3	23.777991208
387	411	41	8	33	19.9049394532
387	412	3	0	3	35.1764685032
387	413	2	1	1	26.3482045265
387	414	3	0	3	40.2328146436
387	415	5	0	5	20.7203169644
387	416	3	1	2	36.473139981
387	417	16	2	14	16.941277457
387	418	3	2	1	15.3838557543
387	419	2	0	2	30.6093542997
387	427	1	0	1	40.0504778783
387	431	1	0	1	47.5033297168
387	438	2	0	2	40.0687918243
387	441	1	0	1	36.7792767853
387	450	1	0	1	19.0779667154
387	454	2	1	1	23.3924619174
387	455	1	0	1	26.7890473704
387	459	4	2	2	14.3281835298
387	460	5	0	5	24.6282089047
387	475	1	0	1	38.1077320241
387	507	2	0	2	95.5093973528
387	519	1	0	1	52.4317053828
387	520	1	0	1	18.2640540658
387	522	1	0	1	24.7500857222
387	524	11	3	8	29.5378467591
387	528	1	0	1	32.8501480741
387	540	2	0	2	59.2838302102
387	551	0	0	0	38.8311739205
387	554	6	0	6	25.9833107899
387	555	1	0	1	35.5825473492
387	557	2	0	2	19.006844494
387	558	5	0	5	13.0438839463
387	563	1	0	1	30.4042551685
387	566	10	2	8	17.2695203954
387	568	1	0	1	31.408874672
387	569	3	0	3	38.849269175
387	571	3	1	2	18.4336168861
387	573	28	0	28	30.3651611235
387	576	1	0	1	49.7618258138
387	581	1	0	1	42.8167557887
387	583	1	0	1	75.8175254021
387	585	2	1	1	53.4355918786
388	45	1	0	1	72.9672968682
388	71	2	1	1	75.2814041074
388	73	18	1	17	82.3761158772
388	74	2	0	2	79.1465261494
388	75	4	0	4	80.0910052923
388	76	3	0	3	82.7731040791
388	78	4	1	3	79.7446898638
388	81	1	0	1	85.0393117558
388	83	3	0	3	81.7585517258
388	84	2	0	2	81.1303795139
388	85	3	1	2	79.324479165
388	86	3	1	2	75.4328309953
388	87	3	0	3	77.5779863884
388	103	1	0	1	79.8722325311
388	109	1	0	1	86.8868220721
388	113	2	1	1	75.5093665631
388	141	1	0	1	35.6479664715
388	142	2	0	2	63.6032109688
388	154	2	0	2	53.3159681316
388	155	1	0	1	75.8710096427
388	164	1	0	1	70.3929454321
388	166	3	0	3	76.0339030884
388	168	1	0	1	65.7851496607
388	170	1	0	1	61.9815980612
388	171	2	0	2	73.5738435772
388	177	0	0	0	61.4808236911
388	319	6	5	1	69.2337386591
388	338	1	0	1	101.379935293
388	345	1	0	1	153.627416695
388	349	1	0	1	88.1731703739
388	375	1	0	1	141.220434799
388	379	18	11	7	7.46165421919
388	381	6	1	5	12.4697296823
388	382	1	0	1	19.800884961
388	383	2	0	2	14.0680751056
388	385	97	0	97	12.5852676456
388	386	5	0	5	12.6832126323
388	387	9	3	6	8.57326730637
388	389	9	1	8	9.27644610138
388	390	2	0	2	12.3487144359
388	391	6	1	5	14.0177189301
388	392	6	1	5	14.8177824832
388	393	4	0	4	7.57648368172
388	394	25	13	12	4.57121762956
388	395	38	12	26	4.89392997042
388	396	14	0	14	19.8601420366
388	397	2	1	1	19.9113994162
388	398	4	2	2	22.2870560938
388	400	3	0	3	22.1941048044
388	401	10	1	9	17.9481253964
388	402	1	0	1	13.2710901554
388	404	16	2	14	12.1008319018
388	405	2	0	2	22.7866572611
388	406	34	2	32	23.3394440851
388	407	1	0	1	24.3121656117
388	408	500	198	302	18.4992932685
388	410	16	4	12	15.5694937456
388	411	223	5	218	11.408384878
388	413	3	0	3	18.7817677275
388	414	7	0	7	31.9327843193
388	415	19	6	13	13.6856369307
388	416	2	0	2	27.9197650231
388	417	55	39	16	9.32639729912
388	418	32	2	30	6.85297977993
388	419	2	1	1	22.4015087759
388	421	1	0	1	37.7665011917
388	425	1	0	1	35.152247587
388	426	1	0	1	52.2312609471
388	427	1	0	1	31.522898558
388	432	1	0	1	46.7351186369
388	433	1	0	1	46.3447529873
388	434	1	0	1	24.6563955969
388	438	0	0	0	33.365998132
388	441	0	0	0	29.4875343538
388	442	6	1	5	33.7877914749
388	447	2	0	2	45.1038373629
388	448	1	0	1	36.8669801567
388	450	3	1	2	20.8528227986
388	453	1	0	1	16.3085457633
388	454	1	0	1	22.9648087579
388	455	1	1	0	28.4508822049
388	459	4	1	3	9.28466560039
388	460	6	0	6	21.8093792109
388	469	2	0	2	46.9760394785
388	511	0	0	0	104.55844676
388	515	1	0	1	49.091880829
388	520	2	0	2	18.472836825
388	522	1	0	1	27.8665763264
388	523	2	0	2	41.6351162627
388	524	12	2	10	34.4789833947
388	532	1	0	1	80.5528018221
388	537	0	0	0	53.4433354806
388	540	4	1	3	63.5276445198
388	541	1	0	1	88.6460679838
388	552	0	0	0	56.9160672194
388	554	1	0	1	33.8873430781
388	555	1	0	1	44.0554980602
388	561	2	0	2	43.3066048617
388	566	10	2	8	24.4956301462
388	569	1	0	1	46.5679836996
388	571	0	0	0	26.7584915918
388	573	22	3	19	37.9101157122
388	578	4	0	4	29.5254337607
388	579	1	0	1	51.5215710225
388	581	0	0	0	49.0750092858
388	583	1	0	1	84.3632386972
388	585	2	0	2	61.9439490324
389	73	6	0	6	90.4439601285
389	74	3	0	3	87.032096716
389	75	1	0	1	88.2020700128
389	76	1	0	1	90.4153146928
389	78	1	0	1	87.5339283632
389	81	1	0	1	92.9089648926
389	84	1	0	1	89.1600917038
389	85	1	0	1	86.8799731106
389	113	1	0	1	83.7827065008
389	131	2	1	1	67.93214444
389	167	1	0	1	52.2297430792
389	168	1	0	1	73.1569061602
389	277	1	0	1	141.05557393
389	319	1	0	1	73.1085368767
389	329	1	1	0	85.8751861357
389	364	1	0	1	82.998344439
389	379	10	0	10	16.2479698215
389	380	1	0	1	30.1120653254
389	381	15	2	13	9.86365444641
389	382	7	2	5	11.7451590298
389	383	16	4	12	6.37162395041
389	385	39	12	27	18.5774395784
389	386	2	0	2	16.2216353067
389	387	6	1	5	12.1020670835
389	388	13	3	10	9.27644610138
389	391	1	0	1	22.8458388717
389	392	2	0	2	22.3010666449
389	393	11	6	5	5.48262924323
389	394	3	1	2	13.6807152774
389	395	35	13	22	6.94798080814
389	396	6	0	6	26.6256271772
389	397	3	0	3	27.6037382961
389	398	7	4	3	16.750997935
389	400	2	0	2	24.6802258124
389	401	10	2	8	19.2985590219
389	402	7	3	4	9.06700912108
389	404	12	4	8	12.646537322
389	405	2	0	2	24.4432036858
389	406	10	0	10	28.1396148979
389	407	3	0	3	30.6289781381
389	408	119	0	119	22.6010725636
389	410	3	0	3	21.2870791315
389	411	40	0	40	16.447421584
389	412	1	0	1	28.0772332357
389	413	7	0	7	16.433797507
389	414	3	0	3	36.310711575
389	415	5	3	2	21.5508431338
389	417	14	4	10	17.0224617678
389	418	7	0	7	11.1591053307
389	419	1	0	1	21.9178925393
389	424	1	0	1	52.6931810799
389	430	1	0	1	27.315568206
389	433	1	0	1	40.8102442991
389	438	1	0	1	28.5698687554
389	439	1	0	1	35.0073576425
389	440	1	0	1	23.9126721156
389	441	3	0	3	25.933697934
389	442	2	0	2	32.3694364969
389	444	1	0	1	41.3596643083
389	459	2	1	1	18.4607932674
389	460	1	0	1	31.0691033976
389	462	2	0	2	27.2784628049
389	466	2	1	1	58.1495706408
389	516	1	0	1	35.5416615768
389	520	8	0	8	9.48224021013
389	522	1	1	0	19.8580110846
389	524	8	1	7	27.5832785374
389	537	1	0	1	46.0444865979
389	554	2	0	2	31.2013928984
389	558	2	0	2	18.0198580204
389	559	1	0	1	43.697242557
389	566	1	0	1	29.2577346926
389	573	12	1	11	42.0495714036
389	581	2	0	2	54.9066938372
389	585	2	0	2	62.9266813938
390	50	1	0	1	70.1420513721
390	72	2	0	2	76.4657191838
390	73	18	0	18	71.5423117556
390	74	3	0	3	68.5985327871
390	75	1	0	1	69.2058169594
390	76	3	0	3	72.5606323616
390	78	3	0	3	69.3353944094
390	81	0	0	0	74.479955245
390	82	1	0	1	71.7489923127
390	84	1	0	1	70.3586774463
390	85	1	0	1	69.265467733
390	86	2	0	2	65.1965183136
390	87	3	0	3	66.808338739
390	88	0	0	0	65.3506121273
390	113	3	1	2	64.4096935524
390	118	1	0	1	69.6925970831
390	142	1	0	1	51.8245457396
390	155	2	0	2	67.2077223872
390	163	1	0	1	33.8670682009
390	168	5	1	4	56.1443232441
390	169	1	0	1	78.914108139
390	171	1	0	1	64.3466835712
390	172	5	0	5	51.3808818372
390	177	4	0	4	52.502208967
390	303	1	0	1	103.488235847
390	319	5	4	1	64.8129786057
390	329	3	0	3	73.7069396581
390	334	1	0	1	103.082676458
390	338	0	0	0	95.642086742
390	341	1	0	1	106.955984964
390	379	20	5	15	6.24642182145
390	380	2	0	2	14.6031685225
390	384	1	0	1	15.8442250443
390	385	69	27	42	12.4445465023
390	386	1	0	1	16.3353893467
390	388	2	0	2	12.3487144359
390	391	23	8	15	4.53056228266
390	392	14	12	2	9.83331980711
390	394	15	0	15	8.35939657537
390	395	3	0	3	15.851354841
390	396	30	4	26	16.5694246667
390	397	5	0	5	14.2777023686
390	398	2	0	2	32.8663278136
390	401	4	0	4	23.6071158962
390	405	2	0	2	26.9641979312
390	406	29	0	29	22.9408084298
390	407	5	1	4	20.8898944465
390	408	229	45	184	20.5097360385
390	409	10	0	10	26.9830129011
390	410	12	2	10	16.0370524381
390	411	73	2	71	15.2426778113
390	412	2	0	2	30.3938180821
390	413	2	0	2	27.5969162732
390	414	3	1	2	30.8021929517
390	415	25	0	25	10.1988032382
390	416	1	0	1	29.6092208334
390	417	34	8	26	9.90812764255
390	421	2	0	2	40.0399786476
390	425	1	0	1	40.3995175018
390	427	3	1	2	35.1397716158
390	433	1	0	1	55.8857613845
390	437	1	0	1	68.4507169067
390	438	2	0	2	42.730249286
390	439	1	0	1	51.0785270985
390	441	1	0	1	38.0441743332
390	442	1	0	1	39.9587224912
390	445	0	0	0	49.842480853
390	450	3	0	3	10.8012691487
390	451	3	0	3	13.1399474227
390	452	5	3	2	4.81657947215
390	453	4	0	4	9.33606081499
390	454	6	0	6	10.871149629
390	455	6	0	6	17.3614071318
390	457	4	0	4	13.1006435686
390	458	2	0	2	8.96628876657
390	459	34	19	15	4.34005827843
390	460	33	22	11	9.78217850189
390	462	3	0	3	5.80185449637
390	475	1	0	1	23.4882330339
390	503	0	0	0	21.4281690657
390	516	0	0	0	55.7297072272
390	524	3	0	3	44.5290379879
390	537	1	0	1	63.5659736132
390	548	1	0	1	117.00298973
390	554	1	0	1	39.82634106
390	558	2	0	2	27.8072700619
390	561	1	0	1	51.1326685539
390	566	11	2	9	21.9588890736
390	568	2	0	2	28.9216416822
390	573	18	6	12	34.5614359889
390	578	2	0	2	23.0615849179
390	581	1	0	1	42.3189130335
391	1	1	0	1	95.4030082724
391	70	2	0	2	71.8463431533
391	71	1	0	1	61.5918518947
391	73	40	1	39	68.5276809986
391	74	5	0	5	65.4135132896
391	75	4	0	4	66.2221515839
391	78	6	2	4	66.0767037989
391	79	1	0	1	72.3534472864
391	81	1	0	1	71.3063149305
391	82	8	0	8	68.4872061665
391	83	2	0	2	67.9764011359
391	84	3	0	3	67.3048457747
391	86	3	0	3	61.8460529662
391	87	4	0	4	63.7504162862
391	88	3	0	3	62.2217722596
391	92	1	0	1	76.7007950901
391	110	3	1	2	63.7751478294
391	113	5	0	5	61.568998661
391	135	1	0	1	33.0793102884
391	141	0	0	0	22.0309842039
391	142	1	0	1	49.6054585398
391	154	1	0	1	39.3516274991
391	161	1	1	0	34.5927596142
391	162	1	0	1	69.736851053
391	163	1	0	1	30.8673101999
391	166	1	0	1	64.2947582732
391	167	1	0	1	32.2945388577
391	168	4	0	4	52.5183781913
391	172	5	1	4	47.7887535226
391	175	1	0	1	55.9822960819
391	176	1	0	1	22.452214138
391	177	9	5	4	48.6349305985
391	180	1	0	1	38.7296283909
391	284	1	0	1	121.761141687
391	319	17	0	17	60.2933824814
391	323	1	0	1	51.1333273295
391	329	1	0	1	69.3978473067
391	338	0	0	0	91.221434256
391	349	1	0	1	77.9420470869
391	375	2	0	2	129.544641681
391	379	42	9	33	6.61556476528
391	380	3	1	2	10.1902695151
391	381	1	0	1	21.1143844337
391	383	1	0	1	28.0822432978
391	384	2	0	2	11.3515023556
391	385	257	61	196	9.50927576331
391	386	12	10	2	14.0053539901
391	387	5	1	4	13.9494936354
391	388	1	0	1	14.0177189301
391	389	0	0	0	22.8458388717
391	390	17	4	13	4.53056228266
391	392	48	13	35	5.74747993384
391	393	1	0	1	21.4635212233
391	394	31	7	24	11.0492901558
391	395	3	1	2	16.3395619624
391	396	30	0	30	21.069183934
391	397	1	0	1	18.626869016
391	401	3	0	3	27.6384840377
391	402	1	0	1	26.87328477
391	404	1	0	1	23.860264074
391	405	1	0	1	31.2447088225
391	406	47	0	47	27.4699471866
391	407	6	2	4	25.3340474036
391	408	224	0	224	24.9133990423
391	409	4	1	3	31.4962954952
391	410	7	0	7	20.47870561
391	411	70	7	63	19.2852214736
391	412	1	0	1	34.7486275496
391	414	2	0	2	35.3114122698
391	415	24	3	21	14.7223388763
391	416	2	1	1	34.1029285801
391	417	54	0	54	14.0196567054
391	421	3	0	3	44.5371493696
391	422	2	0	2	56.6472559964
391	425	1	0	1	44.6518509117
391	426	1	0	1	62.3437688422
391	427	3	0	3	39.5359366571
391	433	2	0	2	59.2955748322
391	438	0	0	0	46.1500480801
391	441	0	0	0	41.6672975422
391	442	2	0	2	44.0790969608
391	450	9	0	9	7.03131190886
391	451	4	2	2	16.9693453595
391	453	4	0	4	13.7052294098
391	454	6	2	4	9.52520229487
391	455	27	0	27	14.4429059946
391	457	3	1	2	16.2006401621
391	458	2	0	2	12.3794407812
391	459	26	24	2	8.32365751807
391	460	49	0	49	11.30954874
391	462	2	1	1	5.73434307204
391	467	0	0	0	16.8415664746
391	475	0	0	0	24.3090794773
391	503	1	0	1	25.2529560148
391	512	1	0	1	74.0671741673
391	520	0	0	0	31.1677264785
391	536	1	0	1	76.6265576892
391	540	1	0	1	73.1028626055
391	543	1	0	1	98.536442018
391	548	1	0	1	116.089777609
391	551	0	0	0	43.2604984482
391	554	2	0	2	37.011715658
391	563	0	0	0	36.6958944096
391	566	22	10	12	17.6420336395
391	567	1	0	1	30.0003075448
391	568	3	0	3	24.6405819808
391	571	1	0	1	23.2526233147
391	572	1	0	1	50.4036373202
391	573	37	12	25	30.0598757514
391	574	1	0	1	18.3388440523
391	577	1	0	1	46.9274301858
391	579	1	0	1	42.2777116032
391	580	1	0	1	31.4003591649
391	581	6	0	6	37.9452926884
391	585	1	0	1	57.4818011307
392	1	1	0	1	97.263493061
392	5	1	0	1	97.5835144669
392	23	1	0	1	89.394036097
392	26	1	0	1	82.0376195434
392	39	1	0	1	84.9772843666
392	50	1	0	1	73.0296050288
392	70	6	0	6	70.8941360722
392	71	5	2	3	60.8366547218
392	72	1	0	1	72.6400517893
392	73	79	3	76	68.1434378148
392	74	8	1	7	64.7441767996
392	75	11	1	10	65.9047361541
392	76	2	0	2	68.201000985
392	78	18	1	17	65.2677757705
392	79	1	0	1	71.8902393835
392	81	3	1	2	70.6254440053
392	82	6	2	4	67.6591082478
392	83	5	0	5	67.4169156257
392	84	9	0	9	66.8590559961
392	85	2	0	2	64.7027656446
392	86	5	1	4	60.889424725
392	87	7	0	7	63.3189132482
392	88	1	0	1	61.6741411615
392	89	1	0	1	79.753987923
392	92	1	0	1	75.8111360185
392	103	1	0	1	65.9759460788
392	109	1	0	1	72.1745134747
392	110	1	1	0	64.1921871536
392	112	4	0	4	68.3939728516
392	113	5	0	5	61.5237924806
392	120	1	0	1	74.2285740543
392	131	1	0	1	50.9977150078
392	141	1	0	1	24.6885048529
392	142	3	0	3	50.6291458571
392	147	1	1	0	34.239789788
392	154	3	0	3	39.5423275844
392	155	2	1	1	61.0551351818
392	156	1	0	1	66.0697333874
392	158	1	0	1	45.6532519525
392	160	2	0	2	42.1684840377
392	161	1	0	1	33.7155795112
392	163	1	0	1	30.9710374885
392	164	4	0	4	55.6832799406
392	165	1	0	1	41.6990639898
392	166	8	3	5	61.3668740773
392	167	4	0	4	30.2868831483
392	168	11	1	10	51.0727185889
392	171	2	0	2	58.7790399306
392	172	7	1	6	46.4595467112
392	173	1	0	1	40.8129832274
392	176	1	0	1	22.6983261988
392	177	16	2	14	46.6743543511
392	180	1	0	1	36.4706776189
392	281	0	0	0	110.383092105
392	310	0	0	0	101.093506821
392	319	21	4	17	55.8907385588
392	323	8	1	7	47.1118059843
392	325	1	0	1	52.5361285929
392	329	4	1	3	66.068053574
392	338	2	0	2	87.4053652609
392	341	1	0	1	99.0344742227
392	349	1	0	1	74.1419354262
392	351	2	0	2	77.3269048629
392	366	1	0	1	60.813538764
392	375	1	0	1	126.616123745
392	379	82	43	39	8.04464047333
392	380	13	9	4	7.82662293327
392	381	9	0	9	18.1298845108
392	383	4	0	4	28.2233287079
392	384	13	0	13	6.62853746373
392	385	793	274	519	4.96175270716
392	386	29	1	28	9.67509889564
392	387	24	5	19	11.2328041621
392	388	3	0	3	14.8177824832
392	389	5	0	5	22.3010666449
392	390	11	0	11	9.83331980711
392	391	88	1	87	5.74747993384
392	393	2	1	1	22.3245504173
392	394	51	0	51	13.5142739653
392	395	8	2	6	15.3639786164
392	396	22	0	22	26.2769260335
392	397	8	1	7	24.110824659
392	398	4	0	4	37.0947020932
392	400	1	0	1	33.8864821479
392	401	2	0	2	30.9926006744
392	402	1	0	1	28.0808328806
392	404	2	0	2	26.2686693155
392	406	54	11	43	32.3271736363
392	407	10	0	10	30.6766924371
392	408	336	0	336	29.1761038818
392	409	2	0	2	36.6104502423
392	410	13	1	12	24.9277404743
392	411	85	1	84	22.8782106952
392	412	4	0	4	38.7610049148
392	413	1	0	1	33.3064430312
392	414	3	0	3	40.4392934902
392	415	51	5	46	19.6317362897
392	416	5	1	4	38.6314176458
392	417	47	1	46	17.9649636146
392	418	3	0	3	20.5236241824
392	419	2	0	2	36.0658698948
392	421	1	0	1	49.0392734615
392	425	2	1	1	48.3117656019
392	426	1	0	1	65.8571305025
392	427	1	0	1	43.6416786127
392	433	1	0	1	61.1487899491
392	434	1	0	1	37.9474189584
392	435	2	0	2	42.4093465005
392	438	2	0	2	48.1278501067
392	441	0	0	0	44.0492865772
392	442	17	0	17	47.4239675519
392	444	2	0	2	53.821214863
392	445	1	0	1	53.1714503187
392	450	6	2	4	8.01296461534
392	451	2	1	1	22.6922650668
392	453	1	0	1	19.1692319088
392	454	8	0	8	13.3281773059
392	455	38	0	38	15.5953090108
392	457	1	0	1	21.9201630221
392	458	2	0	2	18.1268074167
392	459	16	0	16	12.5996037105
392	460	34	0	34	16.6977224564
392	462	2	1	1	10.9922440312
392	466	2	0	2	50.8723273966
392	471	1	0	1	63.1804002983
392	475	2	0	2	28.9389327917
392	503	1	0	1	30.985761079
392	507	1	0	1	106.211578861
392	509	1	0	1	116.103617491
392	512	1	0	1	71.697601131
392	516	1	0	1	57.8420007097
392	520	1	0	1	29.4560533947
392	521	1	0	1	38.0391834229
392	524	7	0	7	39.3070452497
392	528	1	0	1	43.9289263385
392	530	1	0	1	83.1834523044
392	536	1	0	1	71.5972099255
392	540	1	0	1	69.061591268
392	549	1	0	1	95.4777706887
392	554	8	1	7	31.6804247417
392	555	3	0	3	38.0245502151
392	558	1	0	1	21.3310789919
392	561	1	0	1	43.7926621961
392	563	0	0	0	30.9534472458
392	566	128	53	75	12.1558191064
392	567	3	1	2	24.260390765
392	568	12	0	12	21.8420615726
392	569	1	0	1	33.8071664287
392	570	2	0	2	40.5441127354
392	571	3	0	3	17.5084428069
392	573	196	7	189	25.0816564255
392	574	2	0	2	12.9273054985
392	577	4	1	3	42.4319525995
392	578	3	0	3	14.887747382
392	579	2	0	2	37.9140912803
392	580	2	0	2	27.5236364593
392	581	8	4	4	34.5388414104
392	585	4	0	4	51.9688536199
392	586	1	0	1	60.5736844079
393	65	1	0	1	101.258750012
393	71	2	0	2	82.8536930598
393	73	10	0	10	89.9251912693
393	74	2	0	2	86.7152429058
393	75	2	0	2	87.6341738126
393	78	3	0	3	87.3186014965
393	81	4	0	4	92.608421255
393	85	1	0	1	86.8995945197
393	87	1	0	1	85.1316419689
393	103	1	0	1	87.3668391196
393	113	1	0	1	83.0224144158
393	142	3	0	3	70.9196207015
393	163	1	0	1	52.3108643634
393	167	1	0	1	52.6107889972
393	172	5	0	5	68.6999387986
393	177	1	0	1	68.9979002292
393	242	1	0	1	209.647339969
393	309	1	0	1	115.678389886
393	319	2	0	2	75.7313156008
393	323	2	0	2	67.8912739188
393	330	2	0	2	65.971942237
393	349	1	0	1	95.0030038605
393	379	3	0	3	14.9991246173
393	381	10	1	9	14.3229262817
393	382	3	1	2	12.5858523525
393	383	11	8	3	7.03154269833
393	385	30	1	29	19.5910269179
393	386	3	0	3	18.5002494378
393	387	4	0	4	14.0991519065
393	388	16	4	12	7.57648368172
393	389	20	8	12	5.48262924323
393	392	3	0	3	22.3245504173
393	394	5	0	5	10.856256403
393	395	25	1	24	8.53342079168
393	396	13	0	13	21.5131225406
393	397	1	0	1	22.8337259235
393	398	12	3	9	14.7916750924
393	400	1	0	1	19.2840254535
393	401	12	2	10	14.0069073876
393	402	17	5	12	5.8179527382
393	404	31	25	6	7.31363975444
393	405	2	0	2	19.1697066328
393	406	25	0	25	22.6770694546
393	407	4	1	3	25.3553967385
393	408	321	0	321	17.1234946084
393	409	2	0	2	27.6737795707
393	410	13	0	13	16.0061868395
393	411	125	2	123	11.1626521738
393	412	1	0	1	22.8828752725
393	413	30	0	30	12.3220312082
393	414	1	0	1	30.828252324
393	415	16	0	16	17.0267003504
393	416	4	0	4	25.38875645
393	417	22	0	22	12.6352216736
393	418	22	9	13	6.12733714455
393	419	3	0	3	17.1650832739
393	421	1	0	1	34.2180049861
393	425	2	0	2	29.9582537871
393	430	5	0	5	28.6635180497
393	435	1	0	1	23.021704649
393	436	1	0	1	48.309892021
393	438	5	2	3	26.1454970048
393	439	1	0	1	33.5231612108
393	440	2	0	2	23.0707642686
393	441	0	0	0	22.6821019587
393	442	8	0	8	28.1187817171
393	451	2	0	2	25.6351849489
393	452	1	0	1	21.579199736
393	453	1	0	1	20.5596927347
393	454	1	0	1	30.0583030469
393	457	3	0	3	28.1022348778
393	459	2	1	1	15.4106010944
393	460	4	0	4	28.0174751995
393	499	1	0	1	39.6061952665
393	507	1	0	1	92.9817427894
393	512	1	0	1	55.9083125958
393	516	0	0	0	36.5446892363
393	520	6	2	4	14.3330789548
393	521	2	0	2	21.8531522271
393	522	1	0	1	25.1236730602
393	524	7	0	7	33.0349304408
393	540	1	0	1	60.6640521563
393	548	1	0	1	102.259474543
393	554	1	0	1	36.1933311021
393	555	1	0	1	47.6005272931
393	561	1	0	1	43.7526493598
393	566	3	0	3	31.190335932
393	569	1	0	1	52.9463092816
393	573	7	2	5	44.4317617067
393	581	2	0	2	56.2957216559
393	587	1	0	1	79.4152103767
394	46	1	0	1	93.0411859019
394	47	1	0	1	78.341737192
394	48	2	0	2	73.4324704327
394	59	1	0	1	77.0053682497
394	70	1	0	1	82.894904063
394	73	16	2	14	79.5199081019
394	74	4	1	3	76.4469680441
394	75	2	0	2	77.2036315118
394	78	4	0	4	77.1205381891
394	82	4	0	4	79.5315869319
394	84	3	0	3	78.308511089
394	85	2	0	2	76.8831190024
394	86	1	0	1	72.8952195023
394	102	1	0	1	93.0431994553
394	112	1	0	1	78.9604606209
394	131	2	0	2	54.2525229792
394	142	2	0	2	60.1331240936
394	155	1	0	1	74.0963954984
394	177	3	0	3	59.5289139959
394	284	1	0	1	132.80882398
394	319	4	0	4	69.2012609071
394	329	1	0	1	79.5596313785
394	379	41	10	31	5.47495173799
394	380	1	0	1	20.6232247979
394	381	4	0	4	16.5095436898
394	383	3	0	3	17.8084404691
394	385	96	16	80	12.8868669526
394	386	2	1	1	14.5520188995
394	387	2	1	1	11.2189466184
394	388	11	6	5	4.57121762956
394	389	2	0	2	13.6807152774
394	390	3	1	2	8.35939657537
394	391	16	0	16	11.0492901558
394	392	11	2	9	13.5142739653
394	395	2	1	1	9.1799367699
394	396	21	6	15	16.2045860594
394	397	6	1	5	15.7624478954
394	398	2	0	2	24.7644308687
394	400	3	1	2	20.8220843139
394	401	2	1	1	17.5134084194
394	404	3	1	2	12.9283321931
394	406	25	3	22	20.6456782599
394	407	3	0	3	20.7717578046
394	408	200	101	99	16.4725728045
394	409	2	0	2	25.4704489174
394	410	15	7	8	12.786767596
394	411	157	82	75	9.64357457748
394	412	2	0	2	25.5826773675
394	413	5	0	5	20.0875599832
394	414	2	0	2	29.2058179817
394	415	30	0	30	9.61130766851
394	416	2	0	2	26.0777821334
394	417	111	79	32	5.74759285223
394	418	10	3	7	7.17754028433
394	421	1	0	1	36.2997108811
394	425	1	0	1	34.8743380473
394	427	1	0	1	30.5014970655
394	438	2	0	2	35.1416227773
394	441	1	0	1	30.7798115871
394	442	3	1	2	33.915519743
394	444	1	0	1	40.5975057735
394	448	1	0	1	35.9197119788
394	450	2	1	1	18.0804045912
394	451	2	0	2	17.0346530491
394	453	2	0	2	11.8561401914
394	454	2	0	2	19.2164664733
394	455	6	0	6	25.3298094177
394	457	2	1	1	18.6425753275
394	459	31	5	26	4.78064986406
394	460	10	0	10	17.4300287492
394	469	1	0	1	42.4111564851
394	503	2	0	2	24.416912736
394	520	1	0	1	23.0006631647
394	524	2	0	2	38.8612110532
394	555	0	0	0	46.6103086624
394	561	1	0	1	47.1978172952
394	566	5	1	4	24.6815672691
394	571	1	0	1	28.0853855599
394	573	23	0	23	38.0711662644
394	578	1	0	1	28.3729997769
394	581	0	0	0	48.0238647945
395	72	1	0	1	87.9772686009
395	73	7	0	7	83.5063633465
395	78	0	0	0	80.5859603792
395	82	0	0	0	82.9715409562
395	84	2	0	2	82.219749157
395	85	0	0	0	79.939457312
395	109	1	0	1	87.303732913
395	177	2	0	2	61.5901134777
395	319	1	0	1	67.238748391
395	326	1	0	1	80.8397844986
395	375	0	0	0	140.27069024
395	379	6	2	4	9.91779909828
395	381	6	0	6	7.59799647989
395	382	0	0	0	18.6459425355
395	383	2	1	1	13.0791628065
395	385	45	17	28	11.7023013558
395	386	11	5	6	9.99059060254
395	387	6	1	5	5.60590912347
395	388	34	0	34	4.89392997042
395	389	6	3	3	6.94798080814
395	390	2	0	2	15.851354841
395	391	6	0	6	16.3395619624
395	392	6	0	6	15.3639786164
395	393	2	1	1	8.53342079168
395	394	7	0	7	9.1799367699
395	396	3	0	3	24.7418771519
395	397	2	0	2	24.7814320299
395	398	2	0	2	22.8360540937
395	399	2	0	2	36.1416305716
395	400	2	0	2	26.1979345217
395	401	4	0	4	21.4789922391
395	402	3	1	2	14.1610758844
395	404	5	1	4	15.0518630757
395	406	12	1	11	27.9634525075
395	407	1	0	1	29.1714298705
395	408	132	15	117	22.9055809328
395	410	3	1	2	20.2950198143
395	411	47	9	38	15.897438715
395	412	1	0	1	30.3630302053
395	413	5	0	5	20.8359628885
395	415	5	0	5	18.5599189235
395	416	0	0	0	32.1084704
395	417	16	4	12	14.2202459121
395	418	12	2	10	10.8142897457
395	421	1	0	1	41.6470620981
395	427	1	1	0	35.1658607509
395	435	1	0	1	31.3933642255
395	441	2	0	2	31.1944696552
395	442	2	1	1	36.515346523
395	451	1	0	1	26.2113303109
395	452	0	0	0	19.7536019101
395	454	1	0	1	25.7809527856
395	458	1	0	1	23.5607009817
395	459	3	0	3	13.5783302125
395	460	3	0	3	25.6040385124
395	520	5	2	3	14.8617933073
395	521	1	0	1	23.5245802495
395	522	0	0	0	23.4042434037
395	524	8	0	8	29.6829080499
395	540	2	0	2	58.9159226128
395	551	1	0	1	44.005858259
395	554	3	0	3	29.2817904206
395	558	1	0	1	15.761100202
395	562	1	0	1	19.9962763161
395	566	7	3	4	22.8442602701
395	568	2	0	2	36.5399685215
395	573	7	1	6	35.9707926789
395	577	1	0	1	53.8688562823
395	581	1	0	1	48.2687566638
395	585	1	0	1	58.5640940931
396	1	5	0	5	101.515021437
396	48	2	0	2	65.0462705142
396	70	16	0	16	86.8917424357
396	71	3	0	3	76.4741733816
396	72	2	0	2	87.6270715353
396	73	245	8	237	82.2856145983
396	74	8	4	4	79.9692436438
396	75	25	3	22	79.8867192178
396	76	3	0	3	84.4434498328
396	78	21	0	21	80.9427560033
396	79	1	0	1	86.1965175404
396	80	1	0	1	85.5192964262
396	81	12	0	12	85.7177252041
396	82	25	2	23	83.3291222064
396	83	15	3	12	82.1870178095
396	84	25	4	21	81.2555929232
396	85	7	0	7	81.4518712178
396	86	4	0	4	77.1811308505
396	87	16	1	15	77.7843806662
396	88	6	0	6	76.5917913399
396	89	1	0	1	94.1126493155
396	95	2	0	2	84.5573292769
396	99	1	0	1	72.3956693083
396	102	1	0	1	93.7359017291
396	103	10	1	9	78.570866671
396	110	1	0	1	75.5844317914
396	112	5	0	5	80.232129161
396	113	17	0	17	74.7111315568
396	116	3	0	3	85.1585510634
396	118	2	0	2	82.2598660545
396	119	1	0	1	80.0326076083
396	140	1	0	1	69.811127972
396	141	4	1	3	32.3025851137
396	142	6	0	6	60.4869619456
396	147	3	0	3	42.2268122881
396	154	5	0	5	53.220393323
396	155	3	0	3	81.1505878753
396	158	1	0	1	66.8261960479
396	163	3	0	3	45.7683558978
396	164	1	0	1	73.576794945
396	166	2	0	2	83.3518686266
396	167	2	0	2	50.795640437
396	168	8	0	8	69.1960128053
396	171	1	0	1	77.7344147436
396	172	9	0	9	64.414380911
396	173	1	0	1	63.1283752295
396	174	1	0	1	37.5690351551
396	175	2	1	1	73.6019043128
396	177	5	1	4	66.400646676
396	183	2	0	2	171.947666422
396	218	1	0	1	180.133015784
396	257	1	0	1	106.533265575
396	277	1	0	1	132.329642058
396	319	17	0	17	81.1222023346
396	323	3	0	3	71.6858824908
396	325	1	0	1	78.5937572877
396	329	4	1	3	89.0019469816
396	338	1	0	1	111.366035359
396	349	3	0	3	98.1175904796
396	351	1	0	1	100.74256544
396	373	1	0	1	138.147284816
396	379	20	6	14	19.9213914771
396	380	1	0	1	30.7716731337
396	381	1	0	1	32.3297935587
396	382	2	1	1	31.7029318067
396	383	2	0	2	27.5124881077
396	385	24	0	24	27.803872417
396	386	0	0	0	30.4643934916
396	388	5	1	4	19.8601420366
396	389	1	0	1	26.6256271772
396	390	5	2	3	16.5694246667
396	391	15	3	12	21.069183934
396	392	9	1	8	26.2769260335
396	394	12	1	11	16.2045860594
396	395	5	0	5	24.7418771519
396	397	130	6	124	3.75625621203
396	398	8	5	3	28.6025128557
396	399	17	0	17	11.7634140741
396	400	12	1	11	12.5206606898
396	401	53	13	40	14.4188657972
396	402	3	0	3	22.960020251
396	403	1	0	1	18.3090351321
396	404	16	1	15	16.7411631937
396	405	22	1	21	14.6291074973
396	406	421	7	414	7.08465582516
396	407	72	9	63	4.59456131425
396	408	2871	2088	783	8.21528097672
396	409	35	0	35	10.4432940927
396	410	117	95	22	5.8006543034
396	411	287	4	283	10.4330542753
396	412	17	2	15	16.8287622761
396	413	12	0	12	21.4250547952
396	414	52	1	51	14.2464647073
396	415	210	42	168	6.87214338435
396	416	47	0	47	14.326106237
396	417	97	23	74	10.578833634
396	418	4	1	3	15.4778531685
396	419	2	0	2	19.0929467349
396	421	4	0	4	24.400688528
396	424	2	0	2	55.2863801392
396	425	3	0	3	27.0841946405
396	426	14	0	14	44.4296598272
396	427	30	0	30	20.8019031764
396	431	5	0	5	31.4174547801
396	432	2	0	2	35.700740608
396	433	3	0	3	47.0430164429
396	434	1	0	1	19.135121038
396	436	1	0	1	43.6257138808
396	438	15	0	15	34.6330326137
396	440	4	0	4	36.8672258316
396	441	3	0	3	29.2086371686
396	442	43	5	38	27.6787748842
396	443	4	0	4	50.097197173
396	444	6	0	6	30.59885357
396	448	4	0	4	25.7300325408
396	449	2	0	2	21.4787799866
396	450	2	0	2	26.2406570394
396	451	9	0	9	8.30619599512
396	453	9	0	9	7.6246050279
396	454	6	1	5	22.9211783999
396	455	10	1	9	30.5704013128
396	457	18	0	18	12.056095324
396	458	6	0	6	11.6351953554
396	459	9	0	9	14.040998947
396	460	50	2	48	16.9020465066
396	462	2	0	2	19.0362583826
396	466	4	0	4	31.6495462647
396	469	4	2	2	31.3548413814
396	470	1	0	1	36.5283523953
396	471	1	0	1	51.5496338902
396	472	1	0	1	41.5064754677
396	473	1	0	1	30.4620505722
396	475	12	1	11	25.6250064221
396	491	1	0	1	40.921828811
396	495	1	0	1	21.154071675
396	500	1	0	1	20.2079771201
396	503	16	1	15	10.3263987878
396	506	2	0	2	23.3606390739
396	507	3	0	3	113.928588827
396	512	1	0	1	76.3789219552
396	515	1	1	0	62.7585369873
396	517	1	0	1	83.552418203
396	521	2	0	2	43.1087299645
396	523	1	0	1	57.8609373004
396	524	9	0	9	53.8991496658
396	537	1	0	1	72.6149792437
396	540	2	0	2	82.1428536313
396	549	1	0	1	105.712480476
396	554	1	0	1	53.3847916094
396	561	1	0	1	63.1662877074
396	563	0	0	0	56.3992004907
396	566	8	3	5	38.4308485177
396	568	1	0	1	44.4837382276
396	569	1	0	1	59.7543904721
396	571	0	0	0	43.1474715811
396	573	78	7	71	51.1270490401
396	576	1	0	1	66.0967467917
396	577	3	1	2	67.8498005533
396	579	2	0	2	63.1394851333
396	580	1	0	1	52.0132484177
396	581	3	0	3	58.0270128439
396	585	1	0	1	78.1811021233
397	1	1	0	1	98.0400532566
397	36	1	0	1	79.8270802382
397	70	4	0	4	83.1577846525
397	71	3	0	3	72.7416117776
397	73	61	2	59	78.5318217634
397	74	7	0	7	76.2272661945
397	75	8	0	8	76.1326418663
397	76	2	0	2	80.7160472746
397	78	6	0	6	77.2072072818
397	81	2	0	2	81.9709352785
397	82	8	0	8	79.591808659
397	83	4	0	4	78.4382819038
397	84	7	0	7	77.5038471791
397	85	3	0	3	77.7390282508
397	86	1	0	1	73.4615400422
397	87	7	0	7	74.0346432689
397	88	3	0	3	72.8478062289
397	92	1	0	1	87.7407818685
397	96	1	0	1	85.8766775549
397	103	1	0	1	74.815451325
397	110	3	0	3	71.8357936488
397	111	1	0	1	93.1280812711
397	112	4	1	3	76.4816881569
397	113	8	0	8	70.9551432449
397	129	1	0	1	70.4780218844
397	140	1	0	1	66.0579634064
397	142	2	0	2	56.7428128621
397	146	1	0	1	67.0398710545
397	154	3	0	3	49.4850506091
397	158	1	0	1	63.3688938413
397	163	1	0	1	42.0839080389
397	164	1	0	1	69.9117132837
397	166	2	0	2	79.9208251225
397	168	2	0	2	65.5490803793
397	172	4	0	4	60.7721542365
397	175	1	0	1	70.0183623473
397	176	1	0	1	34.6619669572
397	177	3	0	3	62.8431549434
397	319	9	2	7	78.1956346603
397	323	2	1	1	68.6323992082
397	379	7	1	6	18.5674941697
397	381	1	0	1	32.2505339467
397	385	10	0	10	26.2130829857
397	387	1	0	1	26.7162855931
397	388	1	0	1	19.9113994162
397	389	2	0	2	27.6037382961
397	390	2	1	1	14.2777023686
397	391	2	1	1	18.626869016
397	392	5	0	5	24.110824659
397	394	1	1	0	15.7624478954
397	396	227	156	71	3.75625621203
397	398	3	1	2	31.4256927723
397	399	11	7	4	13.5745009937
397	400	3	0	3	16.2197218783
397	401	8	2	6	17.6603904268
397	403	3	0	3	21.6207991918
397	404	3	1	2	19.0375867189
397	405	2	0	2	18.3029473349
397	406	131	0	131	10.7430072943
397	407	15	5	10	6.87824533357
397	408	857	244	613	11.7045395301
397	409	10	3	7	13.4868853988
397	410	37	9	28	8.40454582098
397	411	102	24	78	12.2979276507
397	412	10	0	10	20.5832921768
397	413	6	1	5	24.3967750215
397	414	15	0	15	17.1620791562
397	415	80	0	80	6.22652532492
397	416	10	3	7	17.9964474275
397	417	41	4	37	10.7051873567
397	418	3	0	3	16.7069789947
397	419	1	0	1	22.5657366581
397	421	3	0	3	27.91619104
397	425	4	0	4	30.8398370229
397	426	2	0	2	48.1592023303
397	427	5	0	5	24.5345106603
397	431	1	0	1	35.1694348536
397	433	1	0	1	50.6117721682
397	435	2	0	2	27.5959319659
397	438	3	0	3	38.068242563
397	439	1	0	1	46.978859937
397	441	3	2	1	32.6839784999
397	442	19	1	18	31.4190912141
397	444	6	3	3	34.2622122308
397	445	2	0	2	48.158661005
397	451	25	2	23	4.57166881411
397	452	2	0	2	10.3166255702
397	453	9	3	6	4.9416432611
397	454	2	0	2	19.4580463101
397	455	4	0	4	27.088942802
397	457	19	7	12	8.31681763203
397	458	7	5	2	8.08521977944
397	459	2	0	2	12.6117773027
397	460	43	0	43	13.2706906069
397	466	4	0	4	30.6475120046
397	467	1	0	1	20.7239415238
397	469	2	1	1	28.8919621106
397	471	1	0	1	49.3468487288
397	475	5	0	5	22.0470670298
397	496	1	0	1	14.8233398694
397	497	1	1	0	12.155497718
397	501	1	0	1	26.5530532162
397	503	8	1	7	8.80302513836
397	506	2	0	2	26.5313942576
397	509	1	0	1	126.445843183
397	511	1	0	1	122.562312601
397	512	1	0	1	78.390648714
397	516	1	0	1	55.5763470498
397	520	1	0	1	37.0151899909
397	524	0	0	0	54.3545757198
397	540	2	1	1	83.0801488719
397	554	0	0	0	52.6445028519
397	566	2	1	1	36.2257357185
397	573	25	1	24	48.5952477893
397	579	0	0	0	60.2609138231
397	581	2	0	2	54.8525849831
398	1	1	0	1	128.513658694
398	70	3	0	3	107.592950923
398	71	3	2	1	97.3646825757
398	72	0	0	0	109.08565646
398	73	30	3	27	104.284338553
398	74	1	0	1	101.192775975
398	75	4	0	4	101.967388885
398	78	1	0	1	101.845299995
398	82	5	0	5	104.254284569
398	83	1	0	1	103.754105625
398	84	6	0	6	103.072021761
398	85	0	0	0	101.52593371
398	86	2	0	2	97.5851510172
398	87	4	1	3	99.5177552696
398	88	1	0	1	98.0000747046
398	110	0	0	0	99.1798908433
398	112	1	0	1	103.638897482
398	113	4	0	4	97.2386887105
398	120	1	0	1	110.239844454
398	142	3	0	3	84.597368981
398	155	1	0	1	98.1248287932
398	158	1	0	1	82.6701717414
398	166	2	0	2	98.0546857252
398	172	1	0	1	83.3708217597
398	177	0	0	0	83.7663491562
398	183	1	0	1	194.993118822
398	307	1	0	1	136.82157315
398	319	4	1	3	89.8369538254
398	338	0	0	0	122.480379504
398	349	1	0	1	109.395770909
398	353	1	0	1	118.251327071
398	379	2	0	2	29.5555627209
398	381	2	0	2	26.3734564842
398	382	31	0	31	8.00475273149
398	383	14	5	9	10.6139719585
398	385	8	0	8	34.3128551364
398	386	2	0	2	32.7269960408
398	387	1	0	1	28.411234952
398	388	1	0	1	22.2870560938
398	389	6	0	6	16.750997935
398	391	1	0	1	35.7798666099
398	392	1	0	1	37.0947020932
398	393	4	0	4	14.7916750924
398	394	2	1	1	24.7644308687
398	395	3	1	2	22.8360540937
398	396	37	3	34	28.6025128557
398	397	2	0	2	31.4256927723
398	399	3	0	3	34.8610098864
398	400	5	1	4	19.2188595747
398	401	46	17	29	14.5988184066
398	402	26	9	17	9.01596658522
398	403	1	1	0	29.5568491404
398	404	43	0	43	12.935666378
398	405	7	1	6	17.5788312165
398	406	86	1	85	25.787834685
398	407	3	2	1	30.7036376333
398	408	623	0	623	20.9160176088
398	409	6	1	5	29.623158895
398	410	15	0	15	23.03671772
398	411	58	1	57	19.6653442429
398	412	6	1	5	19.5795196107
398	413	163	12	151	7.29459327461
398	414	12	0	12	31.3535969862
398	415	30	1	29	27.3003553028
398	416	8	0	8	24.1405289192
398	417	21	0	21	24.0659052288
398	418	5	1	4	17.9086584671
398	419	17	1	16	12.3046362279
398	421	3	1	2	29.0135694034
398	422	1	0	1	28.0082553351
398	424	1	0	1	35.9617398692
398	425	1	0	1	21.267154738
398	426	4	0	4	34.4419059751
398	427	8	0	8	22.2901772126
398	428	3	0	3	20.4406628855
398	430	7	0	7	17.6861546534
398	431	4	1	3	23.8753094935
398	433	8	0	8	24.2595518004
398	435	8	3	5	14.4354211529
398	438	37	7	30	11.8290149378
398	439	4	0	4	18.7314945251
398	440	27	2	25	8.7863119383
398	441	22	6	16	10.0749439769
398	442	67	0	67	18.3759432003
398	443	1	0	1	29.9470617535
398	444	3	0	3	28.4022188456
398	445	4	0	4	17.1445973823
398	447	1	0	1	34.5634146472
398	448	4	0	4	25.7512962654
398	453	2	0	2	31.2042207538
398	455	2	1	1	50.0865555861
398	458	2	0	2	35.9383931314
398	459	2	0	2	28.644147147
398	460	4	0	4	40.415569088
398	466	3	0	3	58.526346779
398	487	1	0	1	85.4003081097
398	488	1	0	1	76.5044393362
398	503	0	0	0	38.7509332563
398	507	2	0	2	87.2688416742
398	512	5	0	5	49.330815538
398	515	1	0	1	35.182648902
398	516	9	1	8	24.1520914783
398	518	2	0	2	33.0288717093
398	520	14	2	12	18.5587906265
398	521	3	0	3	20.6001098217
398	522	1	0	1	28.4700105349
398	523	2	0	2	33.082916874
398	524	8	0	8	37.5167068561
398	528	13	2	11	18.9480189393
398	529	1	0	1	74.5538479835
398	537	1	0	1	53.0887533794
398	540	1	0	1	60.2495716698
398	549	1	0	1	80.5917215946
398	553	1	0	1	76.8506429063
398	562	2	0	2	32.3240097389
398	566	1	0	1	45.6766860596
398	567	1	0	1	51.0433629152
398	571	0	0	0	46.0773336834
398	573	14	0	14	58.6959580619
398	579	1	0	1	72.610568027
398	581	0	0	0	71.0208999865
399	1	5	0	5	102.024408032
399	59	2	0	2	61.1194026174
399	70	3	0	3	92.857667657
399	73	26	0	26	87.5724552327
399	74	4	0	4	85.7722862534
399	75	6	0	6	85.1708325923
399	76	1	0	1	90.5674660769
399	78	3	0	3	86.9096688896
399	82	2	0	2	89.2358969545
399	84	5	0	5	86.6767897905
399	87	1	0	1	83.3300232494
399	96	1	0	1	96.7248326287
399	103	2	0	2	83.311140489
399	110	1	0	1	79.9165451509
399	111	1	0	1	102.514323666
399	112	2	0	2	84.6032705902
399	113	1	0	1	79.8201986653
399	125	2	0	2	63.8419333806
399	140	1	0	1	74.4423877084
399	142	0	0	0	64.838802492
399	155	1	0	1	88.9864873143
399	160	1	0	1	64.8996467344
399	163	1	0	1	52.9246754514
399	168	3	0	3	76.4843828973
399	172	1	0	1	71.7831692789
399	175	1	0	1	81.3848015661
399	177	1	0	1	74.4061968454
399	319	3	0	3	91.4117727872
399	326	1	0	1	101.404660355
399	329	1	0	1	98.0181524417
399	338	1	0	1	120.752529949
399	353	1	0	1	112.997599268
399	355	2	0	2	103.122951226
399	379	6	0	6	31.6545253383
399	381	2	0	2	43.735046582
399	385	6	1	5	39.4957523041
399	386	1	0	1	42.2277686523
399	389	2	0	2	37.1050952036
399	390	1	0	1	27.83350112
399	391	3	0	3	32.2012896741
399	392	1	0	1	37.6597970045
399	393	1	0	1	31.7046724309
399	394	1	0	1	27.9070939266
399	395	1	0	1	36.1416305716
399	396	65	11	54	11.7634140741
399	397	11	0	11	13.5745009937
399	398	2	0	2	34.8610098864
399	400	6	1	5	15.6741368796
399	401	7	0	7	20.5365799821
399	402	1	0	1	31.6386541441
399	403	2	1	1	11.6044815052
399	404	2	1	1	25.516060649
399	405	8	2	6	17.5168251492
399	406	233	134	99	9.36059224747
399	407	53	36	17	7.1692274836
399	408	569	0	569	14.9329225454
399	409	116	65	51	5.41074733402
399	410	7	0	7	15.9573689451
399	411	40	9	31	20.7119237349
399	412	9	4	5	17.0783858736
399	413	5	1	4	27.6865068851
399	414	133	5	128	6.18840524927
399	415	42	18	24	18.6200650943
399	416	14	1	13	12.286752581
399	417	21	3	18	22.2030894575
399	418	4	0	4	26.0926553748
399	419	1	0	1	23.0094225958
399	421	3	0	3	18.4600593736
399	422	1	0	1	36.754670274
399	425	1	0	1	25.1268497555
399	426	1	0	1	40.2303622141
399	427	15	2	13	18.4620979684
399	428	1	0	1	36.2428539875
399	429	3	0	3	29.5903983141
399	433	1	0	1	48.052176804
399	434	1	0	1	21.5978032142
399	435	1	0	1	25.2205968965
399	438	4	0	4	37.3474288348
399	439	1	0	1	45.9454349954
399	441	0	0	0	31.9761941366
399	442	19	0	19	27.0373952034
399	443	1	0	1	49.5630195058
399	444	3	0	3	25.8045067204
399	445	1	0	1	49.4429139882
399	447	2	0	2	24.2738903819
399	448	1	0	1	21.5602771646
399	451	2	0	2	16.2141874058
399	453	1	0	1	18.5065859112
399	455	3	0	3	39.3954517363
399	457	3	0	3	19.0928249532
399	458	3	0	3	20.9269368603
399	459	2	0	2	25.7325777221
399	460	5	0	5	25.4435908839
399	462	1	0	1	29.1453345153
399	465	1	0	1	21.1301802893
399	466	14	0	14	23.841943795
399	469	6	2	4	28.392944021
399	470	1	1	0	35.8680463791
399	471	3	1	2	46.5347795087
399	472	2	0	2	39.3717343246
399	475	6	0	6	29.054839134
399	478	1	1	0	18.7630445511
399	495	5	0	5	13.0151378364
399	499	1	0	1	13.1073288196
399	501	4	0	4	15.0868292006
399	502	12	1	11	4.60162227538
399	503	38	13	25	10.2726114977
399	506	5	0	5	15.1343941461
399	507	1	0	1	121.980910046
399	512	1	0	1	84.0926980556
399	516	1	0	1	57.7956115511
399	524	3	0	3	64.6732575388
399	556	1	0	1	100.33022734
399	566	4	0	4	49.7911244367
399	573	8	4	4	62.1337025336
399	581	1	0	1	67.7270990206
400	70	4	0	4	98.9034992705
400	71	3	0	3	88.4847230081
400	73	35	2	33	94.5083621538
400	74	6	1	5	92.054388222
400	75	4	0	4	92.1159840667
400	76	1	0	1	96.4077101282
400	78	7	0	7	92.9723125192
400	81	1	0	1	97.8459781207
400	82	8	0	8	95.3710345287
400	83	3	0	3	94.3391101699
400	84	7	0	7	93.4464358087
400	85	0	0	0	93.3205770035
400	86	1	0	1	89.0990241668
400	87	4	0	4	89.9512159234
400	90	1	0	1	96.7635726772
400	92	1	0	1	103.558713559
400	103	1	0	1	90.9198139821
400	110	1	0	1	88.0043496217
400	112	3	0	3	92.639390591
400	113	2	0	2	86.9941701597
400	119	1	0	1	91.6575657817
400	141	2	0	2	44.5446776662
400	142	3	0	3	72.9313047431
400	147	2	0	2	54.6369775982
400	154	1	0	1	65.2840181342
400	155	1	0	1	92.2942784891
400	164	1	0	1	85.187667425
400	171	2	0	2	89.1456298096
400	172	1	0	1	75.9348526746
400	176	1	0	1	49.7110121308
400	177	1	0	1	77.533950388
400	183	1	0	1	184.386966778
400	309	1	1	0	116.564833539
400	310	0	0	0	133.246124595
400	319	8	0	8	89.7765721009
400	327	1	0	1	95.4926844377
400	338	1	0	1	121.030855927
400	347	1	0	1	107.207107122
400	373	0	0	0	148.563924501
400	379	3	0	3	26.1055600392
400	381	1	0	1	33.2440275021
400	383	1	0	1	22.5511150526
400	385	7	1	6	33.7014610463
400	386	2	1	1	34.7947172704
400	387	1	0	1	30.7671584649
400	389	2	0	2	24.6802258124
400	390	1	0	1	25.4620306008
400	391	2	0	2	29.8193452033
400	394	10	4	6	20.8220843139
400	396	56	0	56	12.5206606898
400	397	5	1	4	16.2197218783
400	398	3	1	2	19.2188595747
400	399	6	0	6	15.6741368796
400	401	57	0	57	5.58031076733
400	402	1	0	1	17.3103704255
400	404	9	1	8	12.0389309721
400	405	156	95	61	2.16398042156
400	406	191	32	159	7.0534225396
400	407	10	1	9	12.6367794339
400	408	1328	120	1208	5.03146494711
400	409	30	0	30	10.4046456141
400	410	25	1	24	9.55006190713
400	411	77	2	75	11.1808601761
400	412	46	34	12	4.9319699283
400	413	7	1	6	12.1572321582
400	414	31	10	21	12.4623121137
400	415	43	3	40	15.719720652
400	416	51	14	37	6.1143187407
400	417	27	0	27	15.9416096976
400	418	2	1	1	15.439096148
400	419	5	2	3	7.45287738998
400	421	13	0	13	15.5834193654
400	425	6	0	6	15.106614766
400	426	9	0	9	32.8002384972
400	427	62	5	57	9.75715954448
400	428	1	0	1	24.1151459511
400	431	2	1	1	19.5313023913
400	432	2	1	1	25.3474662971
400	433	2	1	1	34.6669022573
400	434	4	1	3	6.7411729727
400	435	3	0	3	11.4243459793
400	436	2	0	2	32.8845486347
400	438	14	0	14	22.6617835586
400	440	2	0	2	26.3352011064
400	441	4	1	3	17.1796323692
400	442	48	0	48	15.2739984058
400	443	2	0	2	37.5767824616
400	444	11	1	10	19.9558398367
400	445	1	0	1	34.0987593298
400	447	3	0	3	22.9640769719
400	448	5	2	3	15.1717384791
400	451	5	0	5	20.7912739391
400	455	1	0	1	41.7110459781
400	458	1	0	1	23.4801491426
400	459	3	0	3	21.5417111991
400	460	3	1	2	28.7678615407
400	465	1	0	1	35.8596643042
400	466	5	0	5	39.4582873566
400	471	1	0	1	61.5524012793
400	475	2	0	2	38.1137820372
400	492	1	0	1	51.2927750302
400	503	2	0	2	21.1467143252
400	507	2	0	2	106.448340935
400	516	0	0	0	42.2796271764
400	517	1	0	1	77.3072669133
400	519	1	0	1	67.7925259906
400	524	4	0	4	51.7775700847
400	528	1	0	1	37.7577134459
400	555	1	0	1	66.0928110388
400	566	3	0	3	45.4774614784
400	573	18	0	18	58.8172361736
400	581	1	0	1	67.7600963443
400	585	1	0	1	84.0462799535
401	1	2	0	2	115.656634702
401	32	1	0	1	113.181261402
401	36	1	0	1	96.9149476151
401	45	1	0	1	71.5590209292
401	48	1	0	1	79.4251204121
401	70	12	0	12	98.3689871858
401	71	2	0	2	87.9794735184
401	72	2	0	2	99.4573808949
401	73	130	0	130	94.3376333941
401	74	7	1	6	91.6515091001
401	75	10	0	10	91.9643161478
401	76	3	0	3	95.8115120074
401	78	16	0	16	92.4810134273
401	79	1	0	1	98.2327119677
401	81	4	0	4	97.4973181225
401	82	10	0	10	94.8913813352
401	83	8	0	8	94.040424498
401	84	18	0	18	93.2189447602
401	85	4	0	4	92.604220258
401	86	3	0	3	88.461594708
401	87	14	0	14	89.6908807668
401	88	3	0	3	88.340343776
401	95	1	0	1	97.2336383161
401	96	1	0	1	99.7954507795
401	97	0	0	0	113.71313945
401	103	3	1	2	91.0327674365
401	109	1	0	1	100.519656336
401	110	0	0	0	88.3257618098
401	113	10	1	9	86.9664000061
401	116	1	0	1	96.2822671497
401	117	0	0	0	86.9669266535
401	134	1	0	1	78.5296004697
401	135	1	0	1	57.7314538566
401	141	2	0	2	44.6937140296
401	142	5	0	5	73.3834452309
401	147	3	0	3	55.0698185801
401	154	2	0	2	64.9621539016
401	156	1	0	1	95.8388101292
401	163	1	0	1	56.9301713808
401	164	1	0	1	84.1934066933
401	166	2	0	2	91.923094211
401	168	3	0	3	79.6642885897
401	171	1	0	1	87.9278170519
401	172	2	0	2	74.8865565817
401	175	1	0	1	83.4440971379
401	177	9	0	9	76.1086494665
401	183	2	0	2	184.657888704
401	211	1	0	1	176.271120925
401	251	0	0	0	117.922228313
401	305	1	0	1	131.491758331
401	319	15	0	15	86.6893837523
401	323	3	0	3	78.0950625737
401	338	3	0	3	118.397951874
401	348	1	0	1	113.64612915
401	350	1	0	1	127.825271056
401	351	1	0	1	108.278428355
401	353	2	0	2	112.703354409
401	358	1	0	1	110.757598026
401	364	1	0	1	97.9529630825
401	375	2	0	2	157.181257013
401	379	2	0	2	22.9803670125
401	381	3	1	2	28.2060768267
401	382	4	1	3	19.4102136503
401	383	1	0	1	16.9721943603
401	385	32	0	32	30.1113272658
401	386	3	1	2	30.6258104149
401	387	2	0	2	26.416790405
401	388	3	1	2	17.9481253964
401	389	2	0	2	19.2985590219
401	390	2	0	2	23.6071158962
401	391	3	0	3	27.6384840377
401	392	4	0	4	30.9926006744
401	393	3	0	3	14.0069073876
401	394	18	7	11	17.5134084194
401	395	2	1	1	21.4789922391
401	396	82	0	82	14.4188657972
401	397	30	1	29	17.6603904268
401	398	25	3	22	14.5988184066
401	399	4	1	3	20.5365799821
401	400	30	2	28	5.58031076733
401	402	5	0	5	11.7317641341
401	404	47	2	45	6.69331088173
401	405	41	16	25	5.16290330475
401	406	208	3	205	11.2750406841
401	407	15	0	15	16.1176028538
401	408	2530	615	1915	6.37655752944
401	409	19	10	9	15.5372566542
401	410	46	12	34	9.44528643446
401	411	199	78	121	8.36972794943
401	412	32	0	32	8.92144774351
401	413	70	4	66	7.30550677805
401	414	22	8	14	17.9548184601
401	415	64	6	58	15.0834134315
401	416	13	2	11	11.6265967625
401	417	42	6	36	13.6992344433
401	418	10	2	8	11.1043453427
401	419	39	1	38	5.41766550867
401	421	2	0	2	20.2581971708
401	425	6	1	5	17.3764727807
401	426	6	0	6	34.8663862568
401	427	27	9	18	13.686901609
401	430	3	0	3	32.2845624796
401	431	3	0	3	21.6728757345
401	433	5	1	4	33.3297084663
401	434	2	2	0	6.95549479906
401	435	5	1	4	11.5812513529
401	438	24	1	23	20.5056752818
401	439	1	0	1	29.3795685645
401	441	13	0	13	15.2393860407
401	442	87	10	77	16.4697480254
401	443	1	0	1	37.1501980566
401	444	9	0	9	23.3995863841
401	445	2	0	2	30.6685975598
401	447	1	0	1	27.4129094325
401	448	2	0	2	18.956916373
401	451	3	0	3	22.0376155939
401	452	1	0	1	23.0011697937
401	453	2	0	2	18.7298808894
401	454	6	0	6	33.3779490493
401	455	3	1	2	40.6555185204
401	457	1	0	1	25.614981678
401	458	1	0	1	23.6699183264
401	459	5	1	4	19.3627584411
401	460	14	7	7	28.7379862619
401	465	0	0	0	39.7313672629
401	469	1	0	1	45.540726939
401	475	3	1	2	39.612942869
401	476	2	0	2	65.901907087
401	495	1	0	1	33.0843554904
401	503	2	0	2	24.2957286049
401	506	1	0	1	22.569734593
401	507	2	0	2	101.453437001
401	509	1	0	1	112.432610982
401	512	7	0	7	63.586882952
401	516	1	0	1	38.4308199107
401	520	6	1	5	26.6309889136
401	523	1	0	1	46.2093079432
401	524	6	0	6	46.2234493155
401	528	2	0	2	32.600765228
401	529	3	0	3	85.4850760782
401	535	1	0	1	82.4850712076
401	536	1	0	1	82.8558272692
401	537	2	0	2	63.8256253134
401	540	1	0	1	72.2472200063
401	554	0	0	0	50.1663162492
401	555	4	1	3	61.3221374052
401	561	3	0	3	57.5818344897
401	566	6	0	6	42.0509192777
401	568	1	0	1	52.2446780777
401	573	49	0	49	55.4839336889
401	575	1	0	1	61.4379538079
401	577	1	0	1	73.2058306606
401	578	2	0	2	45.7751678794
401	579	1	0	1	68.796976318
401	581	3	0	3	65.3897060576
401	585	5	0	5	79.8522436773
402	71	1	0	1	88.4191813137
402	73	14	1	13	95.4009607642
402	74	1	0	1	92.2606646427
402	75	2	0	2	93.0945833638
402	76	1	0	1	95.9654207286
402	78	0	0	0	92.8943591383
402	82	1	0	1	95.3015684934
402	83	1	0	1	94.8400846194
402	84	6	0	6	94.1767021545
402	87	2	0	2	90.6223186861
402	88	0	0	0	89.084574386
402	142	2	0	2	76.0166737421
402	154	1	0	1	66.187650214
402	158	1	0	1	73.6768223259
402	168	2	0	2	79.0382159497
402	169	0	0	0	100.818629312
402	177	1	0	1	74.7508626483
402	183	2	0	2	186.122164929
402	245	1	0	1	118.23250288
402	297	1	0	1	148.376333427
402	319	2	0	2	81.3944026589
402	323	1	0	1	73.652947586
402	341	1	0	1	125.902907374
402	373	1	0	1	142.709115232
402	379	1	0	1	20.5678440914
402	380	1	0	1	35.7770151065
402	381	3	1	2	18.9041062431
402	382	12	4	8	8.77925970812
402	383	19	5	14	5.24078064309
402	385	6	0	6	25.4062700401
402	386	3	1	2	24.1485295532
402	387	2	0	2	19.766197699
402	388	4	0	4	13.2710901554
402	389	5	0	5	9.06700912108
402	393	16	1	15	5.8179527382
402	394	3	0	3	15.9375611602
402	395	5	0	5	14.1610758844
402	396	18	5	13	22.960020251
402	398	68	0	68	9.01596658522
402	399	1	0	1	31.6386541441
402	400	1	0	1	17.3103704255
402	401	34	1	33	11.7317641341
402	404	56	21	35	6.26533603606
402	405	4	0	4	16.5677590825
402	406	26	18	8	22.2893878535
402	407	3	0	3	26.094837928
402	408	358	96	262	16.7146281701
402	409	5	0	5	26.9774116486
402	410	6	2	4	17.1608953314
402	411	60	4	56	12.7801774652
402	412	4	1	3	19.8917445829
402	413	67	0	67	7.40046378428
402	414	3	1	2	29.6374992391
402	415	11	5	6	19.9998030109
402	416	6	2	4	23.2986742895
402	417	13	0	13	16.1386867711
402	418	4	1	3	9.50515618044
402	419	1	0	1	13.1747747775
402	421	2	0	2	30.9636892652
402	425	4	2	2	25.4883895739
402	427	2	0	2	24.0480649753
402	431	1	0	1	29.0678340892
402	432	0	0	0	37.5332376316
402	433	2	0	2	33.1617021713
402	435	2	0	2	18.3555169992
402	437	1	0	1	44.3686218867
402	438	15	0	15	20.3485529927
402	439	2	0	2	27.7368025851
402	440	4	0	4	17.4995706889
402	441	1	0	1	17.1051055282
402	442	14	3	11	23.3096093464
402	444	4	1	3	32.4414372701
402	445	1	0	1	25.6681803045
402	448	1	0	1	28.7260955632
402	450	1	0	1	33.8645879123
402	451	1	0	1	28.5565523466
402	453	1	0	1	23.8291498846
402	457	1	0	1	31.4721565834
402	459	2	0	2	20.0955311608
402	460	2	0	2	32.3340239316
402	503	2	0	2	33.2742323425
402	507	2	0	2	91.0001800634
402	512	1	0	1	53.4211308645
402	516	2	1	1	31.7283427654
402	518	2	0	2	39.8532739806
402	520	10	0	10	14.9469630085
402	521	1	0	1	20.6532005122
402	524	2	1	1	34.6294731009
402	528	3	0	3	22.2256893827
402	554	1	0	1	40.1271387527
402	555	3	0	3	52.0517386551
402	562	1	0	1	27.4357806182
402	571	0	0	0	37.8701854604
402	573	7	7	0	50.1312914525
402	581	0	0	0	62.1132577704
403	1	1	0	1	113.542612558
403	25	1	0	1	110.302074325
403	45	1	0	1	63.2516491988
403	70	1	0	1	103.807379805
403	71	1	0	1	93.4397522961
403	73	17	0	17	98.7263036865
403	74	3	0	3	96.7661076552
403	75	5	0	5	96.3216273897
403	78	3	0	3	97.8498227814
403	79	1	0	1	102.622837822
403	81	3	0	3	102.388994461
403	82	1	0	1	100.200518278
403	83	1	0	1	98.8175196198
403	84	2	0	2	97.7908957142
403	85	1	0	1	98.636715656
403	88	1	0	1	93.3589945955
403	107	1	0	1	86.4744122566
403	112	1	0	1	95.9694524501
403	113	4	0	4	91.0092180769
403	130	1	0	1	65.6805662597
403	142	3	0	3	76.1721867746
403	147	1	0	1	58.36902496
403	163	2	0	2	63.2789782278
403	168	1	0	1	86.8449155014
403	177	6	1	5	84.3622412495
403	319	4	0	4	99.3144922667
403	329	1	0	1	107.269650572
403	353	1	0	1	122.568073324
403	358	1	0	1	126.778575644
403	375	1	0	1	166.135239851
403	379	1	0	1	36.6661617783
403	385	5	0	5	44.5522019784
403	386	1	0	1	46.2489842455
403	387	1	0	1	42.4480361047
403	388	1	0	1	33.9337069121
403	390	1	0	1	34.52955338
403	391	5	1	4	39.0595217003
403	394	3	0	3	31.8074847454
403	396	22	1	21	18.3090351321
403	397	1	0	1	21.6207991918
403	399	15	2	13	11.6044815052
403	400	5	0	5	12.347908586
403	401	5	1	4	17.8287155111
403	402	1	0	1	29.4368266393
403	404	3	2	1	24.3863271965
403	405	9	1	8	12.8744879811
403	406	141	92	49	11.5923071685
403	407	4	0	4	14.9997100368
403	408	432	22	410	15.4516859025
403	409	86	57	29	8.27941157057
403	410	8	0	8	19.1232505035
403	411	36	1	35	22.5433523204
403	412	15	3	12	10.0034365448
403	413	3	0	3	23.3509664972
403	414	271	6	265	5.43146287336
403	415	17	2	15	24.3486254923
403	416	46	12	34	6.23441382458
403	417	8	1	7	26.2929639593
403	419	1	0	1	17.3638479322
403	421	52	0	52	6.8820293381
403	422	3	0	3	25.3139340209
403	423	1	0	1	53.3132559591
403	425	6	2	4	14.4004752832
403	426	14	2	12	28.6259045201
403	427	56	3	53	8.434147484
403	428	1	0	1	25.705699929
403	429	4	0	4	18.6339430011
403	431	3	0	3	17.4859670634
403	432	5	0	5	18.4970910531
403	433	3	0	3	37.867910438
403	435	4	0	4	16.7373372227
403	436	1	0	1	26.486339835
403	438	7	4	3	28.7005983387
403	441	3	0	3	23.8087504599
403	442	55	0	55	16.9108978695
403	444	16	1	15	14.2011916749
403	445	1	0	1	41.4649009018
403	447	11	0	11	13.4004729276
403	448	8	5	3	10.1163665854
403	449	1	0	1	39.1983757715
403	451	1	0	1	25.5380660658
403	453	2	0	2	25.9281943284
403	460	1	0	1	34.7913657933
403	461	1	0	1	53.0330417428
403	466	1	0	1	33.0937579593
403	469	2	0	2	39.6577190419
403	471	1	0	1	56.7101322821
403	475	1	0	1	40.3638979641
403	476	1	0	1	60.994162002
403	482	1	0	1	47.6696899978
403	495	0	0	0	23.1168588597
403	501	3	0	3	21.4417813293
403	503	2	0	2	21.4965508982
403	506	13	7	6	5.25363526073
403	509	0	0	0	127.46071927
403	516	1	0	1	50.1423923195
403	524	2	0	2	64.033124121
403	535	0	0	0	99.4593681051
403	536	0	0	0	100.644976899
403	554	0	0	0	67.4325137118
403	573	15	1	14	68.9608576636
403	581	1	0	1	76.3355254365
404	70	3	0	3	95.5789226168
404	71	3	0	3	85.2657441974
404	73	56	2	54	91.9732999256
404	74	3	0	3	89.0360640222
404	75	6	4	2	89.6320438293
404	76	1	0	1	92.9625784544
404	78	5	0	5	89.7627180016
404	79	1	0	1	95.8368235596
404	80	1	0	1	94.8672812623
404	81	6	1	5	94.9187348558
404	82	5	0	5	92.1761031733
404	83	3	0	3	91.5322237242
404	84	11	0	11	90.7948973964
404	85	5	0	5	89.6349537017
404	86	2	0	2	85.5979318358
404	87	5	0	5	87.2454077908
404	88	1	0	1	85.7905937508
404	95	2	0	2	95.3603793427
404	103	3	0	3	89.008501657
404	104	1	0	1	99.9891247336
404	112	1	0	1	91.0581801788
404	113	2	0	2	84.7998137295
404	118	1	0	1	89.9936770353
404	120	1	0	1	97.8628024615
404	140	1	0	1	80.5929865618
404	142	1	0	1	71.8597678419
404	147	1	0	1	53.7059446601
404	154	1	0	1	62.6069528692
404	155	1	0	1	87.0240972364
404	163	1	0	1	54.3063579939
404	168	3	0	3	76.3760294008
404	172	2	0	2	71.6402839869
404	177	8	0	8	72.4455165506
404	183	1	0	1	182.600543792
404	319	11	0	11	81.3255760168
404	323	2	0	2	73.0502285047
404	329	1	0	1	92.3145070004
404	338	2	0	2	113.391034484
404	349	1	0	1	100.164444543
404	373	0	0	0	141.748950212
404	379	9	0	9	18.2699650479
404	381	1	0	1	21.5498145997
404	382	1	0	1	14.9632942314
404	383	8	0	8	11.1946282206
404	384	1	0	1	32.7753570937
404	385	27	1	26	24.6440586111
404	386	1	0	1	24.5749614073
404	387	2	1	1	20.2509506753
404	388	2	0	2	12.1008319018
404	389	13	4	9	12.646537322
404	390	1	0	1	20.4400155422
404	391	3	0	3	23.860264074
404	392	1	0	1	26.2686693155
404	393	6	1	5	7.31363975444
404	394	13	2	11	12.9283321931
404	395	6	1	5	15.0518630757
404	396	62	12	50	16.7411631937
404	397	15	2	13	19.0375867189
404	398	34	1	33	12.935666378
404	399	4	1	3	25.516060649
404	400	12	0	12	12.0389309721
404	401	82	4	78	6.69331088173
404	402	27	3	24	6.26533603606
404	405	13	5	8	11.8561801893
404	406	110	3	107	16.212695702
404	407	5	0	5	19.8340866675
404	408	1502	158	1344	10.5916260494
404	409	11	4	7	21.0405011857
404	410	35	6	29	10.9421114453
404	411	228	5	223	6.85104390391
404	412	22	16	6	15.5841153387
404	413	61	1	60	7.18974822473
404	414	16	0	16	23.9415941549
404	415	36	2	34	14.4179715348
404	416	8	0	8	18.153246284
404	417	46	13	33	11.17770008
404	418	20	12	8	5.76276856414
404	419	10	1	9	10.3603563863
404	425	2	0	2	23.1932152192
404	426	7	0	7	40.1319026473
404	427	9	0	9	20.2526800698
404	429	1	0	1	37.8000644343
404	431	3	0	3	27.2670182763
404	433	3	0	3	35.4716719155
404	434	1	0	1	12.7670514633
404	435	1	0	1	16.5729174489
404	438	15	2	13	22.3151351132
404	439	1	0	1	30.6557669435
404	440	3	1	2	21.7021016631
404	441	12	0	12	17.8514921294
404	442	42	9	33	21.7005615036
404	444	6	0	6	29.6486603651
404	445	1	0	1	30.0719872053
404	447	1	0	1	34.0087604856
404	448	1	0	1	25.4017535062
404	451	2	0	2	22.7572942924
404	454	1	0	1	31.0396701722
404	455	2	0	2	37.7997418511
404	457	3	0	3	25.8869453131
404	459	4	0	4	16.1171361011
404	460	13	2	11	27.503169916
404	466	1	0	1	48.0651972694
404	469	1	0	1	47.900244677
404	475	3	0	3	39.8243554743
404	485	0	0	0	62.0529763126
404	503	3	0	3	27.0663297423
404	506	1	0	1	29.2237119062
404	507	1	0	1	97.2595134573
404	512	3	0	3	59.6456901987
404	515	2	0	2	46.0329546863
404	516	2	0	2	36.9008153852
404	518	2	0	2	45.4269401702
404	520	2	0	2	20.4901763056
404	521	1	0	1	26.8216403739
404	523	2	0	2	41.3677974387
404	524	6	0	6	39.857356429
404	534	2	0	2	66.528527043
404	535	1	0	1	76.9688436155
404	537	1	0	1	57.7951515078
404	548	0	0	0	107.488233234
404	554	0	0	0	43.485333695
404	555	1	0	1	54.743715162
404	557	1	0	1	37.7191213737
404	561	2	0	2	50.9640844451
404	566	6	0	6	36.5845806179
404	571	0	0	0	38.672307785
404	573	26	7	19	50.0076897332
404	581	0	0	0	60.7985681812
404	585	2	0	2	73.5998151065
405	0	1	0	1	107.922855596
405	1	1	0	1	116.005662211
405	45	1	0	1	69.9204122443
405	48	1	0	1	78.5324522734
405	70	2	0	2	100.794119054
405	71	1	0	1	90.3780000803
405	73	42	0	42	96.4620070047
405	74	2	0	2	93.9674027389
405	75	8	0	8	94.072176885
405	76	2	0	2	98.286029674
405	78	8	0	8	94.8694590558
405	81	2	0	2	99.7700899494
405	82	6	0	6	97.2709627422
405	83	2	0	2	96.2710858133
405	84	8	0	8	95.3903487703
405	85	2	0	2	95.1746149459
405	86	1	0	1	90.967343173
405	87	1	0	1	91.8886387911
405	88	3	0	3	90.6184649875
405	90	1	0	1	98.556854332
405	92	1	0	1	105.466373912
405	96	1	0	1	102.745119333
405	113	5	0	5	88.9689035607
405	119	1	0	1	93.4515034604
405	120	1	0	1	102.105361862
405	142	4	0	4	74.9704203636
405	146	1	0	1	84.8276776958
405	147	2	0	2	56.6655091684
405	154	1	0	1	67.2013112318
405	155	1	0	1	93.9771027274
405	168	2	0	2	82.5031631483
405	169	1	0	1	105.64814943
405	172	2	1	1	77.7129360657
405	177	3	0	3	79.2248626177
405	183	1	0	1	186.416886987
405	211	0	0	0	179.27171924
405	220	1	0	1	204.363470153
405	319	9	0	9	90.9609759447
405	323	2	0	2	82.1624979097
405	338	0	0	0	122.38586533
405	375	1	0	1	160.628710564
405	379	7	0	7	27.2012278014
405	385	10	0	10	34.6351998605
405	386	1	0	1	35.4594710988
405	388	2	0	2	22.7866572611
405	389	1	0	1	24.4432036858
405	390	1	0	1	26.9641979312
405	391	4	0	4	31.2447088225
405	392	3	0	3	35.0913805615
405	394	10	1	9	21.8204806164
405	395	3	0	3	26.5313373725
405	396	48	0	48	14.6291074973
405	397	11	2	9	18.3029473349
405	398	6	1	5	17.5788312165
405	399	5	0	5	17.5168251492
405	400	81	1	80	2.16398042156
405	401	111	103	8	5.16290330475
405	402	2	0	2	16.5677590825
405	403	2	0	2	12.8744879811
405	404	11	1	10	11.8561801893
405	406	210	88	122	9.17043252941
405	407	10	2	8	14.7871382021
405	408	1434	880	554	6.85612862333
405	409	23	2	21	12.1597747676
405	410	21	9	12	11.2851636644
405	411	128	1	127	12.2240104251
405	412	134	88	46	3.84824328607
405	413	26	8	18	10.7497068915
405	414	28	3	25	13.8049595105
405	415	50	1	49	17.452130877
405	416	63	0	63	6.82861174216
405	417	28	10	18	17.2574441765
405	418	4	2	2	15.9451229056
405	419	17	1	16	5.49263166366
405	421	8	0	8	15.1293467478
405	422	3	1	2	25.7185783978
405	424	4	2	2	40.7349525984
405	425	13	4	9	13.4400839901
405	426	9	4	5	31.1627899287
405	427	94	6	88	8.74620522636
405	429	2	1	1	26.4971925167
405	431	4	0	4	17.8629729141
405	432	1	0	1	24.1906751118
405	433	4	1	3	32.5083118028
405	434	5	3	2	4.57723339581
405	435	10	5	5	9.29953746704
405	436	1	0	1	31.5437130882
405	438	24	1	23	20.5161770986
405	439	1	0	1	29.3906825029
405	440	2	0	2	24.3983712045
405	441	7	0	7	15.0344363886
405	442	103	1	102	13.3368705223
405	443	1	0	1	35.4777388565
405	444	19	0	19	18.7771211818
405	445	1	0	1	32.0659846396
405	447	4	0	4	22.3590638218
405	448	12	7	5	14.1338756656
405	451	2	0	2	22.8713772128
405	454	1	0	1	35.9580422465
405	455	1	0	1	43.4587814143
405	457	1	0	1	26.6046506903
405	459	4	0	4	22.9284066215
405	460	6	2	4	30.6923450072
405	466	2	1	1	41.3498274076
405	469	4	0	4	44.35404564
405	471	1	0	1	63.5996058798
405	475	3	0	3	40.2419609657
405	495	1	0	1	30.476610426
405	496	1	1	0	32.0747154837
405	502	1	0	1	22.1170668918
405	503	4	0	4	23.2998946973
405	506	1	0	1	17.4617754329
405	507	2	0	2	104.847398649
405	512	2	0	2	66.9077810975
405	520	1	0	1	31.5143874311
405	524	6	1	5	51.1845037639
405	528	1	0	1	36.3137497945
405	534	1	0	1	77.6198929535
405	536	1	0	1	87.7797852803
405	537	1	0	1	68.5517001725
405	540	2	0	2	76.7022261178
405	551	0	0	0	70.1119435253
405	554	1	0	1	55.322968877
405	555	2	0	2	66.4160659488
405	566	3	0	3	46.4992460585
405	568	1	0	1	55.865835706
405	569	1	1	0	68.6332024702
405	573	30	4	26	59.889829042
405	579	2	0	2	73.0024468609
405	585	2	0	2	84.7291050235
406	1	2	0	2	107.178798803
406	7	1	0	1	97.7841887723
406	34	1	0	1	74.9402123977
406	36	1	0	1	89.9050471119
406	45	2	0	2	60.8188828459
406	50	1	0	1	76.5608536234
406	70	4	0	4	93.8750404674
406	71	4	1	3	83.4618266241
406	73	98	1	97	89.1715151317
406	74	11	0	11	86.9271845739
406	75	14	0	14	86.7696701886
406	76	4	0	4	91.4430220008
406	78	6	0	6	87.9219302578
406	79	1	0	1	93.0818534935
406	81	7	0	7	92.6539698249
406	82	14	0	14	90.3028322679
406	83	5	0	5	89.1130317608
406	84	14	0	14	88.1611558874
406	85	9	0	9	88.4780035117
406	86	2	0	2	84.1964079485
406	87	6	0	6	84.7048463959
406	88	2	0	2	83.5420200983
406	96	1	0	1	96.5990583646
406	99	1	0	1	78.9833179236
406	103	8	0	8	85.3582220908
406	110	2	0	2	82.2868884595
406	112	4	0	4	86.9496945013
406	113	17	7	10	81.5591118588
406	117	2	0	2	81.9222899455
406	131	1	0	1	51.8856543378
406	141	2	1	1	39.2297596488
406	142	5	0	5	67.1626972823
406	147	1	0	1	48.9819986681
406	154	3	0	3	60.2028846158
406	155	2	0	2	88.2331112751
406	163	4	0	4	52.8253185942
406	166	1	0	1	90.3837688279
406	167	1	0	1	57.8339637629
406	168	4	0	4	76.2734293625
406	172	5	1	4	71.4931541206
406	173	1	0	1	70.1104241941
406	174	1	0	1	44.5586975529
406	175	1	0	1	80.6859315865
406	176	1	0	1	45.3425382176
406	177	5	0	5	73.4814194435
406	180	1	0	1	64.3589731692
406	183	2	0	2	178.586612477
406	187	1	0	1	181.261103263
406	270	1	0	1	138.542019768
406	305	1	0	1	125.006276907
406	319	15	1	14	87.7404457578
406	323	8	0	8	78.4353574046
406	324	1	0	1	95.7884166138
406	338	0	0	0	118.256283643
406	343	0	0	0	138.053060147
406	379	6	0	6	25.2509838313
406	380	2	0	2	37.4259678736
406	381	1	0	1	35.4630976832
406	382	3	0	3	30.5161940003
406	385	15	3	12	33.1801433593
406	386	1	0	1	35.1946708748
406	387	3	0	3	31.633871559
406	388	5	0	5	23.3394440851
406	389	2	0	2	28.1396148979
406	390	4	2	2	22.9408084298
406	391	12	0	12	27.4699471866
406	392	3	0	3	32.3271736363
406	394	12	5	7	20.6456782599
406	396	227	55	172	7.08465582516
406	397	47	12	35	10.7430072943
406	398	3	1	2	25.787834685
406	399	29	2	27	9.36059224747
406	400	18	13	5	7.0534225396
406	401	47	1	46	11.2750406841
406	402	1	0	1	22.2893878535
406	403	6	0	6	11.5923071685
406	404	15	5	10	16.212695702
406	405	40	3	37	9.17043252941
406	407	74	0	74	5.69138472357
406	408	3105	29	3076	5.62729508682
406	409	169	1	168	5.0514765847
406	410	57	0	57	7.86866668827
406	411	219	99	120	12.0946895732
406	412	26	0	26	10.3331491982
406	413	31	7	24	18.5298609078
406	414	105	56	49	8.60166419843
406	415	183	30	153	12.7563224381
406	416	79	43	36	7.25388815102
406	417	82	3	79	14.9723815988
406	418	8	1	7	17.4172751583
406	419	7	2	5	14.4743881122
406	421	11	5	6	17.3693167755
406	422	2	0	2	32.7938459486
406	425	12	0	12	20.327853919
406	426	16	0	16	37.4504659519
406	427	45	1	44	13.855091739
406	429	1	0	1	29.6451219929
406	431	1	0	1	24.5771534375
406	432	2	0	2	28.6163751082
406	433	7	0	7	41.4457463042
406	435	3	0	3	18.1124832987
406	437	2	1	1	57.2398534194
406	438	18	0	18	29.6800254897
406	439	3	0	3	38.5366453387
406	440	1	0	1	33.2717239057
406	441	2	0	2	24.1999227985
406	442	61	1	60	21.2657314125
406	443	2	0	2	43.9624797461
406	444	12	2	10	23.5242413147
406	445	2	0	2	41.1226666888
406	447	1	0	1	24.6245579521
406	448	1	1	0	18.6647715422
406	450	2	1	1	33.0627955862
406	451	9	2	7	15.1403951205
406	453	4	0	4	14.5442347482
406	454	2	0	2	29.9876866741
406	455	7	1	6	37.6373929902
406	457	7	2	5	18.849834475
406	458	4	0	4	18.7197316789
406	459	3	0	3	19.7514937992
406	460	39	0	39	23.9793514725
406	466	14	1	13	32.7422003742
406	467	2	0	2	31.4105705407
406	469	6	1	5	35.1836324721
406	475	7	3	4	31.8233454308
406	476	1	0	1	56.0888011715
406	478	1	0	1	28.0477956032
406	487	1	0	1	59.6137492883
406	491	1	0	1	42.8139013885
406	495	2	0	2	21.8254282324
406	499	3	0	3	20.5054571429
406	502	5	0	5	13.8225165699
406	503	18	0	18	14.1871628976
406	504	1	0	1	26.8042313802
406	506	4	0	4	16.7994668589
406	507	2	0	2	112.712211734
406	509	1	0	1	123.676126846
406	511	1	0	1	119.531188217
406	512	1	0	1	74.8586064273
406	516	1	0	1	49.2328177911
406	517	1	0	1	83.097806281
406	520	1	0	1	36.6392814728
406	521	0	0	0	42.9422351651
406	524	8	0	8	55.7119793969
406	525	1	0	1	63.0853063061
406	527	1	0	1	65.2231025128
406	537	1	0	1	73.9239092746
406	540	0	0	0	82.8181902753
406	541	1	0	1	108.003048096
406	544	1	0	1	120.27553019
406	548	0	0	0	123.505524051
406	554	1	0	1	57.2116668729
406	555	1	0	1	67.1968609396
406	562	1	0	1	47.0859482889
406	563	1	0	1	61.5495927644
406	566	9	0	9	44.3864195652
406	568	2	0	2	51.3642192991
406	569	1	0	1	66.0750260241
406	573	37	2	35	57.3803786614
406	578	1	0	1	45.9488869008
406	579	1	0	1	69.73041667
406	581	5	0	5	64.8929548969
406	585	3	0	3	83.845877636
407	1	1	0	1	101.50645883
407	34	1	0	1	69.2809042809
407	59	1	0	1	63.8946194759
407	70	7	1	6	89.0448582376
407	73	46	1	45	84.153333274
407	74	9	0	9	82.0439052826
407	75	4	0	4	81.7487425961
407	76	1	0	1	86.6575144583
407	78	10	0	10	83.086440822
407	82	5	0	5	85.4522605531
407	83	1	0	1	84.1639098722
407	84	5	0	5	83.1762716678
407	86	3	0	3	79.4637852204
407	87	3	0	3	79.7492597488
407	92	1	0	1	93.5465570034
407	96	1	0	1	92.186103963
407	99	1	0	1	73.6503859035
407	103	2	0	2	80.2083633759
407	110	2	1	1	77.049138015
407	113	5	0	5	76.4906128834
407	120	1	0	1	89.5607929177
407	136	2	0	2	57.472424157
407	142	2	0	2	61.9147755459
407	146	1	0	1	72.8375301916
407	154	1	0	1	55.4119632538
407	155	1	0	1	84.0676639497
407	163	2	0	2	48.3124235808
407	168	4	0	4	71.8652911696
407	171	1	0	1	80.4725126046
407	172	2	0	2	67.1074104546
407	177	1	0	1	69.36610621
407	277	1	0	1	133.818041035
407	284	1	0	1	138.631758101
407	319	3	0	3	85.0730218911
407	323	1	0	1	75.5060008912
407	332	1	0	1	127.476825892
407	338	0	0	0	114.952190658
407	349	0	0	0	101.732862085
407	368	1	0	1	112.990269245
407	375	2	0	2	151.137506583
407	379	5	0	5	24.4971187611
407	380	1	0	1	34.7880357263
407	383	1	0	1	30.9265541758
407	385	11	2	9	32.3589657364
407	386	1	0	1	35.0588585999
407	388	1	0	1	24.3121656117
407	391	3	0	3	25.3340474036
407	392	3	0	3	30.6766924371
407	394	3	1	2	20.7717578046
407	396	133	45	88	4.59456131425
407	397	18	10	8	6.87824533357
407	398	1	0	1	30.7036376333
407	399	35	6	29	7.1692274836
407	400	5	0	5	12.6367794339
407	401	22	5	17	16.1176028538
407	403	1	0	1	14.9997100368
407	404	2	0	2	19.8340866675
407	405	7	3	4	14.7871382021
407	406	258	68	190	5.69138472357
407	408	1032	690	342	9.79991353652
407	409	28	10	18	6.738400869
407	410	32	1	31	9.35123991072
407	411	74	0	74	14.1981815534
407	412	5	0	5	15.969797519
407	413	3	0	3	23.4104358846
407	414	40	0	40	10.3088533665
407	415	69	1	68	11.454414078
407	416	17	2	15	12.336221387
407	417	24	0	24	15.1003648286
407	418	2	0	2	19.4873341409
407	421	2	0	2	21.5555930986
407	422	1	0	1	38.1217079254
407	425	2	1	1	25.7488459537
407	426	1	0	1	42.4946835318
407	427	8	0	8	19.1202786175
407	431	2	0	2	29.8918008814
407	433	5	0	5	47.1370181114
407	434	1	0	1	19.3427717829
407	435	2	0	2	23.8037340496
407	437	1	0	1	62.8772465042
407	438	1	0	1	35.2985362841
407	441	2	0	2	29.8163997027
407	442	14	2	12	26.8685256747
407	444	3	0	3	28.2851204062
407	447	1	0	1	28.4001551124
407	448	1	0	1	23.5382085039
407	449	1	0	1	24.1990760279
407	451	6	0	6	10.5385376269
407	453	1	0	1	11.6556095158
407	454	2	0	2	26.1872427844
407	455	3	0	3	33.7739303661
407	457	4	0	4	14.0342935227
407	458	4	1	3	14.8242213712
407	459	2	0	2	18.5913882065
407	460	18	5	13	19.8173603976
407	462	0	0	0	22.7723694207
407	465	2	0	2	23.6137790317
407	466	6	1	5	28.2433691311
407	469	4	0	4	29.6391282379
407	475	3	2	1	26.3555136752
407	491	1	0	1	37.9668650874
407	495	2	0	2	17.4609067175
407	497	1	0	1	17.0376308484
407	501	3	0	3	21.6084552271
407	502	4	0	4	10.5230779259
407	503	17	14	3	8.51423182633
407	506	1	0	1	19.7561596793
407	512	1	0	1	79.3082198685
407	520	1	0	1	39.6583662712
407	521	0	0	0	46.5862404049
407	523	1	0	1	61.1998494731
407	524	2	1	1	58.0801132981
407	536	1	0	1	94.4143638583
407	537	1	0	1	76.6734321257
407	554	0	0	0	57.946398442
407	555	3	0	3	67.1371922747
407	563	0	0	0	60.9572925335
407	566	2	0	2	42.829733739
407	567	1	0	1	54.3905020693
407	571	0	0	0	47.6769254697
407	573	19	5	14	55.3723878844
407	579	1	0	1	67.1338484957
407	581	1	0	1	61.7039015166
407	585	1	0	1	82.6305168445
408	0	1	0	1	101.384707519
408	1	24	2	22	109.709395067
408	2	1	0	1	95.9026550714
408	3	1	0	1	99.7190073114
408	13	3	0	3	97.2577432904
408	18	1	0	1	96.8485816473
408	32	2	0	2	107.73916286
408	34	1	0	1	77.4086790427
408	36	5	0	5	91.4540741076
408	41	1	0	1	88.1654516592
408	42	1	0	1	97.8249709868
408	45	1	0	1	65.189180661
408	48	1	0	1	73.0887129921
408	49	3	0	3	85.3198246479
408	50	1	0	1	79.7791481323
408	53	1	0	1	106.922995009
408	54	3	0	3	72.6869379531
408	55	1	0	1	81.7935362221
408	56	1	0	1	87.3158014387
408	59	2	0	2	73.635520275
408	60	1	0	1	77.076746524
408	65	1	0	1	89.9163998632
408	70	74	3	71	93.9406286865
408	71	25	2	23	83.52394988
408	72	3	0	3	94.8500754229
408	73	1056	0	1056	89.6107535773
408	74	80	0	80	87.1113637622
408	75	100	5	95	87.2217262206
408	76	26	0	26	91.4352497445
408	77	1	0	1	94.0915024403
408	78	122	5	117	88.0148502774
408	79	9	0	9	93.5178196199
408	80	4	1	3	92.7571277814
408	81	68	1	67	92.914082624
408	82	72	4	68	90.4159980838
408	83	55	0	55	89.4156647333
408	84	150	0	150	88.536748527
408	85	28	0	28	88.3317230979
408	86	23	0	23	84.1193305039
408	87	68	2	66	85.0339404133
408	88	19	0	19	83.7623547185
408	89	2	0	2	101.462009858
408	90	1	0	1	91.7467121668
408	92	4	4	0	98.6106678325
408	95	4	0	4	92.1787352768
408	96	2	0	2	95.9649345919
408	98	4	0	4	81.5614818402
408	99	1	0	1	80.1753133043
408	102	2	0	2	101.487500028
408	103	29	0	29	86.0878064601
408	104	1	0	1	96.820287278
408	106	1	0	1	105.70622778
408	107	1	0	1	76.1043576138
408	109	2	0	2	96.345367901
408	110	6	0	6	83.2287068255
408	112	25	1	24	87.8506443238
408	113	89	26	63	82.1260216676
408	116	2	0	2	92.0289480369
408	118	3	1	2	89.0008039188
408	119	3	0	3	86.6408296827
408	120	3	0	3	95.2631057742
408	128	1	0	1	62.005284495
408	130	1	0	1	57.2938751512
408	131	5	0	5	55.0673142157
408	135	2	1	1	52.9097963551
408	140	1	0	1	77.3937069576
408	141	9	0	9	39.6880868704
408	142	45	1	44	68.1876184262
408	146	8	1	7	77.9717635072
408	147	7	1	6	49.8722373805
408	151	2	0	2	59.7439444972
408	154	6	0	6	60.3451904471
408	155	14	0	14	87.2632462953
408	156	1	0	1	92.2696572276
408	158	1	0	1	72.5278051079
408	160	2	0	2	64.8960118336
408	161	1	0	1	57.5208913335
408	163	12	1	11	52.568927159
408	164	10	1	9	80.1707051018
408	165	3	0	3	68.2276114519
408	166	10	0	10	88.8920990588
408	167	1	0	1	56.4916704687
408	168	33	0	33	75.7040756424
408	169	3	0	3	98.9174178045
408	170	1	0	1	75.4869724475
408	171	8	0	8	84.1173324156
408	172	28	1	27	70.9130595388
408	173	1	0	1	68.4245347924
408	175	1	1	0	79.7928555271
408	176	3	0	3	44.6921114425
408	177	63	10	53	72.5026624246
408	178	1	0	1	49.7652996548
408	180	1	0	1	63.0158222104
408	183	6	0	6	179.615607912
408	187	1	0	1	181.629179063
408	190	2	0	2	177.555254761
408	208	0	0	0	164.864645375
408	211	1	0	1	172.492463695
408	222	0	0	0	191.356502773
408	229	1	0	1	176.065307845
408	236	1	0	1	161.91714259
408	251	1	0	1	113.708210569
408	277	9	0	9	139.89552731
408	279	1	0	1	132.483796349
408	284	1	0	1	143.86238556
408	310	1	0	1	128.222214358
408	312	1	0	1	135.602315567
408	317	1	0	1	140.415294951
408	319	139	2	137	85.0274685219
408	320	5	0	5	79.931563768
408	323	19	1	18	76.0215761322
408	324	3	0	3	93.1298071074
408	325	3	0	3	81.5767253461
408	326	2	0	2	96.7735864709
408	328	1	0	1	86.418102627
408	329	11	0	11	94.2022591407
408	330	1	0	1	76.0122597707
408	332	2	0	2	128.658243726
408	333	1	0	1	130.427773801
408	334	1	0	1	123.504447897
408	336	1	1	0	119.8963327
408	338	14	0	14	116.133592586
408	339	1	0	1	124.321208521
408	347	1	0	1	102.191729479
408	349	4	0	4	102.854351665
408	354	1	0	1	99.9183578875
408	357	2	0	2	102.98159691
408	358	1	0	1	111.362811885
408	364	1	0	1	96.8179957193
408	366	1	0	1	89.8997009447
408	367	1	0	1	97.3963176464
408	369	1	0	1	150.260559876
408	373	1	0	1	143.580290112
408	375	3	0	3	154.009888568
408	379	61	18	43	21.5624057497
408	380	5	0	5	35.0909085031
408	381	10	0	10	30.2820355763
408	382	10	0	10	25.0792584475
408	383	6	1	5	21.7776517451
408	385	231	5	226	29.3279787606
408	386	12	0	12	30.8174342462
408	387	10	6	4	26.9972200044
408	388	27	1	26	18.4992932685
408	389	12	0	12	22.6010725636
408	390	11	3	8	20.5097360385
408	391	47	1	46	24.9133990423
408	392	25	0	25	29.1761038818
408	393	6	2	4	17.1234946084
408	394	124	12	112	16.4725728045
408	395	19	1	18	22.9055809328
408	396	992	119	873	8.21528097672
408	397	181	0	181	11.7045395301
408	398	102	11	91	20.9160176088
408	399	63	5	58	14.9329225454
408	400	150	72	78	5.03146494711
408	401	562	14	548	6.37655752944
408	402	17	0	17	16.7146281701
408	403	16	1	15	15.4516859025
408	404	142	63	79	10.5916260494
408	405	251	35	216	6.85612862333
408	406	2063	2018	45	5.62729508682
408	407	155	66	89	9.79991353652
408	409	260	14	246	10.5563698353
408	410	389	213	176	4.52368470433
408	411	1484	572	912	7.09504085037
408	412	172	6	166	9.92804562669
408	413	153	9	144	13.6288500739
408	414	307	72	235	13.7690871996
408	415	796	51	745	10.6885092447
408	416	260	53	207	9.60534802498
408	417	424	6	418	11.2244017176
408	418	63	18	45	12.1530768703
408	419	58	3	55	10.8840009436
408	420	4	0	4	52.5573924192
408	421	23	2	21	19.9023988149
408	422	2	0	2	32.5235448594
408	423	2	0	2	57.4948522483
408	424	7	2	5	47.5284819746
408	425	48	12	36	20.1364111216
408	426	89	12	77	37.8311260903
408	427	161	30	131	14.630205965
408	428	4	0	4	28.8329885149
408	429	5	0	5	31.9718737701
408	430	9	0	9	38.5946787182
408	431	15	1	14	24.5619610873
408	432	8	0	8	30.1960029243
408	433	44	2	42	38.9078625379
408	434	6	1	5	11.1335461836
408	435	38	4	34	16.0177367387
408	436	9	1	8	37.8271906808
408	437	3	0	3	53.9388461035
408	438	102	7	95	26.4196325299
408	439	7	0	7	35.3413828995
408	440	9	0	9	28.8925026489
408	441	32	0	32	21.0042400524
408	442	427	26	401	20.1920128845
408	443	4	0	4	42.1911617188
408	444	79	0	79	24.8368112633
408	445	7	1	6	37.0073612094
408	447	6	1	5	27.3411135452
408	448	14	0	14	19.9953106791
408	449	1	0	1	28.461818789
408	450	8	0	8	31.1741736558
408	451	46	0	46	16.2290852452
408	452	4	2	2	18.7678838588
408	453	32	10	22	13.7517727354
408	454	18	1	17	29.1456842624
408	455	35	0	35	36.681933025
408	456	2	0	2	40.9104770418
408	457	17	0	17	19.9241823952
408	458	15	0	15	18.576322212
408	459	52	17	35	16.6954326515
408	460	122	0	122	23.8375698487
408	462	2	0	2	24.5725020139
408	464	1	0	1	54.2717496384
408	466	56	1	55	37.9009428157
408	469	22	1	21	39.1666921674
408	470	3	1	2	44.6872983458
408	471	11	2	9	59.0308838932
408	472	2	1	1	49.5321865583
408	473	4	0	4	38.6710036408
408	474	1	0	1	45.4517612424
408	475	47	1	46	33.750119383
408	477	1	0	1	42.7739074121
408	478	1	0	1	33.4907772392
408	486	1	0	1	67.0365129043
408	487	2	0	2	64.7163599464
408	488	1	0	1	55.9691903413
408	490	1	0	1	58.8925769423
408	491	4	0	4	47.7482167328
408	493	2	1	1	45.7629069821
408	494	1	0	1	34.6015678424
408	495	8	0	8	27.0238960828
408	496	3	0	3	26.0550625236
408	499	8	0	8	25.1309229248
408	500	1	0	1	27.8208303656
408	501	3	0	3	30.0023606829
408	502	14	0	14	19.2979815644
408	503	46	18	28	17.9200089911
408	504	2	0	2	30.051777376
408	505	5	1	4	37.9837117459
408	506	8	2	6	20.6631121614
408	507	25	2	23	107.390496443
408	510	1	0	1	91.7868961938
408	511	2	0	2	114.215756712
408	512	19	0	19	69.6022701659
408	513	1	0	1	63.374003275
408	514	2	0	2	84.3019810243
408	515	3	0	3	55.7130955265
408	516	11	0	11	44.807366201
408	517	1	0	1	77.5942407219
408	518	4	1	3	53.8977117075
408	520	15	3	12	31.0146257266
408	521	9	0	9	37.3632076761
408	522	2	0	2	42.042144632
408	523	6	1	5	51.7776192243
408	524	79	13	66	50.1455296291
408	527	1	0	1	59.6132222989
408	528	12	0	12	38.476340652
408	529	3	0	3	89.9132773501
408	530	3	1	2	98.6973502061
408	534	2	0	2	76.9009029587
408	535	3	0	3	87.559020567
408	536	6	0	6	86.7569211438
408	537	6	0	6	68.3048330799
408	539	1	0	1	72.5486356441
408	540	12	1	11	77.1964867108
408	541	0	0	0	102.386171895
408	543	1	0	1	105.216973416
408	547	1	0	1	105.499434027
408	548	2	0	2	117.976550105
408	551	2	0	2	65.3032430475
408	552	1	0	1	75.1028230802
408	553	1	0	1	88.7727333078
408	554	7	1	6	52.1819741225
408	555	5	0	5	62.5513620968
408	561	5	0	5	60.6813323194
408	562	4	1	3	41.6508195462
408	563	3	0	3	57.2572856696
408	564	1	0	1	72.7894621363
408	566	45	2	43	40.9471959944
408	567	2	0	2	50.9959294518
408	568	2	0	2	49.4193267751
408	569	4	0	4	62.9478857478
408	571	1	0	1	44.5515598766
408	572	1	0	1	73.567344082
408	573	432	0	432	54.2049729179
408	574	1	0	1	37.0794923666
408	577	8	2	6	71.5887211587
408	578	2	1	1	43.4679449779
408	579	9	1	8	67.0231809234
408	580	2	1	1	56.2970938639
408	581	18	1	17	62.8276028484
408	585	10	1	9	79.9071347557
408	586	2	0	2	87.751771743
409	1	3	0	3	106.5934911
409	13	1	0	1	95.1039892002
409	36	1	0	1	90.3218624719
409	48	1	0	1	67.6135610281
409	59	2	0	2	66.4895192438
409	70	5	0	5	95.5931730233
409	71	2	0	2	85.2150860651
409	72	1	0	1	96.0727343021
409	73	88	6	82	90.5865514553
409	74	15	0	15	88.5665112984
409	75	13	0	13	88.1814561922
409	76	1	0	1	93.22922506
409	78	11	0	11	89.6347252643
409	79	1	0	1	94.487899442
409	81	4	0	4	94.2115607329
409	82	7	0	7	91.9913574259
409	83	4	0	4	90.6450983543
409	84	13	6	7	89.6339859764
409	85	7	0	7	90.387500065
409	86	2	0	2	86.0625944928
409	87	5	0	5	86.2288599293
409	88	1	0	1	85.1622861329
409	95	2	0	2	92.2659546879
409	98	1	0	1	83.9089944688
409	103	4	0	4	86.5336075091
409	108	1	0	1	105.185184075
409	110	6	1	5	83.2855752289
409	112	2	0	2	87.9680626917
409	113	10	0	10	82.8902322042
409	131	2	1	1	50.8554758673
409	134	1	0	1	73.0175734586
409	141	2	0	2	40.9767698669
409	142	5	1	4	68.1572695857
409	147	1	0	1	50.2358164524
409	154	3	0	3	62.000791496
409	155	3	0	3	90.7987771558
409	156	2	0	2	95.7238067878
409	166	2	0	2	93.337193087
409	168	9	1	8	78.5655393432
409	169	1	0	1	102.252538829
409	172	2	0	2	73.8132160619
409	177	3	0	3	76.1016772885
409	183	2	0	2	179.336949922
409	220	1	0	1	197.777324546
409	277	1	0	1	140.020308831
409	305	1	0	1	125.615867102
409	310	2	1	1	131.996393595
409	319	12	1	11	91.5476602229
409	323	2	0	2	82.06496207
409	324	1	0	1	99.5470505462
409	326	2	0	2	102.227472181
409	329	1	0	1	99.1282881691
409	332	1	0	1	134.146713822
409	338	2	0	2	121.618545744
409	345	1	0	1	168.292162752
409	358	0	0	0	120.213606622
409	369	1	0	1	154.562896157
409	379	6	1	5	29.8524790248
409	381	3	0	3	40.5051843187
409	383	1	0	1	32.145216502
409	385	25	1	24	37.7936344278
409	386	1	0	1	40.0155563504
409	388	2	0	2	28.3333459754
409	389	1	0	1	33.1465084915
409	390	1	0	1	26.9830129011
409	391	9	1	8	31.4962954952
409	392	6	0	6	36.6104502423
409	394	6	1	5	25.4704489174
409	396	127	10	117	10.4432940927
409	397	33	14	19	13.4868853988
409	398	7	0	7	29.623158895
409	399	72	4	68	5.41074733402
409	400	19	3	16	10.4046456141
409	401	30	13	17	15.5372566542
409	402	2	1	1	26.9774116486
409	403	9	0	9	8.27941157057
409	404	7	1	6	21.0405011857
409	405	30	29	1	12.1597747676
409	406	1069	388	681	5.0514765847
409	407	61	22	39	6.738400869
409	408	1855	24	1831	10.5563698353
409	410	29	0	29	12.7857520231
409	411	145	33	112	17.1413539892
409	412	22	8	14	11.7104971889
409	413	11	1	10	22.528223023
409	414	398	194	204	3.82915709288
409	415	96	25	71	16.9958242253
409	416	60	25	35	7.03573627679
409	417	46	0	46	19.7418643525
409	418	3	1	2	22.4687100664
409	419	5	0	5	17.6464419628
409	421	13	3	10	14.9593620083
409	422	1	0	1	32.3273699724
409	423	1	0	1	59.7133918653
409	425	11	4	7	20.2985609584
409	426	9	0	9	36.2979275438
409	427	40	0	40	13.5621530846
409	428	1	0	1	31.212533472
409	429	1	0	1	26.9129189625
409	431	5	3	2	24.1580424466
409	432	3	0	3	26.5916595698
409	433	7	1	6	42.8609534054
409	435	7	2	5	19.8689163584
409	436	1	0	1	34.6005522827
409	438	9	1	8	31.9615298933
409	439	3	1	2	40.6001933194
409	441	6	1	5	26.5759908092
409	442	70	32	38	21.957398369
409	443	4	1	3	44.6414533377
409	444	24	0	24	21.9347040622
409	445	0	0	0	44.0329064544
409	447	6	0	6	21.674208044
409	448	6	5	1	17.3446900929
409	451	6	1	5	17.2724422902
409	453	3	0	3	18.0233718137
409	454	2	0	2	32.9004422617
409	455	2	0	2	40.5008199066
409	457	4	0	4	20.7156103499
409	458	2	0	2	21.5245430364
409	459	4	2	2	24.1627088166
409	460	22	4	18	26.554411702
409	462	1	0	1	29.344208224
409	466	5	1	4	29.2402136876
409	469	3	0	3	33.4054331782
409	472	1	0	1	44.3244270882
409	475	3	1	2	32.4009450218
409	481	2	0	2	52.0992041214
409	487	1	0	1	56.0540986031
409	495	2	0	2	18.4258471082
409	496	1	0	1	23.0977054009
409	499	6	0	6	18.1999210378
409	502	3	1	2	9.98629554191
409	503	15	0	15	13.6736069582
409	504	1	0	1	26.1286360358
409	506	2	1	1	13.0466669019
409	507	2	0	2	116.842150366
409	512	2	0	2	78.9246410251
409	516	2	0	2	52.3972155834
409	520	0	0	0	41.523162795
409	524	9	3	6	60.7013054827
409	535	1	0	1	97.8937014291
409	540	1	0	1	87.5860939764
409	551	1	0	1	73.8841317761
409	554	0	0	0	62.2184056527
409	555	2	2	0	72.0753363245
409	566	4	1	3	48.74387743
409	567	1	0	1	59.8229039847
409	568	1	0	1	54.7851625702
409	570	1	0	1	77.0446433804
409	573	30	0	30	61.5435088556
409	581	1	0	1	68.3295339974
410	1	1	0	1	106.238467186
410	23	1	0	1	97.0654627322
410	29	1	0	1	92.996320009
410	48	1	0	1	70.5351348214
410	68	2	1	1	69.4848908247
410	70	3	0	3	89.5475018883
410	73	58	1	57	85.3036665683
410	74	5	0	5	82.7460002791
410	75	12	0	12	82.9194263589
410	76	4	1	3	87.0291237781
410	78	10	0	10	83.6298954146
410	81	2	0	2	88.5624118682
410	82	6	1	5	86.0339946037
410	83	1	0	1	85.0755924677
410	84	9	0	9	84.2145534639
410	85	5	0	5	83.9023125838
410	86	2	0	2	79.7037700883
410	87	4	0	4	80.7027492099
410	88	2	0	2	79.4068825398
410	103	2	0	2	81.8627962402
410	110	2	0	2	79.0725197024
410	112	6	0	6	83.6769671237
410	113	11	0	11	77.8578718443
410	131	1	1	0	52.1465469251
410	137	1	1	0	66.7467176154
410	142	2	1	1	64.0783690644
410	147	2	0	2	45.755610526
410	154	4	0	4	55.9924087123
410	155	1	0	1	82.7459788426
410	163	1	0	1	48.1450446417
410	166	1	0	1	84.373127674
410	168	2	0	2	71.2203396102
410	169	1	1	0	94.4039668177
410	172	3	1	2	66.4298449844
410	176	2	0	2	40.2175819335
410	177	3	0	3	67.9867273241
410	284	1	0	1	139.493442885
410	312	1	0	1	131.113272269
410	319	8	1	7	80.6908076299
410	323	3	0	3	71.6103288102
410	331	1	0	1	77.0264764979
410	338	1	0	1	111.678568656
410	345	0	0	0	160.758746701
410	349	1	0	1	98.4002387088
410	357	0	0	0	98.5970424802
410	379	8	0	8	17.5443129432
410	380	2	0	2	30.635680783
410	381	2	0	2	27.8610770718
410	385	11	3	8	25.4326331156
410	386	1	0	1	27.3300261469
410	388	3	3	0	15.5694937456
410	389	1	0	1	21.2870791315
410	391	8	0	8	20.47870561
410	392	2	0	2	24.9277404743
410	394	32	0	32	12.786767596
410	395	1	0	1	20.2950198143
410	396	197	52	145	5.8006543034
410	397	35	19	16	8.40454582098
410	398	6	4	2	23.03671772
410	399	6	5	1	15.9573689451
410	400	15	0	15	9.55006190713
410	401	41	14	27	9.44528643446
410	402	1	0	1	17.1608953314
410	403	1	0	1	19.1232505035
410	404	11	0	11	10.9421114453
410	405	9	0	9	11.2851636644
410	406	303	218	85	7.86866668827
410	407	24	1	23	9.35123991072
410	408	1740	548	1192	4.52368470433
410	409	25	0	25	12.7857520231
410	411	421	137	284	4.84698628049
410	412	11	0	11	14.4512208383
410	413	12	2	10	15.9943881604
410	414	23	7	16	16.4578981802
410	415	216	134	82	6.17590542477
410	416	18	2	16	13.7055275505
410	417	133	5	128	7.17288148872
410	418	4	2	2	10.1714760897
410	419	8	0	8	14.6380485848
410	422	1	0	1	36.9995116921
410	424	1	0	1	51.7428089007
410	425	3	1	2	24.6459059002
410	426	2	0	2	42.3495041129
410	427	13	0	13	19.1204913975
410	429	1	0	1	36.3005457763
410	430	1	0	1	40.4769631749
410	432	1	0	1	34.6547316847
410	433	4	1	3	42.7231316936
410	434	1	0	1	15.3329072338
410	435	1	0	1	20.2380765115
410	438	8	0	8	29.9508401569
410	439	2	1	1	38.8211440629
410	441	2	0	2	24.6598232167
410	442	22	0	22	24.6005599035
410	443	1	0	1	46.3046328656
410	444	5	0	5	29.3152318435
410	448	3	1	2	24.4560768838
410	451	3	0	3	12.6334596797
410	452	1	0	1	14.271967229
410	453	3	0	3	9.4405265226
410	454	1	0	1	24.6729507048
410	455	7	0	7	32.1829815211
410	457	3	1	2	16.1737515607
410	458	3	1	2	14.3523090184
410	459	9	2	7	12.3552502861
410	460	15	8	7	19.5398400449
410	463	1	0	1	42.0702917432
410	466	8	1	7	37.3263991596
410	469	3	0	3	37.0493327476
410	473	2	1	1	35.6195286312
410	475	7	0	7	30.1902451559
410	503	6	1	5	16.1242794096
410	506	2	0	2	24.3767822002
410	507	1	0	1	108.141544974
410	512	2	0	2	70.5784786276
410	520	1	0	1	30.3199768759
410	524	6	1	5	48.7858763481
410	536	1	0	1	85.2059990753
410	537	1	0	1	67.3300392052
410	540	0	0	0	76.6635502079
410	543	1	0	1	104.377716241
410	548	1	0	1	118.055022202
410	554	1	0	1	49.4550283278
410	566	4	0	4	36.8442062268
410	573	16	1	15	50.0034483998
410	577	1	0	1	67.2732712773
410	579	2	0	2	62.6776435143
410	581	1	0	1	58.3523183295
410	585	3	0	3	76.1049288549
411	1	2	0	2	108.905327547
411	9	1	0	1	103.026656469
411	15	1	0	1	98.5844379881
411	36	2	0	2	89.4302535361
411	70	9	0	9	90.1639196153
411	71	3	0	3	79.7915668854
411	72	1	0	1	91.3253375106
411	73	171	8	163	86.2685483224
411	74	31	0	31	83.4953774991
411	75	16	2	14	83.9057994457
411	76	6	0	6	87.5893504237
411	77	1	0	1	90.6576210267
411	78	23	2	21	84.2939811196
411	79	3	0	3	90.1540957255
411	81	12	0	12	89.3557504428
411	82	14	0	14	86.7063362193
411	83	5	0	5	85.9205010317
411	84	26	0	26	85.1277327106
411	85	6	0	6	84.3503901905
411	86	2	0	2	80.2323665547
411	87	9	0	9	81.59020155
411	88	2	0	2	80.2035804267
411	89	1	0	1	98.1174867882
411	90	1	0	1	87.4306181343
411	92	1	0	1	94.930585665
411	95	1	0	1	89.3696372664
411	103	4	0	4	83.0977116697
411	110	5	0	5	80.5053519521
411	112	3	0	3	85.0529791848
411	113	18	0	18	78.9692303474
411	117	1	0	1	78.8838736483
411	120	1	0	1	92.0787130973
411	124	0	0	0	63.8319773757
411	129	1	0	1	80.0004943726
411	131	2	2	0	55.5820478852
411	134	1	0	1	70.8567632025
411	141	2	0	2	36.932866468
411	142	8	0	8	65.6735305108
411	147	2	0	2	47.421159801
411	154	6	0	6	56.8739199035
411	155	3	0	3	82.4451862173
411	160	1	0	1	60.9816392243
411	163	4	0	4	48.7435476896
411	164	1	0	1	75.8810890862
411	165	3	0	3	63.2129342083
411	166	3	0	3	83.5792853891
411	167	1	1	0	51.4897883688
411	168	6	0	6	71.3419146386
411	172	8	1	7	66.5690379486
411	173	1	0	1	63.0189388506
411	177	11	0	11	67.7446312637
411	178	1	0	1	45.0719524847
411	183	2	0	2	176.736803213
411	196	1	0	1	188.862735393
411	258	1	0	1	110.891328047
411	277	2	0	2	136.855732232
411	305	2	0	2	123.742686917
411	319	19	1	18	78.7372913721
411	320	1	0	1	73.4707613689
411	321	1	0	1	84.0669054108
411	323	2	0	2	69.9741133505
411	326	1	0	1	90.9312969353
411	329	1	0	1	88.6241916314
411	338	5	1	4	110.231281836
411	341	1	0	1	121.753202389
411	345	1	0	1	160.507161189
411	349	2	0	2	96.9583957296
411	375	1	0	1	148.829037182
411	379	28	1	27	14.9803450006
411	380	3	0	3	29.4120332202
411	381	5	0	5	23.3700083815
411	382	1	1	0	21.557615471
411	383	4	1	3	17.1100460976
411	385	99	8	91	22.5206587594
411	386	15	0	15	23.7682253118
411	387	6	0	6	19.9049394532
411	388	16	2	14	11.408384878
411	389	7	2	5	16.447421584
411	390	8	1	7	15.2426778113
411	391	27	2	25	19.2852214736
411	392	10	0	10	22.8782106952
411	393	10	0	10	11.1626521738
411	394	100	6	94	9.64357457748
411	395	8	3	5	15.897438715
411	396	240	153	87	10.4330542753
411	397	51	5	46	12.2979276507
411	398	14	4	10	19.6653442429
411	399	17	0	17	20.7119237349
411	400	26	4	22	11.1808601761
411	401	129	31	98	8.36972794943
411	402	3	0	3	12.7801774652
411	403	1	0	1	22.5433523204
411	404	45	1	44	6.85104390391
411	405	30	0	30	12.2240104251
411	406	517	219	298	12.0946895732
411	407	49	7	42	14.1981815534
411	408	3348	21	3327	7.09504085037
411	409	73	17	56	17.1413539892
411	410	304	0	304	4.84698628049
411	412	23	1	22	15.9512763193
411	413	45	0	45	13.1821425786
411	414	42	2	40	20.6270365621
411	415	383	35	348	7.64250665389
411	416	42	0	42	16.6059753185
411	417	501	227	274	5.33605597586
411	418	64	52	12	5.3855621146
411	419	25	14	11	13.7365176953
411	421	7	3	4	26.700361785
411	422	1	0	1	37.3628579099
411	424	1	0	1	50.9549554245
411	425	9	0	9	25.4693807182
411	426	12	0	12	43.1053849404
411	427	21	0	21	20.8654165592
411	429	5	1	4	38.5406658269
411	430	1	0	1	36.6612860988
411	431	5	0	5	29.8415855948
411	432	1	0	1	36.4020745777
411	433	8	2	6	41.1159425315
411	435	6	2	4	19.9504788473
411	436	2	0	2	43.7522633517
411	437	3	0	3	54.7539034803
411	438	23	1	22	28.04227958
411	439	2	0	2	36.7041243846
411	440	1	0	1	28.3663444392
411	441	6	1	5	23.0753312661
411	442	67	31	36	24.7943618097
411	444	12	2	10	30.9903628315
411	445	1	0	1	36.7350510222
411	447	2	0	2	34.1137464115
411	448	3	0	3	26.2859528663
411	449	0	0	0	25.4785493385
411	450	2	0	2	26.0271505264
411	451	4	0	4	15.9076585305
411	452	2	1	1	14.9856998853
411	453	6	1	5	11.5433835362
411	454	8	2	6	25.226736066
411	455	6	0	6	32.3809099134
411	457	7	1	6	19.0575363158
411	458	11	7	4	16.3389885372
411	459	30	1	29	10.9944403132
411	460	58	0	58	21.0708887086
411	462	1	0	1	20.2423944074
411	465	1	0	1	36.511850457
411	466	5	2	3	42.0758648604
411	467	1	0	1	29.4655032813
411	469	1	0	1	41.1895431833
411	470	1	0	1	45.4481219396
411	473	1	0	1	39.0203417289
411	475	9	0	9	33.0356748063
411	491	1	0	1	51.3121954538
411	495	3	0	3	31.5003409474
411	502	1	0	1	24.6421384856
411	503	15	0	15	20.6314223776
411	506	1	0	1	27.7435171483
411	507	4	0	4	103.573810371
411	512	5	1	4	66.1309968819
411	516	0	0	0	43.7254761179
411	519	1	0	1	62.7586476769
411	520	8	1	7	25.4852683481
411	521	1	0	1	32.6782667495
411	524	29	4	25	43.9746011458
411	528	1	0	1	34.969605447
411	529	2	0	2	83.9860239183
411	530	1	0	1	92.3937978259
411	536	1	0	1	80.4411335428
411	540	3	0	3	71.8250349039
411	542	0	0	0	103.122667989
411	552	2	0	2	68.143912731
411	554	2	0	2	45.1748843979
411	555	3	0	3	55.4567743964
411	557	0	0	0	38.677538369
411	558	0	0	0	31.6581342397
411	561	1	0	1	53.9938754248
411	562	1	0	1	35.0884082423
411	563	1	0	1	50.2020390683
411	566	24	2	22	34.3157939351
411	567	1	0	1	43.9853405195
411	568	1	0	1	43.9123163184
411	569	2	0	2	56.4294192777
411	573	81	2	79	47.683510314
411	576	1	0	1	64.9012932531
411	578	3	0	3	37.5445009379
411	579	1	0	1	60.7828571457
411	581	10	1	9	57.1172925337
411	585	5	0	5	72.944988153
412	1	1	0	1	117.471084277
412	50	1	0	1	86.6559570401
412	70	3	0	3	103.582137823
412	71	2	0	2	93.161793339
412	72	1	0	1	104.3915581
412	73	45	0	45	99.0812080913
412	74	4	1	3	96.7001546538
412	75	10	0	10	96.6844889848
412	78	3	0	3	97.6425564807
412	81	1	0	1	102.471950563
412	82	7	1	6	100.036530674
412	83	4	0	4	98.9522972231
412	84	3	0	3	98.038185261
412	85	3	0	3	98.0495507798
412	86	1	0	1	93.810668468
412	87	4	1	3	94.5558594408
412	88	3	0	3	93.3334794475
412	95	2	0	2	101.382468173
412	103	2	0	2	95.3984785516
412	107	1	0	1	85.8181679856
412	110	1	0	1	92.4075785298
412	111	1	0	1	113.608497081
412	112	1	0	1	97.0578816837
412	113	6	0	6	91.5258823852
412	116	1	0	1	101.751860022
412	117	1	0	1	91.7867872286
412	141	1	0	1	49.0931083564
412	142	6	0	6	77.3028363963
412	147	1	0	1	59.0543524826
412	154	1	0	1	69.9321747662
412	155	1	0	1	97.1694710452
412	163	3	0	3	62.2965216438
412	168	2	0	2	85.5373020291
412	172	3	0	3	80.7463002336
412	174	1	0	1	54.2878442686
412	177	2	0	2	82.4062896779
412	268	1	0	1	171.856835329
412	319	8	0	8	94.649848218
412	326	1	0	1	106.611208634
412	338	0	0	0	125.954846701
412	342	0	0	0	135.805141232
412	349	3	0	3	112.675727626
412	379	0	0	0	30.9260184473
412	381	2	0	2	37.1234545234
412	384	1	0	1	45.3722207466
412	385	11	2	9	38.4273624583
412	386	1	0	1	39.3038757371
412	387	1	0	1	35.1764685032
412	389	1	0	1	28.0772332357
412	392	1	0	1	38.7610049148
412	394	9	4	5	25.5826773675
412	395	1	0	1	30.3630302053
412	396	68	45	23	16.8287622761
412	397	6	0	6	20.5832921768
412	398	7	0	7	19.5795196107
412	399	10	0	10	17.0783858736
412	400	62	40	22	4.9319699283
412	401	51	1	50	8.92144774351
412	402	5	1	4	19.8917445829
412	403	1	0	1	10.0034365448
412	404	5	2	3	15.5841153387
412	405	177	12	165	3.84824328607
412	406	219	46	173	10.3331491982
412	407	13	0	13	15.969797519
412	408	1228	0	1228	9.92804562669
412	409	35	11	24	11.7104971889
412	410	21	2	19	14.4512208383
412	411	98	23	75	15.9512763193
412	413	14	0	14	13.4139665261
412	414	54	2	52	12.2635409808
412	415	53	0	53	20.6034749929
412	416	106	5	101	4.92600616415
412	417	17	2	15	20.8432537565
412	419	23	18	5	7.3627980791
412	421	35	0	35	11.3408003158
412	422	5	0	5	22.8083842765
412	424	1	0	1	38.6119871002
412	425	33	11	22	10.3172380576
412	426	30	0	30	27.9354297363
412	427	234	49	185	4.92277814106
412	429	3	0	3	22.6633718828
412	431	11	2	9	14.7159930954
412	432	5	0	5	20.4649182662
412	433	1	0	1	31.3329677985
412	434	3	1	2	5.0286381219
412	435	17	3	14	8.16142657884
412	436	6	2	4	27.9558073946
412	438	24	1	23	20.2728256536
412	439	4	1	3	28.8912045259
412	440	2	0	2	25.3979786954
412	441	13	1	12	14.938680667
412	442	233	100	133	10.9393937489
412	443	1	0	1	33.6360976021
412	444	32	3	29	15.0602516846
412	445	1	0	1	32.5509355287
412	447	5	0	5	18.5184200071
412	448	23	17	6	10.3370860638
412	449	1	0	1	38.0677792237
412	450	2	0	2	41.09394709
412	451	2	0	2	25.1290253597
412	453	4	2	2	23.4680230153
412	454	1	0	1	38.9834232457
412	455	3	0	3	46.5573704214
412	457	3	1	2	28.8776131872
412	458	1	0	1	28.1364800967
412	459	1	0	1	26.4638145336
412	460	8	1	7	33.4418059346
412	466	1	0	1	40.7602992352
412	469	1	0	1	44.9391216395
412	475	2	0	2	42.1299928456
412	480	1	0	1	53.088113453
412	503	2	0	2	24.3552364331
412	506	1	0	1	14.0998126389
412	507	1	0	1	106.579401487
412	512	2	0	2	68.6458331419
412	515	1	0	1	54.3746673615
412	516	1	0	1	41.0591897273
412	520	1	0	1	34.781212314
412	524	2	0	2	54.4990782436
412	535	1	0	1	89.4648600582
412	539	1	0	1	77.9129398976
412	540	1	0	1	79.4364165465
412	554	1	0	1	59.069155932
412	562	1	0	1	47.1486304961
412	566	1	0	1	50.2633012179
412	573	23	0	23	63.6343787049
412	581	0	0	0	72.6908943578
413	42	1	0	1	108.933753796
413	70	1	0	1	102.754020662
413	73	41	35	6	99.1002051943
413	74	5	0	5	96.1942274322
413	75	9	0	9	96.7534160151
413	76	1	0	1	100.141396344
413	78	6	0	6	96.9310735257
413	79	0	0	0	102.96933145
413	81	2	0	2	102.074133674
413	82	6	0	6	99.3446190777
413	83	1	0	1	98.6785870557
413	84	5	0	5	97.9300212047
413	85	3	0	3	96.8198623151
413	87	4	0	4	94.3824676684
413	88	0	0	0	92.9405512313
413	96	1	0	1	103.455337964
413	112	2	0	2	98.0878840691
413	113	3	0	3	91.8916510556
413	121	1	0	1	90.2290191405
413	131	2	0	2	68.1406542324
413	142	5	0	5	78.7944904281
413	154	4	0	4	69.7197461783
413	163	1	0	1	61.4520764803
413	168	3	0	3	83.5653648278
413	172	4	0	4	78.8300259628
413	173	1	0	1	74.1185028749
413	177	1	0	1	79.6162098411
413	222	0	0	0	201.312325968
413	277	1	0	1	149.766100927
413	310	2	0	2	134.399317536
413	319	7	0	7	87.8816643777
413	323	1	0	1	79.8204170185
413	329	1	0	1	99.2674515737
413	330	1	0	1	78.1970006236
413	338	0	0	0	120.143798707
413	349	1	0	1	106.946577351
413	359	1	0	1	110.908191732
413	361	0	0	0	102.533480059
413	366	1	0	1	91.2832710435
413	375	2	0	2	159.910174817
413	379	1	0	1	25.3636232721
413	380	1	0	1	40.682758733
413	381	1	1	0	26.2147917859
413	382	10	0	10	12.8695909715
413	383	11	1	10	12.040780219
413	385	13	2	11	31.3536137259
413	386	5	1	4	30.7469618421
413	387	7	2	5	26.3482045265
413	388	3	0	3	18.7817677275
413	389	5	0	5	16.433797507
413	390	1	0	1	27.5969162732
413	391	3	1	2	31.0484892414
413	392	1	0	1	33.3064430312
413	393	4	1	3	12.3220312082
413	394	13	2	11	20.0875599832
413	395	5	0	5	20.8359628885
413	396	39	9	30	21.4250547952
413	397	9	0	9	24.3967750215
413	398	164	5	159	7.29459327461
413	399	3	0	3	27.6865068851
413	400	6	2	4	12.1572321582
413	401	159	17	142	7.30550677805
413	402	32	1	31	7.40046378428
413	404	95	13	82	7.18974822473
413	405	18	0	18	10.7497068915
413	406	100	5	95	18.5298609078
413	407	2	0	2	23.4104358846
413	408	1139	8	1131	13.6288500739
413	409	17	0	17	22.528223023
413	410	22	3	19	15.9943881604
413	411	121	4	117	13.1821425786
413	412	14	1	13	13.4139665261
413	414	13	3	10	24.5254059864
413	415	41	1	40	20.7659353787
413	416	6	4	2	17.5354874368
413	417	29	1	28	18.1085844741
413	418	5	1	4	12.9100550588
413	419	27	14	13	6.16507460227
413	420	1	0	1	41.2809700636
413	421	7	0	7	24.0129686683
413	425	17	2	15	18.089688236
413	426	8	0	8	33.9738583985
413	427	12	1	11	17.073516625
413	428	1	0	1	21.2562343093
413	430	3	0	3	24.9807226756
413	431	4	1	3	21.6970765132
413	433	10	0	10	28.2922748151
413	434	1	0	1	8.87732285524
413	435	14	1	13	10.9568215854
413	436	1	0	1	36.1643878302
413	438	42	10	32	15.1351124626
413	439	6	0	6	23.5920327288
413	440	3	1	2	15.4815545204
413	441	23	4	19	10.7434564766
413	442	115	5	110	15.9452523587
413	443	1	0	1	33.023314345
413	444	8	1	7	25.0690011042
413	445	1	0	1	23.7780332925
413	448	5	3	2	21.4873540433
413	451	2	0	2	28.5579580936
413	453	1	0	1	24.6336639035
413	454	1	0	1	38.1045318904
413	457	3	0	3	31.9606916197
413	459	2	0	2	23.263319485
413	460	4	0	4	34.2454574568
413	469	1	0	1	52.7168696314
413	475	2	0	2	46.0060827674
413	497	1	0	1	36.1368695044
413	503	1	0	1	31.4991626824
413	507	4	0	4	94.3172746596
413	512	4	0	4	56.4110256548
413	515	1	0	1	42.3490360231
413	516	2	0	2	31.2689234025
413	518	1	0	1	40.2788374748
413	520	5	0	5	21.6786580818
413	524	4	0	4	41.3776415991
413	528	2	0	2	25.6064481869
413	530	1	0	1	89.5508691139
413	535	1	0	1	76.1423756846
413	536	0	0	0	77.7543659943
413	537	1	0	1	58.1783485093
413	540	1	0	1	66.0584062446
413	548	1	0	1	105.653041076
413	554	1	0	1	47.5253169125
413	560	1	0	1	67.0702619437
413	563	2	0	2	55.7676448474
413	566	1	0	1	43.1979450976
413	569	2	0	2	65.1343273242
413	573	21	0	21	56.5510624907
413	581	3	0	3	67.7849875056
413	585	2	0	2	79.123583095
414	0	1	0	1	101.362599276
414	1	2	0	2	108.193899105
414	3	1	0	1	100.255564566
414	21	1	1	0	101.104632099
414	70	8	1	7	98.5736325963
414	73	66	0	66	93.4185854179
414	74	5	0	5	91.5149877292
414	75	4	0	4	91.0146393292
414	76	1	0	1	96.2452831711
414	78	8	0	8	92.6184401997
414	81	3	0	3	97.1129195153
414	82	2	0	2	94.960658583
414	83	3	0	3	93.5372449471
414	84	4	0	4	92.496973238
414	85	1	0	1	93.4654967636
414	86	3	0	3	89.1243831203
414	87	4	0	4	89.1220227631
414	88	1	0	1	88.105186852
414	92	1	0	1	102.983940123
414	96	1	0	1	102.12213198
414	103	2	0	2	89.2439146518
414	107	1	0	1	81.3300040937
414	112	2	0	2	90.5907407724
414	113	10	0	10	85.6882695858
414	120	1	0	1	98.6669204796
414	131	1	0	1	52.2943701406
414	142	4	0	4	70.8017428397
414	154	3	0	3	65.0659649181
414	155	1	0	1	94.1657656144
414	158	1	0	1	80.2698554509
414	166	2	0	2	96.8511819176
414	172	4	1	3	77.0932451333
414	177	7	0	7	79.5019603048
414	183	2	0	2	181.741329265
414	277	1	0	1	142.566074839
414	294	1	0	1	146.393404485
414	319	11	0	11	95.3097732456
414	323	4	0	4	85.7892749224
414	338	2	0	2	125.25988978
414	375	1	0	1	161.246880714
414	379	5	0	5	33.6577662385
414	385	12	3	9	41.5993472511
414	386	1	0	1	43.7575451134
414	388	2	0	2	31.9327843193
414	389	2	0	2	36.310711575
414	390	1	0	1	30.8021929517
414	391	4	0	4	35.3114122698
414	392	2	0	2	40.4392934902
414	394	9	0	9	29.2058179817
414	395	1	0	1	36.5222284441
414	396	78	10	68	14.2464647073
414	397	18	0	18	17.1620791562
414	398	10	1	9	31.3535969862
414	399	30	14	16	6.18840524927
414	400	10	5	5	12.4623121137
414	401	18	1	17	17.9548184601
414	403	28	12	16	5.43146287336
414	404	10	0	10	23.9415941549
414	405	29	13	16	13.8049595105
414	406	379	266	113	8.60166419843
414	407	17	2	15	10.3088533665
414	408	1139	87	1052	13.7690871996
414	409	231	9	222	3.82915709288
414	410	27	0	27	16.4578981802
414	411	72	5	67	20.6270365621
414	412	23	5	18	12.2635409808
414	413	10	0	10	24.5254059864
414	415	74	7	67	20.8243934484
414	416	94	42	52	7.35856845938
414	417	22	0	22	23.4957401411
414	418	1	0	1	25.8763396804
414	419	7	4	3	19.0922732095
414	421	27	6	21	12.3087770245
414	425	4	1	3	19.1777476538
414	426	7	1	6	34.0510675166
414	427	54	23	31	12.6533967375
414	428	1	0	1	30.41068455
414	429	1	0	1	23.7764402132
414	431	4	0	4	22.6217271031
414	432	1	0	1	23.8933360114
414	433	1	1	0	42.394737554
414	435	1	0	1	20.1207643204
414	436	1	0	1	31.8637537259
414	438	12	3	9	32.3150091621
414	439	1	0	1	40.6689375094
414	440	1	0	1	37.6442883515
414	441	3	0	3	27.1070696545
414	442	62	5	57	21.315674921
414	443	1	0	1	43.6020197285
414	444	21	0	21	19.6218838917
414	447	3	0	3	18.4748496542
414	448	10	0	10	15.3903854081
414	449	1	0	1	34.3468930271
414	451	5	0	5	20.7293198982
414	453	1	0	1	21.7918384894
414	454	2	0	2	36.4783881788
414	455	2	0	2	44.0415751109
414	457	1	0	1	24.0307502003
414	458	3	1	2	25.128696608
414	459	4	1	3	27.9873754405
414	460	5	1	4	30.0568891041
414	466	8	0	8	28.7336413747
414	469	2	0	2	34.4361953964
414	471	2	1	1	52.0225743875
414	475	1	0	1	34.9905981399
414	482	1	0	1	44.94348024
414	483	1	0	1	46.2889284775
414	489	1	1	0	59.2907015359
414	492	2	1	1	39.5432452859
414	493	0	0	0	33.052433504
414	495	1	0	1	18.313950042
414	496	1	0	1	25.4508835403
414	498	1	0	1	18.5254367084
414	499	4	0	4	19.1633914429
414	502	1	0	1	9.9478035035
414	503	4	0	4	16.1178543874
414	504	1	0	1	28.0671917425
414	505	1	0	1	25.5440164345
414	506	12	0	12	9.53598446704
414	507	2	0	2	118.599090101
414	512	2	0	2	80.6545275317
414	516	2	0	2	53.3181623897
414	520	1	0	1	44.4020644401
414	523	1	0	1	63.9780922263
414	524	6	0	6	63.774132252
414	528	1	0	1	50.1158671813
414	548	0	0	0	130.178328334
414	554	0	0	0	65.7899057506
414	555	3	0	3	75.7874277975
414	557	0	0	0	59.180375846
414	563	0	0	0	70.0647922449
414	566	1	0	1	52.5730060941
414	573	23	1	22	65.3636092006
414	577	1	0	1	82.0701834234
414	580	1	0	1	66.1656869428
414	581	2	0	2	72.0096059607
415	1	3	0	3	101.266657889
415	5	1	0	1	99.5294744557
415	65	1	0	1	84.4462302019
415	68	1	0	1	65.1736483538
415	70	7	0	7	83.4507261433
415	71	1	1	0	73.0442012698
415	72	1	0	1	84.4587586004
415	73	86	0	86	79.2977400309
415	74	6	1	5	76.6781879584
415	75	15	1	14	76.9195433652
415	76	2	0	2	80.920243896
415	78	7	0	7	77.5420279331
415	80	1	0	1	82.3777500537
415	81	4	3	1	82.5076617563
415	82	6	0	6	79.9486741194
415	83	1	0	1	79.0338525205
415	84	11	4	7	78.1923332594
415	85	4	0	4	77.7725812736
415	86	3	0	3	73.5869873391
415	87	2	0	2	74.6717046246
415	88	1	0	1	73.35015185
415	90	1	0	1	81.107636102
415	95	1	0	1	82.1507841258
415	96	1	0	1	85.2955382211
415	102	1	0	1	91.6229244384
415	103	2	0	2	75.9521871044
415	104	1	0	1	86.793430837
415	110	3	0	3	73.2462059206
415	112	1	0	1	77.826651579
415	113	6	0	6	71.8986932299
415	140	1	0	1	67.3483345367
415	141	1	0	1	29.6151334245
415	142	2	0	2	58.3242048175
415	146	1	0	1	67.5779815377
415	154	6	0	6	49.947097367
415	156	1	0	1	81.5812438904
415	162	1	0	1	83.3508777357
415	163	1	0	1	42.026974737
415	166	3	0	3	78.261463321
415	168	6	0	6	65.051281642
415	169	1	0	1	88.2298500253
415	170	1	0	1	64.9528239866
415	172	7	0	7	60.2612033799
415	176	1	1	0	34.0563633979
415	177	4	0	4	61.8142300112
415	178	1	0	1	39.0768224048
415	183	4	0	4	169.574675693
415	277	1	0	1	129.756251685
415	319	9	0	9	75.0117816993
415	322	1	0	1	67.021778334
415	323	1	0	1	65.7818418779
415	326	2	0	2	86.3564477409
415	329	1	0	1	83.6540951482
415	338	2	0	2	105.739360219
415	342	0	0	0	115.704134821
415	379	12	0	12	13.0494353889
415	380	3	0	3	24.756427575
415	381	1	0	1	26.051216621
415	383	1	0	1	23.7442770434
415	385	37	2	35	20.9418379038
415	386	4	0	4	23.6262136035
415	388	3	0	3	13.6856369307
415	390	6	0	6	10.1988032382
415	391	15	5	10	14.7223388763
415	392	9	0	9	19.6317362897
415	394	36	1	35	9.61130766851
415	395	1	0	1	18.5599189235
415	396	258	25	233	6.87214338435
415	397	78	33	45	6.22652532492
415	398	6	0	6	27.3003553028
415	399	7	0	7	18.6200650943
415	400	12	0	12	15.719720652
415	401	34	17	17	15.0834134315
415	404	7	4	3	14.4179715348
415	405	15	0	15	17.452130877
415	406	255	19	236	12.7563224381
415	407	19	1	18	11.454414078
415	408	1583	481	1102	10.6885092447
415	409	35	0	35	16.9958242253
415	410	166	0	166	6.17590542477
415	411	576	25	551	7.64250665389
415	412	10	0	10	20.6034749929
415	413	11	0	11	20.7659353787
415	414	18	2	16	20.8243934484
415	416	32	10	22	19.4485855676
415	417	240	59	181	4.53756376397
415	418	12	0	12	10.9748430346
415	419	4	0	4	20.4559802945
415	421	2	0	2	29.8668029316
415	425	2	0	2	30.8207696701
415	426	7	0	7	48.519619792
415	427	19	1	18	25.2046379282
415	430	1	0	1	44.1301229939
415	431	1	0	1	35.2475219787
415	432	1	0	1	40.6668307124
415	433	3	0	3	48.368402444
415	435	2	0	2	26.2851935374
415	436	1	0	1	48.4049363039
415	438	8	1	7	35.4058646651
415	439	1	0	1	44.1672755225
415	440	2	1	1	36.0088504214
415	441	5	0	5	30.268924182
415	442	30	0	30	30.7453345792
415	444	5	1	4	35.3652981711
415	448	2	1	1	30.4868109066
415	449	1	0	1	18.199623651
415	450	2	0	2	20.5987856297
415	451	10	5	5	8.64028861391
415	452	1	0	1	8.10274805057
415	453	14	6	8	3.90413931094
415	454	7	0	7	18.5179303661
415	455	6	0	6	26.0085411567
415	457	15	4	11	11.4946480051
415	458	4	4	0	8.73096745033
415	459	14	1	13	7.19751314471
415	460	38	6	32	13.6631562543
415	462	1	0	1	13.8840063494
415	465	0	0	0	30.4821452869
415	466	4	2	2	36.8529581302
415	469	5	0	5	34.3660786957
415	471	1	1	0	54.9578511817
415	475	12	4	8	25.4089198419
415	478	1	0	1	34.1843542441
415	488	1	0	1	54.5993448727
415	494	1	0	1	28.7360319014
415	495	1	0	1	26.9020439801
415	496	1	0	1	19.8251492027
415	497	1	0	1	15.7126802202
415	503	9	1	8	15.0082235934
415	506	3	1	2	29.5471541525
415	512	3	0	3	72.8769574734
415	516	1	0	1	51.3179968033
415	520	1	0	1	31.0110533384
415	521	2	0	2	38.865508148
415	523	1	0	1	53.7363520917
415	524	6	0	6	48.1323028686
415	525	1	0	1	56.0279563014
415	528	0	0	0	41.8929534983
415	555	1	0	1	55.68716847
415	557	1	0	1	39.6054055314
415	566	9	1	8	31.7511451561
415	568	1	0	1	38.9040587324
415	573	33	16	17	44.6432338086
415	575	1	0	1	52.1478399794
415	581	1	0	1	52.3807659539
415	585	3	0	3	71.4109179928
416	45	1	0	1	65.2584625858
416	47	1	0	1	75.2809010985
416	59	1	0	1	73.3905970967
416	70	3	0	3	101.107626875
416	71	1	1	0	90.6968497827
416	73	41	1	40	96.3553838231
416	74	8	0	8	94.1487658066
416	75	6	0	6	93.9523036432
416	76	1	0	1	98.682401738
416	78	5	1	4	95.1530838331
416	79	0	0	0	100.264787003
416	82	2	0	2	97.5314166048
416	83	3	0	3	96.318530915
416	84	7	0	7	95.3559645937
416	85	1	0	1	95.7265108682
416	86	1	0	1	91.4416981004
416	87	7	0	7	91.908032115
416	88	2	0	2	90.7602534503
416	96	1	0	1	103.846401995
416	103	3	0	3	92.4849635916
416	110	1	0	1	89.3613701648
416	113	5	0	5	88.7230089039
416	131	1	0	1	57.8086109554
416	142	6	2	4	74.2287328601
416	147	1	0	1	56.1094920169
416	154	3	1	2	67.4378592926
416	166	2	0	2	97.5029664254
416	168	1	0	1	83.5219511974
416	171	1	0	1	92.058884449
416	176	1	0	1	52.5764865726
416	177	2	1	1	80.6918465786
416	277	3	0	3	146.133588001
416	319	11	0	11	94.3725314324
416	323	3	0	3	85.2189375881
416	361	0	0	0	109.640799423
416	379	8	0	8	31.1343264182
416	381	1	0	1	39.2644204424
416	385	9	2	7	38.9290991074
416	386	2	0	2	40.3740408632
416	387	1	0	1	36.473139981
416	390	1	0	1	29.6092208334
416	391	2	0	2	34.1029285801
416	394	7	2	5	26.0777821334
416	395	2	1	1	32.1084704
416	396	59	1	58	14.326106237
416	397	14	2	12	17.9964474275
416	398	3	1	2	24.1405289192
416	399	10	0	10	12.286752581
416	400	50	18	32	6.1143187407
416	401	30	0	30	11.6265967625
416	402	3	0	3	23.2986742895
416	403	22	18	4	6.23441382458
416	404	4	2	2	18.153246284
416	405	64	21	43	6.82861174216
416	406	363	2	361	7.25388815102
416	407	15	1	14	12.336221387
416	408	1243	502	741	9.60534802498
416	409	70	18	52	7.03573627679
416	410	21	6	15	13.7055275505
416	411	89	0	89	16.6059753185
416	412	91	45	46	4.92600616415
416	413	5	0	5	17.5354874368
416	414	171	50	121	7.35856845938
416	415	48	0	48	19.4485855676
416	417	30	6	24	20.7586553194
416	418	2	0	2	21.2987635374
416	419	5	1	4	11.8378584337
416	421	24	7	17	10.435231284
416	422	2	0	2	25.7880887217
416	424	1	0	1	42.3679906193
416	425	13	4	9	13.4793314521
416	426	13	1	12	30.2460945503
416	427	91	53	38	6.79145272868
416	429	4	0	4	22.672807638
416	431	4	1	3	17.5593069578
416	432	2	0	2	21.4048223282
416	433	5	0	5	35.8269748163
416	434	1	0	1	9.83001313596
416	435	6	4	2	12.9661086517
416	438	7	2	5	25.1420898853
416	439	5	1	4	33.6699960297
416	440	1	0	1	30.2858058053
416	441	6	0	6	19.8474081853
416	442	98	12	86	14.9456588288
416	444	21	2	19	16.2730246615
416	445	1	0	1	37.4764357686
416	447	5	1	4	17.8489843948
416	448	18	0	18	11.4109605294
416	450	1	0	1	40.0024778904
416	451	2	1	1	22.3632839918
416	453	1	0	1	21.6602243644
416	455	4	0	4	44.8256777882
416	457	1	0	1	26.0487101683
416	458	2	0	2	25.9574178317
416	459	5	1	4	26.0584752996
416	460	11	0	11	31.2275832025
416	466	2	0	2	35.8586671752
416	469	3	1	2	40.4384168326
416	471	1	0	1	58.8160587773
416	475	2	1	1	38.6852687969
416	480	1	0	1	48.3984976349
416	491	1	0	1	46.3363144305
416	496	2	0	2	29.680940912
416	499	1	0	1	25.2328467039
416	502	1	0	1	16.7090261552
416	503	5	0	5	20.3359587189
416	505	1	0	1	32.8109853208
416	506	3	0	3	11.2339020563
416	512	1	0	1	73.3754893635
416	515	2	0	2	59.1335799652
416	520	0	0	0	38.2345450115
416	524	6	0	6	57.8495451335
416	537	1	0	1	75.3488302167
416	548	0	0	0	123.101670925
416	554	0	0	0	61.2599457984
416	555	1	0	1	71.9449096478
416	558	1	0	1	47.7175977754
416	566	1	0	1	50.5001188948
416	573	27	0	27	63.7020333531
416	578	1	0	1	52.6696885581
416	581	1	1	0	71.8177311842
416	585	1	0	1	89.5085945007
417	0	1	0	1	95.2036592285
417	1	2	0	2	104.517658054
417	36	1	0	1	84.5885810342
417	48	1	0	1	70.986518012
417	70	5	0	5	84.8867434081
417	71	2	0	2	74.5249384072
417	73	82	0	82	81.0670387254
417	74	11	0	11	78.2453356527
417	75	8	0	8	78.7111133199
417	78	8	0	8	79.0270663049
417	80	1	0	1	84.0311625782
417	81	3	0	3	84.1126010257
417	82	6	0	6	81.4401051527
417	83	2	0	2	80.690085915
417	84	12	5	7	79.9138008014
417	85	2	0	2	79.0495342768
417	86	4	0	4	74.9440610877
417	87	3	0	3	76.3717871071
417	88	2	0	2	74.9650205032
417	92	1	0	1	89.665754879
417	102	1	0	1	93.915494521
417	103	3	0	3	77.9770806198
417	107	2	0	2	66.8895407785
417	110	1	0	1	75.4570629209
417	112	2	0	2	79.9797587207
417	113	13	4	9	73.812765054
417	120	2	0	2	86.9065899153
417	131	2	0	2	52.0426170069
417	142	3	0	3	60.7095259671
417	145	1	0	1	64.1317287897
417	147	1	0	1	42.5324609657
417	154	5	0	5	51.6732308164
417	155	3	0	3	77.1143473023
417	158	1	0	1	62.1057470379
417	163	2	0	2	43.4871547813
417	164	2	0	2	70.5553843008
417	166	1	0	1	78.3038217856
417	168	2	0	2	66.0128028665
417	171	1	0	1	74.2442999361
417	172	4	0	4	61.2418017406
417	175	2	0	2	69.7468318985
417	177	7	0	7	62.4102783942
417	254	1	0	1	110.824107462
417	277	1	0	1	131.696481096
417	319	12	0	12	73.8446787665
417	323	2	0	2	64.9340985758
417	326	1	0	1	85.804994663
417	332	0	0	0	117.645760092
417	334	1	0	1	112.407307272
417	338	2	0	2	105.132793671
417	349	1	0	1	91.8550212372
417	375	1	0	1	143.539595427
417	379	39	2	37	10.3880446881
417	380	2	0	2	24.1883988567
417	381	4	0	4	21.7840849605
417	383	1	0	1	19.4924861469
417	385	92	19	73	18.2601455373
417	386	8	2	6	20.2745880779
417	387	3	0	3	16.941277457
417	388	12	3	9	9.32639729912
417	389	3	0	3	17.0224617678
417	390	7	5	2	9.90812764255
417	391	16	1	15	14.0196567054
417	392	10	4	6	17.9649636146
417	393	1	0	1	12.6352216736
417	394	132	13	119	5.74759285223
417	395	7	3	4	14.2202459121
417	396	129	24	105	10.578833634
417	397	32	6	26	10.7051873567
417	398	6	0	6	24.0659052288
417	399	6	0	6	22.2030894575
417	400	5	0	5	15.9416096976
417	401	39	0	39	13.6992344433
417	402	7	0	7	16.1386867711
417	403	1	0	1	26.2929639593
417	404	13	0	13	11.17770008
417	405	16	0	16	17.2574441765
417	406	233	84	149	14.9723815988
417	407	32	7	25	15.1003648286
417	408	1362	32	1330	11.2244017176
417	409	22	0	22	19.7418643525
417	410	122	34	88	7.17288148872
417	411	904	378	526	5.33605597586
417	412	8	0	8	20.8432537565
417	413	7	2	5	18.1085844741
417	414	19	8	11	23.4957401411
417	415	187	2	185	4.53756376397
417	416	27	3	24	20.7586553194
417	418	21	2	19	6.74952447992
417	419	9	1	8	19.0725114623
417	421	5	0	5	31.1200731578
417	422	2	0	2	42.6465185879
417	424	2	0	2	56.2636281303
417	425	3	0	3	30.6387457586
417	426	2	0	2	48.3243723795
417	427	15	0	15	25.6981944179
417	430	1	0	1	40.3585642078
417	431	0	0	0	35.0366142882
417	432	1	0	1	41.2890756122
417	433	1	0	1	46.2768877802
417	435	1	0	1	25.27570431
417	438	7	2	5	33.1548849624
417	439	3	0	3	41.7005327225
417	441	4	0	4	28.3016656064
417	442	28	4	24	30.0823799675
417	443	1	0	1	50.5737346502
417	444	5	0	5	35.8954145429
417	445	2	0	2	41.2099032156
417	448	2	0	2	31.1080734248
417	451	7	0	7	13.0223711327
417	452	1	0	1	10.0139670076
417	453	3	1	2	7.9264329314
417	454	4	0	4	20.0259759483
417	455	5	0	5	27.080571951
417	457	4	0	4	15.5122512747
417	458	4	0	4	12.1246789417
417	459	33	3	30	5.69814950566
417	460	26	1	25	16.3519954977
417	462	2	0	2	14.9860024198
417	469	1	0	1	38.7888882685
417	475	9	0	9	29.0738183809
417	501	1	0	1	36.5523938808
417	502	1	0	1	25.5004145174
417	503	7	1	6	19.5073523356
417	506	1	0	1	31.5465864279
417	507	4	0	4	105.566008126
417	512	5	0	5	68.5421399633
417	516	1	0	1	47.7821098045
417	520	0	0	0	26.4911394523
417	524	11	0	11	43.6691837633
417	529	1	0	1	83.7935414359
417	540	2	0	2	72.3998941384
417	555	1	0	1	52.3525025243
417	562	1	0	1	34.1837869514
417	563	1	0	1	46.5803822512
417	566	19	1	18	29.7418578654
417	568	1	0	1	38.6602074294
417	573	43	0	43	42.9806251578
417	577	2	0	2	60.3934401632
417	580	2	0	2	45.2381828084
417	581	2	0	2	51.9317630325
418	35	1	0	1	90.5742484207
418	39	0	0	0	101.36843832
418	59	2	0	2	80.2285450208
418	70	4	0	4	89.9763690019
418	71	1	0	1	79.6883775204
418	73	49	4	45	86.4853307333
418	74	4	0	4	83.4808536718
418	75	2	0	2	84.1556611356
418	76	1	0	1	87.3480590602
418	78	9	0	9	84.180931229
418	81	4	0	4	89.3689187049
418	82	3	0	3	86.5934385549
418	83	1	0	1	86.003775312
418	84	5	0	5	85.2906280335
418	85	2	0	2	83.9962307965
418	86	7	2	5	79.9846329503
418	87	3	0	3	81.7381297282
418	88	0	0	0	80.2555422829
418	111	1	0	1	100.222137558
418	113	6	1	5	79.380083015
418	135	1	0	1	50.4383047191
418	141	2	0	2	38.1211269126
418	142	1	0	1	66.699108121
418	154	1	0	1	57.1606863664
418	156	1	0	1	86.2984248199
418	163	1	0	1	48.7954317252
418	166	1	0	1	81.863678269
418	168	2	0	2	70.6848773507
418	171	1	0	1	78.7062774064
418	172	4	0	4	65.959115354
418	177	4	1	3	66.7062257644
418	240	1	0	1	203.460910485
418	319	14	0	14	75.8002193061
418	329	1	0	1	86.5850151205
418	338	1	0	1	107.747041442
418	349	2	0	2	94.5083009023
418	375	1	0	1	147.126652051
418	379	14	5	9	12.511017482
418	380	1	0	1	27.787079177
418	381	3	0	3	18.1289587147
418	382	5	1	4	17.8893620093
418	383	2	1	1	12.7806914281
418	385	53	2	51	19.1208113096
418	386	3	1	2	19.5361818287
418	387	5	2	3	15.3838557543
418	388	28	16	12	6.85297977993
418	389	3	0	3	11.1591053307
418	390	3	1	2	14.9739389482
418	391	7	0	7	18.1711558083
418	392	4	0	4	20.5236241824
418	393	3	0	3	6.12733714455
418	394	26	10	16	7.17754028433
418	395	10	0	10	10.8142897457
418	396	57	3	54	15.4778531685
418	397	7	0	7	16.7069789947
418	398	8	1	7	17.9086584671
418	400	8	0	8	15.439096148
418	401	30	25	5	11.1043453427
418	402	6	1	5	9.50515618044
418	403	1	0	1	27.414334382
418	404	29	12	17	5.76276856414
418	405	6	0	6	15.9451229056
418	406	109	4	105	17.4172751583
418	407	4	0	4	19.4873341409
418	408	1058	38	1020	12.1530768703
418	409	11	0	11	22.4687100664
418	410	48	1	47	10.1714760897
418	411	567	24	543	5.3855621146
418	412	7	0	7	19.7932620981
418	413	11	5	6	12.9100550588
418	414	11	0	11	25.8763396804
418	415	35	2	33	10.9748430346
418	416	7	1	6	21.2987635374
418	417	113	101	12	6.74952447992
418	419	3	0	3	15.7341002219
418	425	1	0	1	28.3800599844
418	426	3	0	3	45.6200193938
418	427	4	0	4	24.6746195696
418	428	1	0	1	33.8523185107
418	433	2	0	2	41.1244454464
418	435	2	0	2	22.0579089799
418	438	3	1	2	27.9810738308
418	441	2	0	2	23.6096159246
418	442	24	0	24	27.1491666941
418	443	2	0	2	45.9300227529
418	444	1	0	1	34.5025822284
418	445	1	0	1	34.9622010911
418	448	3	1	2	30.0141483527
418	449	1	0	1	26.8316100687
418	451	1	1	0	19.6121354938
418	453	1	0	1	14.6314102736
418	454	2	0	2	25.7514259781
418	455	5	0	5	32.2742503108
418	456	1	0	1	38.0095863944
418	457	3	0	3	22.2500054637
418	459	4	0	4	10.7358670344
418	460	17	1	16	22.8288883571
418	469	1	0	1	45.3309922241
418	475	1	0	1	35.7948739171
418	486	1	0	1	76.1946773871
418	505	1	0	1	49.0995334782
418	507	2	0	2	99.0755645227
418	512	1	0	1	61.9021449467
418	516	4	0	4	41.231141275
418	520	6	0	6	20.3956678724
418	524	12	0	12	38.61440027
418	536	1	0	1	75.058022226
418	540	2	0	2	66.6658534693
418	551	0	0	0	54.1788580551
418	554	2	0	2	40.0510861671
418	555	2	1	1	50.6657794749
418	566	8	0	8	31.0816814605
418	569	1	0	1	53.2210977385
418	573	40	1	39	44.5219619301
418	577	1	0	1	62.3211867767
418	581	0	0	0	55.0609839461
418	585	2	0	2	68.7931675927
418	586	1	0	1	76.2789583847
419	1	0	0	0	120.592029693
419	50	1	0	1	90.5798200052
419	70	1	0	1	103.786138707
419	73	25	0	25	99.7385670503
419	74	4	0	4	97.0650913935
419	75	2	0	2	97.3634995562
419	76	1	0	1	101.229141419
419	78	3	0	3	97.8972362793
419	79	1	0	1	103.635089764
419	81	5	0	5	102.909096215
419	82	3	0	3	100.307434583
419	83	4	0	4	99.4494937002
419	84	7	0	7	98.6237106994
419	85	0	0	0	98.0211446686
419	86	1	0	1	93.8792558203
419	98	1	0	1	91.1473304679
419	103	1	0	1	96.4054106296
419	113	1	0	1	92.3537986815
419	141	1	0	1	50.0407794989
419	142	3	2	1	78.6995120729
419	145	1	0	1	81.2573396356
419	154	1	0	1	70.3685949032
419	156	1	0	1	101.194792838
419	168	1	0	1	85.0675909101
419	171	1	0	1	93.3161526274
419	172	2	0	2	80.291628173
419	177	1	1	0	81.476030158
419	183	1	0	1	190.019895668
419	277	0	0	0	150.211583827
419	310	1	0	1	136.791964466
419	319	2	0	2	91.5342876279
419	323	1	0	1	83.0977284446
419	329	1	0	1	102.09066921
419	338	0	0	0	123.428339303
419	382	3	2	1	18.9189189535
419	383	1	0	1	18.1032534753
419	385	3	0	3	34.8501632275
419	386	2	0	2	34.9346854495
419	387	1	0	1	30.6093542997
419	389	2	1	1	21.9178925393
419	390	1	0	1	28.9769658848
419	391	1	0	1	32.938353664
419	392	0	0	0	36.0658698948
419	394	32	0	32	22.5516757334
419	395	2	0	2	25.3485990952
419	396	25	2	23	19.0929467349
419	397	9	0	9	22.5657366581
419	398	10	1	9	12.3046362279
419	399	2	0	2	23.0094225958
419	400	6	2	4	7.45287738998
419	401	119	59	60	5.41766550867
419	402	3	0	3	13.1747747775
419	403	0	0	0	17.3638479322
419	404	29	0	29	10.3603563863
419	405	28	0	28	5.49263166366
419	406	72	7	65	14.4743881122
419	407	3	0	3	19.9437369597
419	408	636	145	491	10.8840009436
419	409	9	2	7	17.6464419628
419	410	13	1	12	14.6380485848
419	411	61	3	58	13.7365176953
419	412	20	15	5	7.3627980791
419	413	58	0	58	6.16507460227
419	414	16	0	16	19.0922732095
419	415	33	0	33	20.4559802945
419	416	15	0	15	11.8378584337
419	417	17	0	17	19.0725114623
419	418	3	0	3	15.7341002219
419	420	1	0	1	41.6996111302
419	421	3	1	2	17.876612539
419	423	1	0	1	46.9935413698
419	424	3	1	2	37.3138310731
419	425	14	5	9	12.8498932896
419	426	7	0	7	29.8864021914
419	427	29	17	12	10.9362745609
419	429	1	0	1	27.8013860603
419	430	4	0	4	29.4729880358
419	431	6	1	5	16.9124504357
419	433	4	0	4	28.1019354244
419	434	8	4	4	2.74498441173
419	435	23	9	14	6.34471426606
419	437	1	0	1	43.0975127546
419	438	20	6	14	15.5426404352
419	439	4	1	3	24.4662616218
419	440	1	0	1	18.909568104
419	441	12	0	12	10.1210922626
419	442	139	0	139	11.4150944413
419	443	1	0	1	31.7547099931
419	444	9	1	8	19.4907938874
419	447	3	1	2	24.4408529079
419	448	4	1	3	15.5693181501
419	449	1	0	1	38.6512078276
419	451	2	0	2	27.0515790052
419	454	2	0	2	38.7944249689
419	455	1	0	1	46.0690861852
419	457	2	0	2	30.7029705698
419	458	1	0	1	28.9669586774
419	459	1	0	1	24.7042960057
419	460	5	0	5	34.0869527692
419	475	1	0	1	44.609695813
419	495	2	0	2	35.9639134146
419	503	1	0	1	28.404762685
419	507	1	0	1	99.50775052
419	512	3	1	2	61.5630587728
419	516	1	0	1	34.8378433004
419	520	1	0	1	27.8016772054
419	524	1	0	1	47.516649582
419	528	1	0	1	31.2059006402
419	549	1	0	1	92.8873144066
419	568	1	1	0	57.4938234968
419	573	10	0	10	60.2492838883
419	581	2	0	2	70.5552339878
419	583	1	0	1	105.214899379
419	585	1	0	1	83.9122876371
420	1	1	0	1	162.230464158
420	24	1	0	1	151.141659369
420	73	3	0	3	140.316903857
420	75	2	0	2	137.980481488
420	78	0	0	0	138.005034258
420	82	2	0	2	140.416345618
420	84	1	0	1	139.129084542
420	100	1	0	1	148.102512827
420	120	1	0	1	146.217518833
420	166	1	0	1	133.854196439
420	177	1	0	1	119.956476491
420	277	0	0	0	191.013736581
420	338	0	0	0	157.090837803
420	396	1	0	1	60.7266581006
420	398	1	0	1	36.2266303172
420	399	1	0	1	61.7425189826
420	402	1	0	1	45.2356149078
420	406	1	0	1	55.2102192488
420	408	11	0	11	52.5573924192
420	411	1	0	1	54.352393739
420	416	1	0	1	49.5540395355
420	422	2	0	2	28.1371976901
420	423	51	2	49	10.9484676147
420	424	41	15	26	13.3820962848
420	426	115	4	111	29.6852976174
420	427	1	0	1	43.353668719
420	429	6	0	6	42.8459007596
420	431	1	0	1	34.2505137558
420	432	2	0	2	38.8280163977
420	433	52	17	35	13.768483026
420	435	1	0	1	37.0981890615
420	436	17	0	17	35.7399570251
420	437	386	82	304	7.62605898406
420	438	5	0	5	26.3488291215
420	441	0	0	0	31.6024936973
420	442	6	1	5	34.7136384271
420	443	30	7	23	13.5848044164
420	444	3	0	3	39.3002298421
420	446	18	1	17	16.9992460254
420	448	1	0	1	41.6178034115
420	460	1	0	1	75.3863870594
420	503	1	0	1	69.3840011825
420	516	1	0	1	21.7926299191
420	518	2	0	2	25.6463433844
420	573	2	0	2	93.655719759
420	581	0	0	0	106.819407841
421	1	2	0	2	120.259071688
421	73	11	0	11	105.533922037
421	78	2	0	2	104.591882189
421	82	2	0	2	106.949664543
421	84	3	0	3	104.587153359
421	85	1	0	1	105.324042453
421	87	0	0	0	101.185800184
421	113	1	0	1	97.828399351
421	142	1	0	1	83.0293028662
421	147	1	0	1	65.1782769869
421	154	1	0	1	76.9461343019
421	175	1	0	1	97.9292228279
421	177	2	0	2	90.759340496
421	319	3	0	3	104.806849245
421	338	0	0	0	135.57450341
421	375	0	0	0	172.52512
421	385	1	0	1	49.1841563284
421	386	0	0	0	50.3780902144
421	392	0	0	0	49.0392734615
421	396	6	1	5	24.400688528
421	400	1	0	1	15.5834193654
421	401	3	1	2	20.2581971708
421	403	5	1	4	6.8820293381
421	404	1	0	1	26.9242740873
421	405	6	1	5	15.1293467478
421	406	24	8	16	17.3693167755
421	408	85	0	85	19.9023988149
421	409	14	11	3	14.9593620083
421	410	2	0	2	24.1268831818
421	411	2	1	1	26.700361785
421	412	13	3	10	11.3408003158
421	413	1	0	1	24.0129686683
421	414	29	6	23	12.3087770245
421	415	5	0	5	29.8668029316
421	416	13	2	11	10.435231284
421	417	1	0	1	31.1200731578
421	422	3	1	2	18.8874593257
421	424	1	0	1	36.4413654336
421	425	17	2	15	9.75522534205
421	426	29	0	29	21.7968690074
421	427	62	5	57	6.94100560576
421	429	3	0	3	12.2802896085
421	431	7	2	5	11.6108381217
421	432	8	0	8	11.6448774361
421	433	6	2	4	32.8020221487
421	434	1	0	1	15.1404530896
421	435	6	0	6	14.7644660294
421	436	5	4	1	19.6499842715
421	438	9	2	7	25.4322708833
421	439	2	1	1	32.4734031873
421	441	1	0	1	21.3191065445
421	442	111	0	111	12.8892631349
421	444	61	19	42	7.43062713416
421	447	24	10	14	7.43879117283
421	448	37	10	27	4.37303014418
421	453	1	0	1	31.9131547865
421	460	1	0	1	41.1786191622
421	471	1	0	1	62.6458325235
421	480	1	0	1	53.0758405822
421	506	13	10	3	5.37736575942
421	507	0	0	0	114.109612903
421	524	2	0	2	65.3888259209
421	554	0	0	0	70.4081946277
421	561	1	0	1	77.3893918776
421	573	12	0	12	74.0954108816
421	581	0	0	0	82.2071469954
422	1	1	0	1	138.777574723
422	70	1	0	1	126.387075217
422	73	8	0	8	121.873973281
422	74	2	0	2	119.508538594
422	78	2	0	2	120.449006336
422	83	1	0	1	121.757300035
422	87	1	0	1	117.359200858
422	88	1	0	1	116.141521825
422	103	1	0	1	118.136168833
422	113	1	0	1	114.299856841
422	116	1	0	1	124.532260961
422	142	1	0	1	99.9558246943
422	173	0	0	0	100.381045432
422	177	0	0	0	104.917456924
422	310	1	0	1	160.470880964
422	319	1	0	1	115.329056498
422	323	1	0	1	106.976941072
422	329	1	0	1	125.943198351
422	375	1	0	1	186.185913988
422	391	1	0	1	56.6472559964
422	396	4	0	4	39.5904011653
422	397	2	0	2	43.3457483927
422	399	3	1	2	36.754670274
422	401	3	0	3	29.0334266529
422	402	1	0	1	34.7455701075
422	405	1	0	1	25.7185783978
422	406	8	0	8	32.7938459486
422	408	49	3	46	32.5235448594
422	409	1	0	1	32.3273699724
422	411	5	1	4	37.3628579099
422	412	3	0	3	22.8083842765
422	413	1	0	1	27.6717909384
422	414	2	0	2	30.5970983677
422	415	3	0	3	43.1702715884
422	416	2	0	2	25.7880887217
422	417	1	0	1	42.6465185879
422	420	1	0	1	28.1371976901
422	421	4	0	4	18.8874593257
422	423	1	0	1	28.2072938523
422	425	8	0	8	12.5068024405
422	426	404	175	229	6.43686060358
422	427	15	7	8	19.0016973534
422	429	16	2	14	15.0179720719
422	431	59	16	43	8.23016956446
422	432	20	5	15	10.7658325958
422	433	4	0	4	16.8709102584
422	435	3	0	3	17.5426067384
422	436	44	7	37	10.6799869541
422	437	5	1	4	33.4487303504
422	438	5	0	5	17.626970318
422	439	2	0	2	19.527943428
422	441	5	0	5	18.00209996
422	442	108	10	98	12.5686304353
422	443	2	0	2	14.5830886783
422	444	97	0	97	11.6453582977
422	447	13	4	9	17.2259353672
422	448	6	0	6	15.2116628915
422	459	0	0	0	48.3409001311
422	460	1	0	1	56.242799169
422	475	1	1	0	64.4733338252
422	503	2	0	2	45.9798285664
422	506	1	0	1	23.8865389479
422	565	1	0	1	114.461514667
422	573	6	0	6	84.0088040957
423	1	2	0	2	166.265617349
423	20	1	0	1	154.803281468
423	64	1	0	1	152.177010217
423	73	7	0	7	146.675440244
423	74	1	0	1	143.905720407
423	76	1	0	1	147.941229783
423	78	2	0	2	144.686013116
423	85	0	0	0	144.647509257
423	88	1	0	1	140.619499444
423	92	0	0	0	155.325323349
423	124	1	0	1	121.560789188
423	142	1	0	1	125.6544863
423	172	1	0	1	126.681715677
423	177	1	0	1	127.402975184
423	307	1	0	1	177.092680499
423	393	0	0	0	58.6718491628
423	401	4	0	4	52.3663213818
423	402	1	0	1	52.8560840913
423	406	1	0	1	59.2248401385
423	408	14	2	12	57.4948522483
423	411	0	0	0	60.4172679663
423	412	1	0	1	48.8920989523
423	416	3	0	3	52.8085430842
423	420	57	14	43	10.9484676147
423	424	110	65	45	10.6304753322
423	426	156	5	151	27.2844377599
423	427	2	0	2	46.1523192301
423	429	1	0	1	41.2238608366
423	432	2	0	2	37.8892157781
423	433	44	10	34	19.6989441811
423	436	20	1	19	32.7653137426
423	437	199	109	90	18.0420515127
423	438	3	0	3	32.7658092351
423	439	1	0	1	25.3329031493
423	441	0	0	0	37.3603536002
423	442	7	0	7	37.9784073286
423	443	21	0	21	15.3097175703
423	444	1	0	1	39.843061357
423	445	1	0	1	30.786348652
423	446	6	2	4	26.5424872639
423	448	2	0	2	43.2138841185
423	488	1	0	1	101.153339852
423	516	1	0	1	32.6101161301
423	524	1	0	1	71.9800702805
423	563	1	0	1	97.7499827791
423	573	2	0	2	102.370966776
423	581	0	0	0	114.946168025
424	8	0	0	0	164.064075205
424	50	1	0	1	124.404773803
424	59	1	0	1	113.237623335
424	70	0	0	0	141.095709752
424	71	1	0	1	130.70842246
424	73	3	2	1	137.024388216
424	75	1	0	1	134.644595156
424	76	1	0	1	138.532679717
424	78	1	0	1	135.210068529
424	83	1	0	1	136.75566825
424	85	0	0	0	135.304991637
424	87	0	0	0	132.397892986
424	96	1	0	1	142.256060114
424	110	1	0	1	130.756625913
424	142	2	0	2	115.704800228
424	177	0	0	0	118.451020141
424	277	0	0	0	187.411965237
424	360	1	0	1	136.358845437
424	397	1	0	1	59.0048584119
424	398	1	0	1	35.9617398692
424	399	1	0	1	53.9408078296
424	401	1	0	1	42.7292192443
424	406	2	0	2	48.9338923759
424	408	14	8	6	47.5284819746
424	411	3	1	2	50.9549554245
424	415	2	0	2	57.7278099078
424	416	6	0	6	42.3679906193
424	420	52	10	42	13.3820962848
424	422	4	1	3	17.5852155559
424	423	88	0	88	10.6304753322
424	425	1	0	1	28.9225262316
424	426	239	130	109	17.2359593912
424	427	2	0	2	35.6606098834
424	428	1	0	1	18.695496322
424	429	2	0	2	31.0407169484
424	431	1	0	1	25.2394219956
424	432	1	0	1	27.4848052621
424	433	106	35	71	12.4364604251
424	436	17	0	17	23.0714021726
424	437	154	40	114	20.6301429372
424	438	2	0	2	24.2441008571
424	439	6	2	4	18.5896196903
424	441	1	0	1	28.1751224415
424	442	10	0	10	27.672620664
424	443	43	0	43	6.01695070231
424	444	4	2	2	29.2275719131
424	446	4	1	3	30.1828224753
424	448	2	0	2	32.5946481906
424	458	1	0	1	66.0727651428
424	460	1	0	1	71.2825351261
424	462	1	0	1	71.1845125881
424	507	1	0	1	92.6675481546
424	512	1	0	1	59.2153780216
424	516	2	0	2	30.5364250988
424	524	2	0	2	67.6868127263
424	534	1	0	1	87.7654397531
424	537	1	0	1	77.609317521
424	571	0	0	0	82.0080212877
424	573	1	1	0	94.6431966564
425	70	5	1	4	113.897191077
425	73	32	0	32	109.367171358
425	74	5	0	5	107.009567188
425	75	1	0	1	106.968942819
425	76	1	0	1	111.421105338
425	78	3	0	3	107.956562712
425	82	3	0	3	110.349718634
425	83	1	0	1	109.252785227
425	84	5	0	5	108.331495305
425	85	0	0	0	108.366113512
425	86	1	0	1	104.127905163
425	87	2	0	2	104.853924473
425	95	1	0	1	111.582997345
425	116	1	0	1	112.06817672
425	120	1	0	1	114.914247199
425	142	1	0	1	87.4830402632
425	168	1	0	1	95.8269184254
425	169	1	0	1	119.049799996
425	172	1	0	1	91.0357254329
425	177	0	0	0	92.6315109625
425	310	0	0	0	148.30546011
425	319	0	0	0	104.064867505
425	349	1	0	1	122.426107867
425	379	1	0	1	40.3294261375
425	381	0	0	0	44.1707495832
425	382	0	0	0	29.1721841144
425	385	8	1	7	47.4689249974
425	391	5	0	5	44.6518509117
425	392	1	0	1	48.3117656019
425	394	2	0	2	34.8743380473
425	396	11	0	11	27.0841946405
425	397	1	0	1	30.8398370229
425	398	3	1	2	21.267154738
425	400	4	0	4	15.106614766
425	401	8	2	6	17.3764727807
425	403	2	0	2	14.4004752832
425	404	2	1	1	23.1932152192
425	405	9	0	9	13.4400839901
425	406	43	0	43	20.327853919
425	408	209	28	181	20.1364111216
425	409	7	0	7	20.2985609584
425	410	3	1	2	24.6459059002
425	411	16	2	14	25.4693807182
425	412	22	4	18	10.3172380576
425	413	5	2	3	18.089688236
425	414	10	0	10	19.1777476538
425	415	13	3	10	30.8207696701
425	416	11	2	9	13.4793314521
425	417	7	0	7	30.6387457586
425	418	0	0	0	28.3800599844
425	419	9	0	9	12.8498932896
425	421	39	16	23	9.75522534205
425	422	15	4	11	12.5068024405
425	424	8	0	8	28.9225262316
425	426	65	4	61	17.7232291192
425	427	162	18	144	6.73808490544
425	428	11	2	9	11.3057245872
425	429	8	0	8	15.5838222738
425	430	1	0	1	34.6299075967
425	431	62	5	57	4.42779738971
425	432	10	2	8	12.0460112928
425	433	18	0	18	23.4906701803
425	434	1	0	1	10.4998449924
425	435	46	4	42	7.17356144519
425	436	18	0	18	18.5097478022
425	437	5	0	5	40.5076181489
425	438	51	19	32	15.799812614
425	439	3	0	3	22.7486749909
425	440	2	0	2	23.5073547995
425	441	41	6	35	12.2475335452
425	442	1167	547	620	3.26969179202
425	443	6	2	4	24.4397385732
425	444	105	17	88	7.15101391022
425	445	3	1	2	28.6396219459
425	447	22	0	22	13.4838531644
425	448	56	22	34	5.45289440068
425	453	2	0	2	33.7763479927
425	459	1	1	0	36.3287937398
425	460	2	0	2	43.758806142
425	469	1	0	1	53.5197147912
425	475	4	0	4	52.0959500132
425	491	2	0	2	58.0926370303
425	503	2	0	2	33.8086936402
425	506	1	0	1	15.0535252602
425	507	1	0	1	104.577524082
425	512	2	0	2	67.0273813732
425	516	1	0	1	37.3810500494
425	520	1	0	1	39.2489638581
425	524	4	0	4	58.660524106
425	536	1	0	1	94.4503000568
425	554	0	0	0	65.6149434197
425	555	1	0	1	77.4512092818
425	561	0	0	0	71.3108118567
425	566	1	0	1	59.4182992593
425	569	1	0	1	81.5732115931
425	573	7	0	7	72.8548142311
425	577	1	0	1	90.581436902
425	581	2	0	2	82.5658873567
425	585	1	0	1	96.7612415684
426	1	2	0	2	142.009355115
426	5	1	0	1	137.884506441
426	25	1	0	1	137.82689062
426	28	1	0	1	143.660352683
426	36	1	0	1	126.584234064
426	65	1	0	1	115.262182139
426	70	0	0	0	131.316835555
426	73	14	0	14	126.601330348
426	74	5	0	5	124.377055732
426	78	2	0	2	125.365677633
426	82	1	0	1	127.748926745
426	84	2	0	2	125.601434579
426	85	2	0	2	125.872985103
426	87	6	1	5	122.150990961
426	88	1	0	1	120.992452487
426	110	1	0	1	119.528589828
426	113	3	0	3	118.964141317
426	131	1	0	1	86.0721324779
426	142	3	0	3	104.394262242
426	146	1	0	1	115.183064693
426	155	3	0	3	125.094367353
426	166	1	0	1	126.601653668
426	168	3	0	3	113.459029434
426	172	1	0	1	108.668608069
426	177	2	0	2	110.333421701
426	183	1	0	1	215.63487728
426	293	1	0	1	178.376175454
426	319	2	0	2	121.419196501
426	338	1	0	1	153.260949957
426	345	2	0	2	203.089670484
426	383	1	0	1	44.6780034615
426	385	0	0	0	64.7303135423
426	392	1	0	1	65.8571305025
426	393	1	0	1	46.2907243772
426	396	5	0	5	44.4296598272
426	397	1	0	1	48.1592023303
426	398	1	0	1	34.4419059751
426	399	1	0	1	40.2303622141
426	400	3	0	3	32.8002384972
426	401	8	0	8	34.8663862568
426	403	1	0	1	28.6259045201
426	405	2	0	2	31.1627899287
426	406	8	0	8	37.4504659519
426	408	98	23	75	37.8311260903
426	411	8	1	7	43.1053849404
426	412	3	0	3	27.9354297363
426	413	1	0	1	33.9738583985
426	414	3	1	2	34.0510675166
426	415	7	1	6	48.519619792
426	416	8	0	8	30.2460945503
426	417	4	0	4	48.3243723795
426	419	1	0	1	29.8864021914
426	420	2	0	2	29.6852976174
426	421	3	0	3	21.7968690074
426	422	72	30	42	6.43686060358
426	423	10	1	9	27.2844377599
426	424	21	0	21	17.2359593912
426	425	7	6	1	17.7232291192
426	427	16	0	16	23.6278596373
426	428	2	1	1	14.2807055131
426	429	70	0	70	13.9434791771
426	431	14	0	14	13.3007840483
426	432	77	0	77	10.9591679457
426	433	22	0	22	20.73372599
426	435	1	0	1	23.571780554
426	436	302	129	173	6.0912795317
426	437	16	0	16	35.9489338274
426	438	3	0	3	23.8648742767
426	439	2	0	2	24.5779273352
426	441	5	0	5	24.4382490495
426	442	85	0	85	18.4717313929
426	443	5	0	5	16.4503019006
426	444	113	1	112	14.431233665
426	447	12	0	12	17.8836078909
426	448	5	1	4	18.9758779422
426	450	1	0	1	68.889871171
426	457	1	0	1	56.2902851326
426	460	2	0	2	61.2652601008
426	475	2	0	2	68.6914015085
426	482	1	0	1	68.5284599363
426	501	1	0	1	46.7121034383
426	503	3	0	3	49.9384050225
426	506	2	1	1	26.1092600177
426	507	0	0	0	106.634208428
426	511	1	0	1	112.945579727
426	516	0	0	0	40.4186895524
426	520	1	0	1	52.9404659961
426	524	1	0	1	71.1153574265
426	551	0	0	0	98.6081402161
426	563	1	0	1	89.6611719921
426	573	3	0	3	90.1235108299
426	577	1	0	1	107.941051147
426	581	0	0	0	100.22243673
426	585	2	0	2	113.038673269
427	1	1	0	1	120.148131677
427	35	1	0	1	100.42295128
427	70	8	0	8	107.6916731
427	71	1	0	1	97.2748237879
427	73	48	1	47	103.025292215
427	74	5	0	5	100.759957895
427	75	9	0	9	100.623691775
427	76	1	0	1	105.245348621
427	78	6	0	6	101.741551348
427	80	1	0	1	106.287484768
427	81	1	0	1	106.496533711
427	82	4	0	4	104.126316677
427	83	1	0	1	102.958902166
427	84	7	0	7	102.012031161
427	85	1	0	1	102.247878051
427	86	2	0	2	97.9813273638
427	87	8	1	7	98.5521635467
427	88	1	0	1	97.378485941
427	96	1	0	1	110.20398021
427	102	1	0	1	114.101290302
427	103	2	0	2	99.2056423707
427	112	1	0	1	100.777638187
427	113	4	0	4	95.4140480329
427	142	5	0	5	80.9805024633
427	144	1	0	1	80.3817087799
427	147	1	0	1	62.8280776778
427	155	1	0	1	101.665427164
427	163	1	0	1	66.5393723808
427	166	1	0	1	103.466100969
427	168	6	0	6	89.8953178467
427	171	2	0	2	98.3867492075
427	172	2	2	0	85.1071881356
427	177	4	0	4	86.8999928245
427	183	2	0	2	192.368281445
427	319	4	0	4	99.5323243571
427	320	1	0	1	94.325300307
427	323	1	1	0	90.6148133252
427	329	1	0	1	108.822595168
427	338	1	0	1	130.757168539
427	353	1	0	1	124.417329467
427	361	0	0	0	114.678902231
427	373	0	0	0	158.183252463
427	375	0	0	0	168.521629774
427	379	4	1	3	35.8330183604
427	382	1	0	1	29.5870058406
427	383	1	0	1	29.0365083198
427	385	7	0	7	43.3498971151
427	387	1	0	1	40.0504778783
427	391	5	0	5	39.5359366571
427	392	1	0	1	43.6416786127
427	393	1	0	1	27.4930234731
427	394	2	1	1	30.5014970655
427	396	28	10	18	20.8019031764
427	397	4	0	4	24.5345106603
427	398	11	4	7	22.2901772126
427	399	4	0	4	18.4620979684
427	400	17	2	15	9.75715954448
427	401	36	3	33	13.686901609
427	402	1	0	1	24.0480649753
427	403	7	0	7	8.434147484
427	404	5	0	5	20.2526800698
427	405	63	15	48	8.74620522636
427	406	168	16	152	13.855091739
427	407	3	1	2	19.1202786175
427	408	782	21	761	14.630205965
427	409	30	13	17	13.5621530846
427	410	11	3	8	19.1204913975
427	411	62	7	55	20.8654165592
427	412	146	86	60	4.92277814106
427	413	12	0	12	17.073516625
427	414	79	18	61	12.6533967375
427	415	36	7	29	25.2046379282
427	416	74	1	73	6.79145272868
427	417	11	2	9	25.6981944179
427	418	1	0	1	24.6746195696
427	419	10	3	7	10.9362745609
427	420	1	0	1	43.353668719
427	421	135	69	66	6.94100560576
427	422	9	0	9	19.0016973534
427	424	2	0	2	35.6606098834
427	425	135	67	68	6.73808490544
427	426	62	1	61	23.6278596373
427	428	6	0	6	17.7901313116
427	429	7	4	3	17.7511531834
427	430	2	0	2	37.9213996078
427	431	29	2	27	10.7716073685
427	432	13	1	12	15.5917527499
427	433	9	2	7	29.7440519701
427	434	10	2	8	8.19948818955
427	435	42	0	42	8.5053948685
427	436	7	0	7	23.2071185885
427	437	3	1	2	46.5236434613
427	438	40	0	40	20.2795902255
427	439	9	0	9	28.2484254437
427	440	4	1	3	26.7453436561
427	441	28	0	28	15.5048118635
427	442	773	263	510	8.66546192247
427	443	4	1	3	31.1181202518
427	444	98	5	93	10.2105082773
427	445	2	0	2	33.0842796997
427	447	22	9	13	13.7573249912
427	448	72	0	72	5.42184117968
427	450	1	0	1	45.7770411122
427	451	1	0	1	28.9875186473
427	453	1	0	1	27.8383699678
427	457	3	0	3	32.7040970043
427	460	6	1	5	37.6510844847
427	466	2	0	2	41.27248234
427	469	1	0	1	46.8413496395
427	471	1	0	1	64.6731348178
427	475	2	1	1	45.4738755214
427	503	4	0	4	27.0869060356
427	506	11	5	6	10.9050079072
427	507	2	0	2	108.281246817
427	509	1	0	1	119.446806726
427	516	0	0	0	41.7875412198
427	520	1	0	1	38.7369835996
427	524	2	0	2	58.4480777499
427	535	1	0	1	92.3918011915
427	549	1	0	1	102.425212056
427	554	1	0	1	63.675586726
427	555	4	0	4	74.9866927545
427	564	1	0	1	85.2946471434
427	566	1	0	1	55.1805178601
427	573	12	0	12	68.5446628139
427	577	1	0	1	86.071507974
427	581	2	0	2	77.4577857282
427	583	1	0	1	115.461547489
427	587	1	0	1	105.346555888
428	1	0	0	0	137.557430964
428	70	1	0	1	122.513617936
428	71	1	0	1	112.114480994
428	73	12	0	12	118.363603796
428	74	3	0	3	115.760937756
428	75	3	1	2	115.980830882
428	78	1	0	1	116.614264255
428	82	4	0	4	119.02259337
428	84	3	0	3	117.268150235
428	85	1	0	1	116.775449666
428	87	2	0	2	113.751368291
428	88	1	0	1	112.434618271
428	111	1	0	1	132.650934914
428	113	3	0	3	110.920418138
428	117	1	0	1	111.011935012
428	142	1	0	1	97.0122692371
428	145	1	0	1	99.0922478634
428	168	1	0	1	103.834812363
428	172	1	0	1	99.0595538077
428	177	4	0	4	100.203263687
428	277	1	0	1	168.72057316
428	311	1	0	1	161.029788023
428	319	2	0	2	109.113406131
428	320	1	0	1	103.320716697
428	338	1	0	1	141.398655472
428	357	0	0	0	127.39184202
428	379	1	0	1	46.3560887407
428	381	1	0	1	46.5226645829
428	382	1	0	1	28.0694866577
428	385	4	0	4	52.6046975597
428	386	1	0	1	51.9084294881
428	390	1	0	1	47.7237067647
428	392	0	0	0	54.3757876182
428	395	1	0	1	41.9356465635
428	396	13	0	13	36.6294939629
428	397	2	0	2	40.3346510807
428	398	9	4	5	20.4406628855
428	399	1	0	1	36.2428539875
428	401	6	1	5	24.1788751957
428	404	1	0	1	28.1139374819
428	405	8	1	7	22.0467705398
428	406	33	0	33	30.4294446944
428	408	176	4	172	28.8329885149
428	409	3	1	2	31.212533472
428	411	11	1	10	32.495530949
428	412	10	2	8	20.1022798816
428	413	12	0	12	21.2562343093
428	414	10	0	10	30.41068455
428	415	7	0	7	39.084495256
428	416	9	2	7	24.2091143242
428	417	5	0	5	37.8289813315
428	419	1	0	1	18.7683580781
428	420	1	0	1	25.6193919973
428	421	10	2	8	20.5461705132
428	422	10	0	10	8.03200037371
428	424	8	3	5	18.695496322
428	425	51	19	32	11.3057245872
428	426	55	3	52	14.2807055131
428	427	48	8	40	17.7901313116
428	429	2	0	2	21.1477577644
428	431	60	3	57	9.19732470167
428	432	1	0	1	16.6619357491
428	433	50	0	50	12.2628620376
428	435	29	16	13	12.8289317812
428	436	10	0	10	18.6124318374
428	437	1	0	1	29.3921419803
428	438	267	2	265	9.60347584856
428	439	30	3	27	12.7314936741
428	440	3	1	2	18.0920297438
428	441	63	23	40	10.778294604
428	442	701	99	602	9.26494559805
428	443	15	0	15	13.5338239305
428	444	44	1	43	14.886984506
428	445	3	0	3	20.2347163053
428	447	11	0	11	21.7016882364
428	448	16	11	5	16.2035280414
428	449	1	0	1	57.2074908833
428	451	1	0	1	44.9060198458
428	455	1	0	1	64.8342812259
428	459	1	0	1	43.4293833741
428	460	3	0	3	52.6022787197
428	475	1	0	1	62.1585265692
428	503	3	0	3	44.4086079991
428	506	2	1	1	25.9221953501
428	507	2	0	2	95.9601741237
428	512	2	0	2	59.1158484061
428	517	1	0	1	71.1153607261
428	518	1	0	1	37.8244913885
428	520	2	0	2	38.793324963
428	521	1	0	1	38.9538315652
428	524	2	0	2	56.8352178148
428	528	1	0	1	34.4523454281
428	563	0	0	0	76.1910806705
428	566	2	0	2	64.4521783234
428	567	1	0	1	71.0759548051
428	573	8	0	8	77.7896857198
428	579	1	0	1	91.5159014916
428	581	1	0	1	88.9111157408
428	585	1	0	1	99.5642051435
429	45	1	0	1	76.6652386168
429	70	0	0	0	122.348968647
429	73	6	0	6	117.150307676
429	75	1	0	1	114.747641251
429	81	1	0	1	120.872252887
429	82	2	0	2	118.735010267
429	85	1	0	1	117.232874562
429	86	1	0	1	112.895159101
429	87	1	0	1	112.87998645
429	112	1	0	1	114.169197125
429	120	1	0	1	122.34281896
429	131	1	0	1	74.0775661812
429	142	1	0	1	94.4208825957
429	147	1	0	1	76.817550033
429	154	1	0	1	88.8341043189
429	166	3	0	3	120.008296001
429	172	1	0	1	100.724348796
429	177	1	0	1	102.951626418
429	243	1	0	1	232.71113198
429	272	1	0	1	178.624381895
429	277	2	0	2	166.021227338
429	321	1	0	1	121.874991197
429	382	0	0	0	44.727691366
429	394	1	0	1	48.1838421716
429	400	2	1	1	27.3629459787
429	406	8	0	8	29.6451219929
429	408	37	13	24	31.9718737701
429	410	1	0	1	36.3005457763
429	411	2	1	1	38.5406658269
429	412	4	1	3	22.6633718828
429	413	2	0	2	33.4871437859
429	414	5	0	5	23.7764402132
429	415	4	1	3	42.121298798
429	416	6	0	6	22.672807638
429	417	2	0	2	43.1872755868
429	419	0	0	0	27.8013860603
429	421	8	1	7	12.2802896085
429	422	13	7	6	15.0179720719
429	424	4	2	2	31.0407169484
429	425	2	1	1	15.5838222738
429	426	528	78	450	13.9434791771
429	427	12	1	11	17.7511531834
429	428	1	0	1	21.1477577644
429	431	1	0	1	13.2816171248
429	432	65	31	34	4.48685681536
429	433	3	0	3	31.837497661
429	435	3	0	3	22.7169986163
429	436	133	19	114	9.20652999773
429	437	1	0	1	48.4391385433
429	438	4	0	4	29.4507514078
429	441	2	0	2	27.2728693358
429	442	38	0	38	18.4153643851
429	443	1	0	1	29.2762021656
429	444	107	9	98	8.44803639892
429	446	1	0	1	57.3767879661
429	447	57	2	55	5.3170355442
429	448	6	1	5	12.417183859
429	471	1	0	1	70.1103616614
429	506	7	0	7	14.470907792
429	507	0	0	0	117.075267725
429	509	1	0	1	128.294601254
429	522	1	0	1	65.2097010657
429	554	0	0	0	80.9128028966
429	566	1	0	1	72.8359802932
429	573	1	0	1	86.1523993389
430	1	0	0	0	144.604367765
430	48	1	0	1	110.900916827
430	73	3	0	3	117.751783347
430	74	1	0	1	114.30660442
430	78	1	0	1	114.780278291
430	84	0	0	0	116.463086475
430	85	1	0	1	114.035400677
430	88	0	0	0	111.267627639
430	113	2	0	2	111.094379112
430	142	1	0	1	99.4578491578
430	155	1	0	1	109.096920382
430	177	0	0	0	95.3685562352
430	271	1	0	1	185.818851778
430	277	1	0	1	168.332761083
430	320	1	0	1	90.1958643053
430	324	0	0	0	104.45423794
430	382	9	4	5	16.0894164544
430	383	2	0	2	21.7929909425
430	389	1	0	1	27.315568206
430	394	1	0	1	39.5196127083
430	395	2	0	2	34.2459566699
430	396	2	0	2	46.1520421708
430	397	1	0	1	48.7841214632
430	398	6	2	4	17.6861546534
430	399	1	0	1	52.399728463
430	401	1	0	1	32.2845624796
430	402	1	0	1	24.2199887878
430	406	12	1	11	43.4389007768
430	407	1	0	1	48.3875066803
430	408	58	12	46	38.5946787182
430	409	2	0	2	47.0862540825
430	410	2	0	2	40.4769631749
430	411	5	0	5	36.6612860988
430	412	1	0	1	36.3225758274
430	413	6	1	5	24.9807226756
430	415	5	1	4	44.1301229939
430	416	1	0	1	41.1454689075
430	417	4	0	4	40.3585642078
430	420	1	0	1	28.4155074882
430	424	1	1	0	34.7393071766
430	425	1	0	1	34.6299075967
430	426	2	0	2	41.3454518444
430	427	1	0	1	37.9213996078
430	433	19	0	19	22.7795737804
430	435	1	0	1	29.4199724803
430	437	0	0	0	24.2899304605
430	438	5	2	3	19.1540876527
430	439	22	0	22	17.1940266782
430	440	18	16	2	11.2063316119
430	441	0	0	0	22.5975110394
430	442	12	0	12	31.3608308405
430	443	4	1	3	29.5314683901
430	445	25	7	18	8.86086578753
430	447	1	0	1	47.885832845
430	448	1	0	1	39.9423819964
430	460	1	0	1	56.479596793
430	507	1	0	1	70.3697920503
430	508	1	0	1	62.5805323442
430	512	8	1	7	32.5383267627
430	515	10	3	7	18.2127396041
430	516	92	0	92	8.3372002326
430	517	1	0	1	43.46196275
430	518	15	1	14	15.638781122
430	520	4	2	2	21.906518533
430	521	2	1	1	16.2243775313
430	522	3	0	3	25.4667997943
430	523	2	0	2	20.2659166174
430	524	7	0	7	33.2730375883
430	526	1	0	1	21.4610312512
430	528	8	3	5	8.97634879852
430	535	4	0	4	56.6785616265
430	536	0	0	0	64.1949336738
430	540	1	0	1	47.8404244117
430	549	1	0	1	64.8410357548
430	573	1	1	0	66.934799046
430	581	0	0	0	81.0426658872
431	73	12	0	12	113.70047399
431	74	2	0	2	111.3731511
431	76	1	0	1	115.803599248
431	78	5	0	5	112.329498206
431	82	1	0	1	114.720630387
431	84	3	0	3	112.672969548
431	85	0	0	0	112.760139686
431	86	1	0	1	108.516203555
431	103	1	0	1	109.931538992
431	113	2	0	2	106.111894002
431	119	1	0	1	111.165108388
431	155	1	0	1	111.816894418
431	158	1	0	1	97.0122773794
431	168	1	0	1	100.244985664
431	177	1	0	1	97.0590552746
431	293	1	0	1	165.252206917
431	319	2	0	2	108.345865192
431	329	1	0	1	118.445760336
431	387	1	0	1	47.5033297168
431	396	10	1	9	31.4174547801
431	397	5	0	5	35.1694348536
431	398	3	0	3	23.8753094935
431	400	2	0	2	19.5313023913
431	401	1	0	1	21.6728757345
431	406	9	0	9	24.5771534375
431	408	84	3	81	24.5619610873
431	409	1	0	1	24.1580424466
431	410	3	0	3	29.0730172151
431	411	6	0	6	29.8415855948
431	412	8	0	8	14.7159930954
431	413	6	0	6	21.6970765132
431	414	3	0	3	22.6217271031
431	415	7	2	5	35.2475219787
431	416	6	2	4	17.5593069578
431	417	2	0	2	35.0366142882
431	419	1	0	1	16.9124504357
431	421	20	7	13	11.6108381217
431	422	46	0	46	8.23016956446
431	424	3	0	3	25.2394219956
431	425	58	29	29	4.42779738971
431	426	197	52	145	13.3007840483
431	427	36	10	26	10.7716073685
431	428	7	6	1	9.19732470167
431	429	8	5	3	13.2816171248
431	432	8	1	7	9.1009569933
431	433	11	1	10	21.33153805
431	435	15	0	15	10.8031018651
431	436	19	0	19	14.486266015
431	437	2	0	2	38.4905386586
431	438	12	0	12	16.2704063719
431	439	3	0	3	21.727480361
431	441	12	0	12	14.0867730586
431	442	336	132	204	5.75929917898
431	443	6	0	6	21.231071481
431	444	99	43	56	5.80296436788
431	445	1	0	1	28.5845513019
431	447	20	1	19	12.7354010825
431	448	20	2	18	7.44588477239
431	459	1	0	1	40.7303606677
431	460	1	0	1	48.1456017468
431	475	0	0	0	56.244402758
431	506	1	0	1	16.9374125656
431	516	1	0	1	37.1949202516
431	520	0	0	0	42.2599647062
431	524	2	0	2	61.3877734325
431	554	0	0	0	69.1030369311
431	555	1	0	1	81.1192172103
431	566	1	0	1	63.6611109865
431	573	1	0	1	77.1015077168
432	70	2	0	2	122.163652184
432	73	6	0	6	117.175550233
432	74	1	0	1	115.148516886
432	78	1	0	1	116.20498984
432	81	1	0	1	120.801682718
432	85	0	0	0	116.901835167
432	113	1	0	1	109.472399032
432	142	1	0	1	94.667593494
432	164	1	0	1	109.208632912
432	177	0	0	0	102.09309521
432	222	0	0	0	217.491928564
432	345	1	0	1	194.612558954
432	385	1	0	1	58.8065425922
432	396	2	0	2	35.700740608
432	399	1	0	1	29.9802973134
432	400	1	0	1	25.3474662971
432	401	1	0	1	28.7905347911
432	404	1	0	1	34.9774266453
432	406	2	0	2	28.6163751082
432	408	34	9	25	30.1960029243
432	409	1	0	1	26.5916595698
432	410	1	0	1	34.6547316847
432	411	3	0	3	36.4020745777
432	412	3	1	2	20.4649182662
432	414	3	0	3	23.8933360114
432	415	6	0	6	40.6668307124
432	416	8	0	8	21.4048223282
432	418	1	0	1	39.8948800226
432	420	1	0	1	38.8280163977
432	421	8	6	2	11.6448774361
432	422	19	6	13	10.7658325958
432	424	5	1	4	27.4848052621
432	425	5	0	5	12.0460112928
432	426	434	24	410	10.9591679457
432	427	9	6	3	15.5917527499
432	429	45	0	45	4.48685681536
432	431	9	1	8	9.1009569933
432	433	3	1	2	27.4684575218
432	435	2	0	2	19.2074293775
432	436	98	65	33	8.00898898072
432	437	2	0	2	44.2081262411
432	438	1	0	1	25.0829324041
432	441	1	0	1	23.1867419232
432	442	33	8	25	14.5614469582
432	443	2	0	2	25.2442545912
432	444	143	4	139	5.41368941897
432	447	14	4	10	6.95342070937
432	448	4	0	4	10.2009505678
432	460	1	0	1	52.5804741855
432	475	1	0	1	58.8607008341
432	503	1	0	1	39.9932489283
432	506	3	0	3	15.3383425667
432	540	1	0	1	91.5306156359
432	573	2	0	2	84.0799898288
433	1	3	0	3	148.513144307
433	70	0	0	0	131.046271211
433	71	0	0	0	120.722252293
433	73	11	0	11	127.342584456
433	74	3	0	3	124.476595689
433	75	3	0	3	124.987823885
433	78	2	0	2	125.221155787
433	79	1	0	1	131.21937098
433	82	5	1	4	127.634753305
433	84	2	0	2	126.184550154
433	85	4	1	3	125.10540839
433	87	1	0	1	122.640189447
433	88	1	0	1	121.214583757
433	103	1	0	1	124.213526391
433	109	1	0	1	132.85339758
433	113	2	0	2	120.078891853
433	142	0	0	0	106.69260524
433	164	1	0	1	116.39379961
433	166	1	0	1	122.289550707
433	172	1	0	1	107.083118501
433	177	1	0	1	107.73339832
433	183	1	0	1	217.852745288
433	201	1	0	1	229.883984091
433	212	1	0	1	192.705620839
433	220	1	0	1	235.357292351
433	305	1	0	1	164.795797308
433	310	0	0	0	162.035041719
433	319	1	1	0	113.86927509
433	325	1	0	1	107.744090254
433	329	1	0	1	126.518839711
433	338	0	0	0	146.616128158
433	359	1	0	1	135.74991505
433	377	1	0	1	171.633155962
433	381	1	0	1	50.0488900464
433	382	2	0	2	29.9418839551
433	385	1	0	1	58.5530375969
433	387	1	0	1	52.6527547148
433	389	1	0	1	40.8102442991
433	392	1	0	1	61.1487899491
433	394	2	0	2	48.2744267137
433	395	1	0	1	47.0904924088
433	396	10	1	9	47.0430164429
433	398	4	0	4	24.2595518004
433	399	1	0	1	48.052176804
433	400	1	0	1	34.6669022573
433	401	2	0	2	33.3297084663
433	405	2	1	1	32.5083118028
433	406	22	0	22	41.4457463042
433	408	117	24	93	38.9078625379
433	409	4	0	4	42.8609534054
433	411	7	1	6	41.1159425315
433	412	2	0	2	31.3329677985
433	414	4	0	4	42.394737554
433	415	10	0	10	48.368402444
433	416	2	0	2	35.8269748163
433	417	1	0	1	46.2768877802
433	420	14	1	13	13.768483026
433	422	2	0	2	16.8709102584
433	423	24	1	23	19.6989441811
433	424	49	7	42	12.4364604251
433	425	7	0	7	23.4906701803
433	426	63	0	63	20.73372599
433	427	9	0	9	29.7440519701
433	428	7	0	7	12.2628620376
433	429	6	0	6	31.837497661
433	430	13	0	13	22.7795737804
433	431	6	0	6	21.33153805
433	432	2	0	2	27.4684575218
433	435	10	4	6	23.3332842104
433	436	5	0	5	26.6076141563
433	437	82	6	76	17.1590604837
433	438	73	2	71	13.1573164365
433	439	106	10	96	6.15476033393
433	440	13	0	13	17.4224014465
433	441	17	0	17	18.1001201039
433	442	131	7	124	21.0792603885
433	443	193	65	128	6.78859726363
433	444	9	1	8	26.8085912371
433	445	27	9	18	13.9193392402
433	446	1	0	1	25.6155271361
433	447	3	1	2	33.3633432586
433	448	11	2	9	28.4656538877
433	451	1	0	1	55.1296603882
433	457	1	0	1	58.7986491218
433	459	1	0	1	51.5492599109
433	460	0	0	0	62.0303640143
433	465	1	0	1	69.1822413394
433	469	1	0	1	76.2417664611
433	503	1	0	1	55.6165493633
433	512	1	0	1	50.3518965878
433	516	30	1	29	20.0396604585
433	517	2	0	2	63.3822178492
433	518	2	0	2	28.1328938626
433	528	1	0	1	31.2046455842
433	530	1	0	1	97.5202496835
433	535	1	0	1	77.7553489481
433	537	0	0	0	66.0783110501
433	540	0	0	0	69.6958255309
433	543	0	0	0	97.323430839
433	556	1	0	1	95.0995967736
433	558	1	0	1	56.7987791588
433	573	6	0	6	82.8580284293
433	581	0	0	0	95.2651265251
433	585	1	0	1	102.038043875
434	1	0	0	0	120.570995585
434	73	25	2	23	100.636515633
434	74	2	0	2	98.0632032228
434	75	1	0	1	98.2523297881
434	76	3	0	3	102.312248343
434	78	4	0	4	98.9338627954
434	79	1	0	1	104.540291418
434	81	2	0	2	103.885806227
434	82	1	0	1	101.339991419
434	83	1	0	1	100.403258663
434	84	1	0	1	99.5461367146
434	85	1	0	1	99.1542773139
434	86	1	0	1	94.9767837347
434	87	1	0	1	96.0328300421
434	92	1	0	1	109.548097761
434	103	1	0	1	97.1772491684
434	110	1	0	1	94.3471178339
434	113	5	0	5	93.1866079731
434	118	1	0	1	99.7467107895
434	142	5	0	5	79.3158842889
434	147	1	0	1	60.9976575791
434	158	1	0	1	82.6471188506
434	177	1	0	1	82.8940345126
434	183	1	0	1	190.731646041
434	319	2	0	2	93.6092633396
434	323	1	0	1	85.0467556163
434	338	2	0	2	125.352579112
434	379	1	0	1	29.9310481852
434	381	1	0	1	34.0701740909
434	382	0	0	0	21.5218671532
434	383	1	0	1	20.8465929671
434	385	7	0	7	36.9799842923
434	391	2	0	2	34.5362505102
434	394	2	0	2	24.4607583464
434	395	1	0	1	27.8159732108
434	396	21	0	21	19.135121038
434	397	1	0	1	22.7659645623
434	398	4	0	4	14.5959692104
434	399	1	0	1	21.5978032142
434	400	18	2	16	6.7411729727
434	401	21	5	16	6.95549479906
434	403	1	0	1	14.9622428378
434	404	3	1	2	12.7670514633
434	405	72	32	40	4.57723339581
434	406	65	2	63	13.692532282
434	407	0	0	0	19.3427717829
434	408	367	0	367	11.1335461836
434	409	4	0	4	16.1874689702
434	410	7	3	4	15.3329072338
434	411	21	5	16	15.2518730119
434	412	59	44	15	5.0286381219
434	413	10	7	3	8.87732285524
434	414	9	4	5	17.1851064884
434	415	8	2	6	21.3930020094
434	416	6	1	5	9.83001313596
434	417	9	5	4	20.5419378957
434	418	1	0	1	17.8810688128
434	419	27	9	18	2.74498441173
434	421	11	2	9	15.1404530896
434	422	3	0	3	22.1110788368
434	425	8	1	7	10.4998449924
434	426	9	1	8	27.9108921203
434	427	50	0	50	8.19948818955
434	428	3	1	2	17.7341494538
434	430	1	0	1	31.3222097943
434	431	9	4	5	14.7368762478
434	433	2	0	2	27.9424817263
434	435	7	1	6	4.90567359602
434	436	1	1	0	29.0071560211
434	438	12	5	7	16.0002709369
434	439	1	0	1	24.8441165764
434	440	2	1	1	20.4712003397
434	441	8	2	6	10.5293416395
434	442	135	87	48	9.54290974381
434	443	1	0	1	31.0576168617
434	444	9	2	7	16.904503138
434	447	1	0	1	21.7094617814
434	448	9	0	9	12.861368138
434	451	1	1	0	27.3215742136
434	454	1	0	1	39.8874150616
434	460	2	1	1	34.8688717568
434	466	1	0	1	45.4161496529
434	512	1	0	1	63.618715285
434	515	1	0	1	49.3514331968
434	516	1	0	1	36.247381482
434	524	3	0	3	50.2486842442
434	555	0	0	0	67.3574015108
434	566	1	0	1	48.9344729278
434	573	8	0	8	62.3736547439
434	581	0	0	0	72.3360307864
435	1	3	0	3	125.231995989
435	5	1	0	1	122.401065158
435	7	2	0	2	115.713223728
435	36	1	0	1	107.42164829
435	39	1	0	1	118.308584619
435	48	1	0	1	87.2919225843
435	70	4	1	3	109.734204142
435	73	29	0	29	105.541344042
435	74	3	0	3	102.961006849
435	75	1	0	1	103.157418205
435	76	1	0	1	107.19863518
435	78	2	0	2	103.8270993
435	82	2	0	2	106.233853474
435	83	2	0	2	105.305088833
435	84	7	0	7	104.449903501
435	85	1	0	1	104.03117626
435	86	2	0	2	99.8603224236
435	87	0	0	0	100.935794138
435	90	1	0	1	107.259897372
435	92	1	0	1	114.443585607
435	111	1	0	1	119.856669143
435	112	1	0	1	103.862173243
435	113	2	0	2	98.0922268234
435	119	1	0	1	102.160003977
435	131	1	0	1	69.993521311
435	141	1	0	1	55.6776218144
435	150	1	0	1	59.9504320923
435	158	0	0	0	87.3608114922
435	168	2	0	2	91.1786762735
435	171	1	0	1	99.4737862855
435	172	1	0	1	86.3960181779
435	177	1	0	1	87.6777350252
435	183	1	0	1	195.629299046
435	237	1	0	1	175.16925878
435	311	1	0	1	149.05334553
435	319	2	0	2	97.8505226303
435	379	1	0	1	34.3674765115
435	382	1	0	1	22.19296585
435	385	2	0	2	41.1597936029
435	389	1	0	1	27.3846787408
435	391	1	0	1	39.2138313188
435	393	0	0	0	23.021704649
435	394	1	0	1	28.8950748845
435	396	15	0	15	23.9286365071
435	397	5	0	5	27.5959319659
435	398	4	0	4	14.4354211529
435	399	1	0	1	25.2205968965
435	400	1	0	1	11.4243459793
435	401	13	10	3	11.5812513529
435	402	1	0	1	18.3555169992
435	403	0	0	0	16.7373372227
435	404	2	1	1	16.5729174489
435	405	15	3	12	9.29953746704
435	406	34	0	34	18.1124832987
435	407	3	0	3	23.8037340496
435	408	265	50	215	16.0177367387
435	409	8	3	5	19.8689163584
435	410	3	0	3	20.2380765115
435	411	20	12	8	19.9504788473
435	412	21	5	16	8.16142657884
435	413	23	0	23	10.9568215854
435	414	8	0	8	20.1207643204
435	415	13	4	9	26.2851935374
435	416	24	0	24	12.9661086517
435	417	6	0	6	25.27570431
435	418	2	0	2	22.0579089799
435	419	17	8	9	6.34471426606
435	420	1	0	1	37.0981890615
435	421	26	2	24	14.7644660294
435	422	6	1	5	17.5426067384
435	424	7	0	7	31.5197347461
435	425	87	18	69	7.17356144519
435	426	25	9	16	23.571780554
435	427	112	0	112	8.5053948685
435	428	5	1	4	12.8289317812
435	431	22	3	19	10.8031018651
435	432	5	1	4	19.2074293775
435	433	11	0	11	23.3332842104
435	434	3	1	2	4.90567359602
435	436	2	0	2	25.2890270069
435	437	2	1	1	39.3736262
435	438	98	4	94	12.1966892951
435	439	5	3	2	20.7312958154
435	441	76	21	55	7.07670045952
435	442	804	30	774	5.13208885135
435	443	3	0	3	26.1890192669
435	444	57	11	46	14.2689626464
435	445	1	0	1	24.7694842794
435	447	11	0	11	20.1501161715
435	448	35	0	35	11.3168541174
435	453	1	0	1	29.6712539076
435	455	1	0	1	52.1369314312
435	456	1	0	1	56.7511228209
435	457	2	0	2	35.8878750744
435	460	2	0	2	39.774545079
435	469	2	0	2	53.0553811949
435	475	2	0	2	49.537068281
435	503	2	0	2	32.2878342934
435	506	1	0	1	19.3339541263
435	512	2	0	2	61.9534562159
435	516	2	0	2	33.4164469063
435	524	2	0	2	51.6011134601
435	528	2	0	2	32.9102820356
435	535	1	0	1	84.2829728221
435	536	1	0	1	87.5650354149
435	548	1	0	1	112.487258226
435	566	3	1	2	53.117097664
435	573	10	1	9	66.5517303869
435	576	1	0	1	84.5656708577
435	581	0	0	0	76.8901396867
435	585	3	0	3	89.8997988774
436	28	1	0	1	140.724976479
436	73	3	0	3	125.18332055
436	74	2	0	2	123.156287493
436	75	1	0	1	122.778284255
436	78	0	0	0	124.21068816
436	82	1	0	1	126.573137247
436	85	1	0	1	124.896669775
436	87	2	0	2	120.828915083
436	107	1	0	1	112.696976838
436	112	1	0	1	122.451861164
436	113	2	0	2	117.478283689
436	134	0	0	0	107.446728238
436	142	4	0	4	102.657474937
436	146	1	0	1	113.948704506
436	177	0	0	0	109.985013462
436	277	1	0	1	174.425743762
436	293	0	0	0	177.370287519
436	375	1	0	1	191.672639928
436	396	1	0	1	43.6257138808
436	397	1	0	1	47.2642290912
436	406	3	0	3	36.5429611464
436	408	18	0	18	37.8271906808
436	414	1	0	1	31.8637537259
436	415	3	0	3	48.4049363039
436	416	4	0	4	29.304281824
436	420	1	0	1	35.7399570251
436	421	1	0	1	19.6499842715
436	422	10	2	8	10.6799869541
436	423	2	0	2	32.7653137426
436	424	4	0	4	23.0714021726
436	425	2	0	2	18.5097478022
436	426	515	219	296	6.0912795317
436	427	1	0	1	23.2071185885
436	429	42	25	17	9.20652999773
436	431	2	1	1	14.486266015
436	432	31	22	9	8.00898898072
436	433	1	0	1	26.6076141563
436	437	7	1	6	42.0397837764
436	438	1	0	1	28.1117427456
436	441	0	0	0	27.6732577822
436	442	15	2	13	20.2207608668
436	444	38	10	28	13.0600628667
436	447	6	0	6	14.076360146
436	448	2	0	2	17.9503913095
436	469	0	0	0	64.7861289299
436	474	1	0	1	57.0300355869
436	501	1	0	1	42.6633447605
436	502	1	0	1	40.5883708687
436	503	1	0	1	47.9759182482
436	507	1	0	1	112.561299078
436	516	1	0	1	46.016135361
436	573	0	0	0	91.3147406382
437	1	1	0	1	163.482470754
437	70	1	0	1	142.854360781
437	73	8	8	0	139.760164605
437	74	1	0	1	136.572529644
437	78	0	0	0	137.170041091
437	82	1	0	1	139.571979408
437	83	1	0	1	139.175246103
437	85	2	0	2	136.695465592
437	87	0	0	0	134.974791607
437	112	1	0	1	139.221723241
437	113	1	0	1	132.781664065
437	141	1	0	1	91.4946580312
437	142	0	0	0	120.165896579
437	164	1	0	1	127.669434478
437	177	1	0	1	118.473901696
437	338	0	0	0	153.905444555
437	378	1	0	1	192.06105986
437	381	1	0	1	57.7918368279
437	382	1	0	1	38.2650384763
437	385	1	0	1	68.5761459903
437	398	1	0	1	35.5877530508
437	399	2	0	2	64.5366210469
437	406	1	0	1	57.2398534194
437	408	25	2	23	53.9388461035
437	410	1	0	1	57.2473279333
437	411	1	0	1	54.7539034803
437	412	1	0	1	47.5319876432
437	413	2	0	2	41.5779839288
437	415	1	0	1	62.3406008393
437	416	2	0	2	52.2498738483
437	417	1	0	1	59.508568499
437	420	91	2	89	7.62605898406
437	422	1	0	1	33.4487303504
437	423	69	0	69	18.0420515127
437	424	40	0	40	20.6301429372
437	425	1	0	1	40.5076181489
437	426	122	3	119	35.9489338274
437	427	1	0	1	46.5236434613
437	428	1	0	1	29.3921419803
437	429	5	0	5	48.4391385433
437	430	1	0	1	24.2899304605
437	431	1	0	1	38.4905386586
437	432	2	0	2	44.2081262411
437	433	80	12	68	17.1590604837
437	436	20	15	5	42.0397837764
437	438	5	1	4	27.5881202155
437	439	5	0	5	18.7034402125
437	441	0	0	0	33.0669703624
437	442	8	1	7	37.897551392
437	443	14	0	14	19.4990831411
437	444	2	0	2	43.9309668207
437	445	1	0	1	18.8263472897
437	446	37	4	33	9.55893147243
437	455	1	0	1	85.6168726143
437	507	3	1	2	72.0554484008
437	512	1	0	1	39.7927638338
437	516	8	1	7	16.5576460279
437	518	3	0	3	18.5094974295
437	540	0	0	0	62.8716539418
437	548	0	0	0	88.914457457
437	554	0	0	0	71.3410626838
437	573	0	0	0	90.9718111742
437	581	0	0	0	104.710468751
437	585	1	0	1	106.312861026
438	71	1	0	1	107.566811603
438	73	31	0	31	114.208211132
438	74	4	0	4	111.324563602
438	75	6	0	6	111.856800113
438	76	0	0	0	115.27584589
438	78	5	0	5	112.065383416
438	81	1	0	1	117.202866399
438	82	7	0	7	114.478956168
438	83	1	0	1	113.801756137
438	84	3	0	3	113.044895844
438	85	1	0	1	111.949891789
438	86	2	0	2	107.911156286
438	87	1	0	1	109.499075491
438	88	4	0	4	108.066298023
438	103	1	0	1	111.12272818
438	113	2	0	2	106.96755297
438	142	1	0	1	93.6968657043
438	166	2	0	2	109.393370796
438	171	1	0	1	106.667091807
438	172	1	0	1	93.9387878335
438	177	1	0	1	94.639558714
438	220	0	0	0	222.214832606
438	266	1	0	1	180.723892044
438	314	1	0	1	147.719361857
438	319	1	0	1	101.612750513
438	338	3	2	1	134.196692919
438	379	3	0	3	40.3058072734
438	380	1	0	1	55.6497708968
438	382	3	0	3	18.8757032984
438	385	2	0	2	45.7274696558
438	386	1	0	1	44.4241959772
438	390	1	0	1	42.730249286
438	392	0	0	0	48.1278501067
438	394	2	0	2	35.1416227773
438	396	10	2	8	34.6330326137
438	397	2	0	2	38.068242563
438	398	16	0	16	11.8290149378
438	400	1	0	1	22.6617835586
438	401	5	0	5	20.5056752818
438	402	2	0	2	20.3485529927
438	403	1	0	1	28.7005983387
438	404	3	0	3	22.3151351132
438	405	3	1	2	20.5161770986
438	406	29	2	27	29.6800254897
438	408	176	3	173	26.4196325299
438	409	1	0	1	31.9615298933
438	410	2	0	2	29.9508401569
438	411	14	1	13	28.04227958
438	412	7	0	7	20.2728256536
438	413	15	5	10	15.1351124626
438	414	7	1	6	32.3150091621
438	415	7	0	7	35.4058646651
438	416	7	0	7	25.1420898853
438	417	6	2	4	33.1548849624
438	419	6	0	6	15.5426404352
438	420	1	0	1	26.3488291215
438	421	11	1	10	25.4322708833
438	422	2	0	2	17.626970318
438	423	1	0	1	32.7658092351
438	424	6	0	6	24.2441008571
438	425	19	9	10	15.799812614
438	426	32	19	13	23.8648742767
438	427	26	0	26	20.2795902255
438	428	32	9	23	9.60347584856
438	431	8	1	7	16.2704063719
438	432	3	0	3	25.0829324041
438	433	58	9	49	13.1573164365
438	435	32	9	23	12.1966892951
438	436	5	0	5	28.1117427456
438	437	4	0	4	27.5881202155
438	439	33	18	15	8.92368718094
438	440	13	2	11	8.5981345463
438	441	82	21	61	5.48217078248
438	442	302	71	231	12.565751307
438	443	9	0	9	18.2526861171
438	444	26	3	23	21.900252646
438	445	4	2	2	12.8980927541
438	447	2	0	2	28.7950933914
438	448	5	1	4	21.2346363643
438	455	1	0	1	60.0899266689
438	460	7	5	2	49.0452227887
438	461	1	0	1	61.7273769149
438	469	1	0	1	64.8544556941
438	475	2	0	2	60.0887406011
438	499	1	0	1	49.9597185795
438	503	1	0	1	43.8065001757
438	505	1	0	1	56.8467711106
438	506	1	0	1	30.5565741497
438	507	2	0	2	88.7822686651
438	516	9	2	7	21.646386798
438	520	1	0	1	29.5595795437
438	523	2	0	2	38.7192952282
438	524	2	0	2	47.2617168461
438	528	1	0	1	24.9889038126
438	536	1	0	1	81.4995607268
438	555	1	0	1	70.0781394956
438	573	9	0	9	70.4162927684
438	581	1	0	1	82.4064638792
438	583	0	0	0	109.760945417
439	1	0	0	0	145.017071397
439	50	2	0	2	115.002062184
439	70	0	0	0	126.123254138
439	73	8	0	8	122.620786716
439	74	1	0	1	119.641057487
439	75	4	0	4	120.282881484
439	76	0	0	0	123.48649899
439	78	4	0	4	120.337841026
439	79	1	0	1	126.479710831
439	82	1	0	1	122.749951871
439	84	2	0	2	121.435743345
439	85	2	0	2	120.109275574
439	87	2	0	2	117.884631091
439	88	1	0	1	116.412648777
439	92	1	0	1	130.968797703
439	113	1	0	1	115.454888136
439	154	1	0	1	93.2617683121
439	155	2	0	2	116.855291635
439	171	1	0	1	114.563161684
439	172	1	0	1	102.001941521
439	177	4	0	4	102.47913984
439	319	1	0	1	107.95733353
439	323	1	0	1	100.7700363
439	351	1	0	1	131.495382793
439	373	1	0	1	169.927768905
439	382	3	0	3	23.9206759656
439	385	1	0	1	53.0104496203
439	386	0	0	0	51.2010757317
439	394	1	0	1	43.2306043548
439	396	2	0	2	43.5555334448
439	397	3	0	3	46.978859937
439	398	7	2	5	18.7314945251
439	399	1	0	1	45.9454349954
439	400	1	0	1	31.5447941007
439	401	4	0	4	29.3795685645
439	405	2	0	2	29.3906825029
439	406	10	0	10	38.5366453387
439	408	98	19	79	35.3413828995
439	409	2	1	1	40.6001933194
439	410	2	0	2	38.8211440629
439	411	2	0	2	36.7041243846
439	412	2	0	2	28.8912045259
439	413	1	0	1	23.5920327288
439	414	2	0	2	40.6689375094
439	415	5	0	5	44.1672755225
439	416	2	0	2	33.6699960297
439	419	5	0	5	24.4662616218
439	420	4	1	3	17.700158556
439	421	1	0	1	32.4734031873
439	423	6	1	5	25.3329031493
439	424	14	11	3	18.5896196903
439	425	18	8	10	22.7486749909
439	426	12	1	11	24.5779273352
439	427	9	2	7	28.2484254437
439	428	7	1	6	12.7314936741
439	429	3	1	2	33.7971643669
439	430	11	4	7	17.1940266782
439	431	9	2	7	21.727480361
439	432	1	0	1	29.3134639902
439	433	303	3	300	6.15476033393
439	434	1	0	1	24.8441165764
439	435	14	0	14	20.7312958154
439	437	19	3	16	18.7034402125
439	438	111	46	65	8.92368718094
439	440	31	9	22	11.3434906278
439	441	10	3	7	14.3833807711
439	442	109	28	81	19.8205177075
439	443	39	6	33	12.8392095273
439	444	9	2	7	27.5107081464
439	445	55	27	28	8.4666181721
439	446	1	0	1	25.5569638202
439	447	1	0	1	34.3900424982
439	448	3	0	3	28.1120263522
439	454	1	0	1	61.6812847121
439	459	2	0	2	46.7675635967
439	469	0	0	0	73.6800993155
439	475	2	0	2	68.9858280545
439	496	0	0	0	61.3363370768
439	507	1	0	1	83.2784245242
439	509	1	0	1	94.4974627104
439	512	1	0	1	46.7159683767
439	516	35	12	23	16.0581331725
439	517	1	0	1	59.1819958685
439	518	8	2	6	25.1234473656
439	521	1	0	1	31.3668208783
439	528	1	0	1	25.2993994636
439	531	1	0	1	78.2870806559
439	540	3	1	2	64.7399522353
439	549	1	0	1	79.6053572559
439	553	1	0	1	86.5626042545
439	554	2	0	2	61.5128838645
439	573	3	0	3	77.0407644685
439	585	2	0	2	95.9087045133
440	1	0	0	0	137.260837859
440	54	1	0	1	100.588826531
440	73	8	0	8	112.900478507
440	74	5	0	5	109.748881251
440	75	1	0	1	110.594000816
440	78	1	0	1	110.370494587
440	81	2	0	2	115.642702858
440	82	1	0	1	112.776024437
440	84	2	0	2	111.675400178
440	85	0	0	0	109.970305454
440	86	1	0	1	106.073800433
440	87	2	0	2	108.121055053
440	113	1	0	1	105.906047338
440	154	1	0	1	83.6769960841
440	172	1	0	1	91.7677534298
440	177	1	0	1	91.9862205508
440	319	1	0	1	96.6704594315
440	338	2	0	2	129.501862406
440	367	1	0	1	110.255277603
440	381	1	0	1	32.7895328835
440	382	11	2	9	12.5933925381
440	389	0	0	0	23.9126721156
440	390	1	0	1	41.5911841114
440	391	1	0	1	44.3728307637
440	392	1	0	1	45.349504071
440	394	1	0	1	33.4141660201
440	396	5	0	5	36.8672258316
440	398	23	12	11	8.7863119383
440	399	1	0	1	41.9082489586
440	401	6	0	6	22.5212694108
440	402	4	0	4	17.4995706889
440	404	7	0	7	21.7021016631
440	406	15	0	15	33.2717239057
440	408	133	0	133	28.8925026489
440	409	2	0	2	36.525996111
440	410	3	1	2	31.4748654282
440	411	10	4	6	28.3663444392
440	412	3	1	2	25.3979786954
440	413	12	0	12	15.4815545204
440	414	1	0	1	37.6442883515
440	415	4	1	3	36.0088504214
440	416	2	0	2	30.2858058053
440	418	1	0	1	26.6628370317
440	422	1	0	1	26.1192429675
440	424	1	0	1	29.7723672747
440	425	1	0	1	23.5073547995
440	426	3	0	3	32.2349792589
440	427	2	0	2	26.7453436561
440	428	5	1	4	18.0920297438
440	430	19	5	14	11.2063316119
440	431	2	0	2	24.6283769673
440	433	25	0	25	17.4224014465
440	434	1	0	1	20.4712003397
440	437	1	0	1	26.8762113259
440	438	37	18	19	8.5981345463
440	439	28	4	24	11.3434906278
440	441	18	0	18	11.395180707
440	442	38	2	36	20.2460307124
440	443	3	0	3	23.858601948
440	444	1	0	1	30.0842263847
440	445	17	1	16	8.37253686259
440	451	1	0	1	44.0084664892
440	458	1	0	1	44.6800361282
440	460	2	0	2	49.1967525644
440	512	2	0	2	43.7411753065
440	515	1	0	1	29.4169973511
440	516	19	0	19	15.9627494521
440	518	2	0	2	25.2989698468
440	520	4	0	4	22.6205334576
440	524	3	0	3	39.150620897
440	526	1	0	1	29.0078511984
440	528	2	1	1	16.3930973953
440	529	1	0	1	73.1403243575
440	543	1	0	1	86.4093487348
440	551	0	0	0	70.8289902294
440	563	1	0	1	61.548837699
440	573	4	1	3	65.8473023414
440	581	1	0	1	78.7887950463
440	585	1	0	1	84.6311394345
441	1	2	0	2	130.713082029
441	70	2	0	2	113.178938437
441	71	0	0	0	102.823976999
441	73	35	1	34	109.34340126
441	74	5	1	4	106.546928766
441	75	2	0	2	106.981095706
441	78	3	0	3	107.325837598
441	79	1	0	1	113.228039121
441	80	1	0	1	112.328206711
441	81	2	0	2	112.413304652
441	82	5	0	5	109.739082291
441	83	1	0	1	108.986397039
441	84	2	0	2	108.200221848
441	85	1	0	1	107.307964416
441	86	1	0	1	103.225295835
441	87	2	0	2	104.661239062
441	88	1	0	1	103.264387233
441	90	1	0	1	110.227325445
441	98	1	0	1	100.37219201
441	103	3	0	3	106.149865774
441	110	0	0	0	103.501943288
441	112	1	0	1	108.070215661
441	113	1	0	1	102.03849733
441	142	2	0	2	88.5930003934
441	154	1	0	1	79.9483797787
441	161	0	0	0	76.1017351534
441	162	1	0	1	111.165329746
441	163	2	0	2	71.7888202623
441	165	1	0	1	85.5365382508
441	166	1	0	1	105.415512027
441	168	4	0	4	94.1468914412
441	169	1	0	1	116.599642344
441	176	1	0	1	63.5473061898
441	177	3	0	3	90.2852878763
441	307	1	0	1	140.406446263
441	319	2	0	2	98.412578311
441	323	1	0	1	90.4802793295
441	329	1	0	1	109.997238697
441	351	0	0	0	121.051496978
441	375	0	0	0	170.652907758
441	382	2	0	2	18.0253514876
441	383	2	0	2	20.2645490718
441	385	3	0	3	42.0305490129
441	386	1	0	1	41.1784705325
441	387	1	0	1	36.7792767853
441	391	2	0	2	41.6672975422
441	392	1	0	1	44.0492865772
441	393	1	0	1	22.6821019587
441	394	1	0	1	30.7798115871
441	396	17	3	14	29.2086371686
441	397	5	3	2	32.6839784999
441	398	28	13	15	10.0749439769
441	400	2	0	2	17.1796323692
441	401	19	1	18	15.2393860407
441	402	6	0	6	17.1051055282
441	403	1	0	1	23.8087504599
441	404	5	0	5	17.8514921294
441	405	8	0	8	15.0344363886
441	406	45	19	26	24.1999227985
441	407	2	0	2	29.8163997027
441	408	364	61	303	21.0042400524
441	409	2	0	2	26.5759908092
441	410	5	2	3	24.6598232167
441	411	22	0	22	23.0753312661
441	412	16	6	10	14.938680667
441	413	40	19	21	10.7434564766
441	414	11	0	11	27.1070696545
441	415	14	0	14	30.268924182
441	416	10	4	6	19.8474081853
441	417	5	0	5	28.3016656064
441	419	11	6	5	10.1210922626
441	420	1	0	1	31.6024936973
441	421	24	2	22	21.3191065445
441	422	6	0	6	18.00209996
441	423	1	0	1	37.3603536002
441	424	5	0	5	28.1751224415
441	425	79	3	76	12.2475335452
441	426	26	1	25	24.4382490495
441	427	72	5	67	15.5048118635
441	428	22	0	22	10.778294604
441	429	5	0	5	27.2728693358
441	430	4	0	4	22.5975110394
441	431	21	0	21	14.0867730586
441	432	3	1	2	23.1867419232
441	433	38	2	36	18.1001201039
441	434	1	0	1	10.5293416395
441	435	98	1	97	7.07670045952
441	436	4	0	4	27.6732577822
441	437	1	0	1	33.0669703624
441	438	336	33	303	5.48217078248
441	439	25	0	25	14.3833807711
441	440	16	1	15	11.395180707
441	442	847	349	498	9.04165086865
441	443	9	1	8	22.3523373375
441	444	43	0	43	19.1129408805
441	445	8	0	8	17.703042118
441	447	2	0	2	25.7175349943
441	448	26	3	23	17.4063654609
441	453	2	0	2	33.9637522292
441	454	1	0	1	48.2984076534
441	455	2	0	2	55.360142385
441	460	2	0	2	43.9315117125
441	462	1	0	1	43.2860427716
441	472	1	0	1	70.0485744993
441	475	1	0	1	54.7241123564
441	482	1	0	1	71.4774744174
441	499	1	0	1	44.5105683393
441	502	4	0	4	36.4961256083
441	503	2	0	2	38.3247475853
441	506	4	0	4	26.1771976992
441	507	0	0	0	92.8655312472
441	512	5	0	5	55.120549654
441	516	1	0	1	26.3397501578
441	520	0	0	0	28.633734446
441	524	3	1	2	47.4224674298
441	525	1	0	1	52.7765876085
441	528	2	0	2	26.9202741791
441	540	1	0	1	68.7258763444
441	554	3	0	3	56.0803390631
441	569	1	0	1	75.6280757908
441	571	0	0	0	54.9740050683
441	573	7	0	7	67.1047493146
441	575	1	0	1	71.6440039067
441	581	4	0	4	78.5240874832
442	1	7	0	7	128.318578421
442	3	1	0	1	119.207982807
442	49	1	0	1	103.144333299
442	59	1	1	0	87.8283932593
442	65	1	0	1	105.174441061
442	70	9	0	9	114.130783772
442	71	6	0	6	103.714825035
442	72	2	0	2	115.03646097
442	73	173	0	173	109.77969944
442	74	15	0	15	107.302788123
442	75	16	0	16	107.387983025
442	76	4	0	4	111.621157192
442	77	1	0	1	114.270108705
442	78	13	0	13	108.206327544
442	79	3	0	3	113.688220904
442	80	1	0	1	112.941610482
442	81	6	0	6	113.102794993
442	82	18	1	17	110.607776706
442	83	3	0	3	109.60089748
442	84	33	1	32	108.714277324
442	85	4	0	4	108.502590298
442	86	3	0	3	104.300305956
442	87	15	1	14	105.215948738
442	88	3	0	3	103.952234859
442	89	1	0	1	121.626951578
442	90	1	0	1	111.84519126
442	92	2	0	2	118.802636263
442	98	1	0	1	101.708460517
442	103	2	0	2	106.188094197
442	109	0	0	0	116.497002765
442	110	2	0	2	103.250000228
442	111	1	0	1	124.209725133
442	112	8	0	8	107.891100971
442	113	3	0	3	102.268112023
442	116	1	0	1	112.196985622
442	120	1	0	1	115.402274653
442	131	2	0	2	72.7429774074
442	141	4	0	4	59.8185798418
442	142	6	1	5	88.1617760063
442	144	1	0	1	87.1349380434
442	147	1	0	1	69.884335476
442	154	1	0	1	80.5354137719
442	155	2	0	2	107.134061925
442	163	1	0	1	72.7436302671
442	164	2	0	2	100.271587197
442	166	2	0	2	108.373607943
442	168	3	0	3	95.7794630133
442	169	1	0	1	118.825241229
442	170	0	0	0	94.6831803992
442	171	3	0	3	104.130980287
442	172	7	1	6	90.9911460405
442	173	0	0	0	87.8124263743
442	177	6	1	5	92.4000945858
442	180	1	0	1	82.7140541235
442	183	2	0	2	199.622909201
442	242	0	0	0	231.112758172
442	277	2	0	2	159.975232627
442	282	1	0	1	155.664179435
442	310	1	0	1	147.911344618
442	319	14	0	14	102.949268038
442	320	2	0	2	97.4078160184
442	321	2	1	1	108.605918457
442	322	0	0	0	94.8593011721
442	329	1	0	1	113.38405838
442	338	4	0	4	134.815106888
442	341	1	0	1	146.448676924
442	349	2	0	2	121.558698233
442	361	0	0	0	117.821324047
442	375	3	0	3	173.619915982
442	379	4	1	3	39.3904702514
442	380	1	0	1	54.1965736518
442	381	1	1	0	42.1592494491
442	382	3	0	3	26.3481706088
442	383	2	0	2	27.4966472681
442	385	22	1	21	46.2633427634
442	386	1	0	1	46.2440442987
442	388	1	0	1	33.7877914749
442	389	2	0	2	32.3694364969
442	391	3	0	3	44.0790969608
442	392	2	0	2	47.4239675519
442	394	3	0	3	33.915519743
442	396	66	16	50	27.6787748842
442	397	10	0	10	31.4190912141
442	398	20	13	7	18.3759432003
442	399	4	0	4	27.0373952034
442	400	9	0	9	15.2739984058
442	401	44	1	43	16.4697480254
442	403	4	1	3	16.9108978695
442	404	8	1	7	21.7005615036
442	405	27	8	19	13.3368705223
442	406	181	28	153	21.2657314125
442	407	8	0	8	26.8685256747
442	408	1022	374	648	20.1920128845
442	409	11	0	11	21.957398369
442	410	15	3	12	24.6005599035
442	411	63	3	60	24.7943618097
442	412	83	3	80	10.9393937489
442	413	35	7	28	15.9452523587
442	414	48	17	31	21.315674921
442	415	58	12	46	30.7453345792
442	416	54	2	52	14.9456588288
442	417	28	0	28	30.0823799675
442	418	4	2	2	27.1491666941
442	419	20	4	16	11.4150944413
442	420	1	0	1	34.7136384271
442	421	85	18	67	12.8892631349
442	422	31	0	31	12.5686304353
442	423	2	0	2	37.9784073286
442	424	30	5	25	27.672620664
442	425	569	202	367	3.26969179202
442	426	270	3	267	18.4717313929
442	427	480	174	306	8.66546192247
442	428	39	17	22	9.26494559805
442	429	18	2	16	18.4153643851
442	430	2	0	2	31.3608308405
442	431	223	103	120	5.75929917898
442	432	31	5	26	14.5614469582
442	433	85	31	54	21.0792603885
442	434	6	3	3	9.54290974381
442	435	217	49	168	5.13208885135
442	436	59	34	25	20.2207608668
442	437	12	1	11	37.897551392
442	438	293	17	276	12.565751307
442	439	44	0	44	19.8205177075
442	440	13	0	13	20.2460307124
442	441	199	0	199	9.04165086865
442	443	16	3	13	22.7651815732
442	444	338	27	311	10.1129518754
442	445	8	0	8	25.4357420109
442	446	1	0	1	45.3603903031
442	447	67	3	64	16.6808398074
442	448	116	57	59	8.67040829367
442	450	1	0	1	50.7597887213
442	451	1	0	1	35.9838799237
442	453	2	0	2	33.9437439724
442	455	4	2	2	56.7235758287
442	459	5	0	5	35.7749876807
442	460	9	2	7	44.022367619
442	465	0	0	0	48.1572441074
442	466	3	0	3	49.916698946
442	469	3	0	3	55.3535917049
442	475	2	0	2	53.0688013928
442	480	1	0	1	63.1357543448
442	503	2	0	2	35.1631097834
442	506	8	3	5	18.0999110779
442	507	2	0	2	101.328054985
442	509	1	0	1	112.535100761
442	512	6	0	6	63.7610657983
442	515	1	0	1	49.4805832351
442	516	7	3	4	34.1832229251
442	520	4	0	4	36.6124860605
442	524	7	1	6	55.8722057833
442	528	2	0	2	35.9595811097
442	535	1	0	1	87.2633577706
442	536	2	0	2	91.4864434431
442	537	2	0	2	71.2203838261
442	540	2	0	2	77.7641084684
442	548	2	0	2	114.699238973
442	555	1	0	1	75.3613189184
442	561	1	0	1	68.6700231348
442	562	1	0	1	50.1363939028
442	566	4	3	1	58.2231249711
442	567	2	1	1	66.1011678405
442	569	0	0	0	80.343830488
442	571	2	0	2	60.3203449007
442	573	47	11	36	71.6605786831
442	577	1	0	1	89.4703265085
442	578	1	0	1	62.2363607856
442	579	1	0	1	85.1234358446
442	581	4	0	4	81.8579656192
442	585	1	0	1	94.9989090146
443	1	1	0	1	151.082343683
443	17	1	0	1	134.954557917
443	48	1	0	1	112.032602957
443	70	1	0	1	135.454039131
443	73	9	0	9	131.487724864
443	74	2	0	2	128.776459648
443	78	0	0	0	129.583636707
443	82	2	0	2	131.995774083
443	84	2	0	2	130.367011578
443	85	0	0	0	129.620076638
443	86	1	0	1	125.517350346
443	88	1	0	1	125.474981193
443	113	1	0	1	124.108248857
443	144	1	0	1	108.925896422
443	153	1	0	1	94.2821113619
443	177	0	0	0	112.629097631
443	220	1	0	1	239.503389822
443	277	0	0	0	181.960919993
443	314	0	0	0	165.964552754
443	319	1	0	1	119.780882375
443	338	0	0	0	152.418666537
443	381	1	0	1	56.1257020408
443	382	1	0	1	36.1985832372
443	385	0	0	0	63.9720182326
443	396	5	0	5	50.097197173
443	398	2	0	2	29.9470617535
443	405	2	0	2	35.4777388565
443	406	7	1	6	43.9624797461
443	407	2	0	2	49.6037448329
443	408	46	0	46	42.1911617188
443	409	1	0	1	44.6414533377
443	410	1	0	1	46.3046328656
443	411	3	1	2	45.290426909
443	412	1	0	1	33.6360976021
443	413	2	0	2	33.023314345
443	415	4	0	4	52.2096631627
443	416	1	0	1	37.6755524869
443	420	25	0	25	13.5848044164
443	421	2	0	2	32.7813949564
443	422	1	0	1	14.5830886783
443	423	24	0	24	15.3097175703
443	424	73	0	73	6.01695070231
443	425	6	3	3	24.4397385732
443	426	84	45	39	16.4503019006
443	427	8	3	5	31.1181202518
443	428	5	1	4	13.5338239305
443	429	3	0	3	29.2762021656
443	430	1	0	1	29.5314683901
443	431	3	0	3	21.231071481
443	432	1	0	1	25.2442545912
443	433	419	101	318	6.78859726363
443	435	2	1	1	26.1890192669
443	436	9	1	8	22.5408372568
443	437	53	13	40	19.4990831411
443	438	26	0	26	18.2526861171
443	439	27	5	22	12.8392095273
443	440	0	0	0	23.858601948
443	441	10	0	10	22.3523373375
443	442	61	2	59	22.7651815732
443	444	10	1	9	25.9418791458
443	445	7	0	7	20.6790379312
443	447	2	0	2	31.8089146587
443	448	3	1	2	28.6762090297
443	460	1	0	1	65.8224515958
443	471	1	0	1	95.3142423545
443	503	1	0	1	57.927931886
443	507	0	0	0	90.6553471082
443	512	4	1	3	55.9645948012
443	513	1	0	1	55.899891011
443	516	9	0	9	26.2268454114
443	518	3	0	3	33.5835343514
443	526	0	0	0	50.8626655723
443	534	1	0	1	82.9215096418
443	537	1	0	1	72.7543090595
443	540	1	0	1	76.100081386
443	555	2	0	2	87.1029541442
443	573	3	0	3	88.6334761819
443	581	1	0	1	100.631615801
443	586	1	0	1	113.885688274
444	0	1	0	1	120.983312414
444	1	1	0	1	127.685042034
444	70	2	0	2	117.301219758
444	72	0	0	0	117.882442061
444	73	24	1	23	112.436012319
444	74	3	0	3	110.316328567
444	75	3	0	3	110.031244674
444	76	0	0	0	114.894361229
444	78	1	0	1	111.343982174
444	82	3	0	3	113.715428054
444	83	1	0	1	112.447822901
444	85	1	0	1	111.965792817
444	87	4	0	4	108.033496177
444	95	1	0	1	114.199158437
444	96	2	0	2	120.118937583
444	103	1	0	1	108.445732405
444	109	1	0	1	120.083915955
444	113	1	0	1	104.7642579
444	140	1	0	1	99.6043826859
444	155	1	0	1	111.691419725
444	163	1	0	1	76.3457740903
444	168	2	0	2	99.7948599117
444	172	1	0	1	95.0130885326
444	177	3	0	3	96.9299152688
444	222	0	0	0	213.100794352
444	312	1	0	1	160.428283041
444	319	1	0	1	109.709400841
444	338	0	0	0	140.967399244
444	358	1	0	1	133.901977784
444	379	2	2	0	45.9706837105
444	385	1	0	1	53.3946346387
444	386	1	0	1	54.0221330103
444	389	1	0	1	41.3596643083
444	391	2	0	2	49.746012095
444	396	11	0	11	30.59885357
444	397	3	1	2	34.2622122308
444	398	2	0	2	28.4022188456
444	400	4	0	4	19.9558398367
444	401	2	1	1	23.3995863841
444	403	1	0	1	14.2011916749
444	405	1	0	1	18.7771211818
444	406	24	0	24	23.5242413147
444	407	4	1	3	28.2851204062
444	408	158	0	158	24.8368112633
444	409	3	0	3	21.9347040622
444	410	3	1	2	29.3152318435
444	411	8	0	8	30.9903628315
444	412	10	1	9	15.0602516846
444	413	2	1	1	25.0690011042
444	414	10	3	7	19.6218838917
444	415	10	0	10	35.3652981711
444	416	7	3	4	16.2730246615
444	417	5	1	4	35.8954145429
444	419	2	0	2	19.4907938874
444	421	37	4	33	7.43062713416
444	422	44	2	42	11.6453582977
444	424	6	0	6	29.2275719131
444	425	33	12	21	7.15101391022
444	426	480	192	288	14.431233665
444	427	52	3	49	10.2105082773
444	428	2	0	2	14.886984506
444	429	45	17	28	8.44803639892
444	431	44	1	43	5.80296436788
444	432	94	12	82	5.41368941897
444	433	9	0	9	26.8085912371
444	435	9	6	3	14.2689626464
444	436	63	58	5	13.0600628667
444	438	21	4	17	21.900252646
444	441	5	1	4	19.1129408805
444	442	232	40	192	10.1129518754
444	443	2	0	2	25.9418791458
444	447	74	2	72	6.94177506116
444	448	25	11	14	4.89032966471
444	458	1	0	1	42.2275327702
444	460	0	0	0	47.5005870577
444	475	2	0	2	54.333018363
444	503	1	0	1	35.5357520426
444	505	1	0	1	38.6088171987
444	506	10	2	8	12.245235517
444	516	0	0	0	42.989122777
444	555	1	0	1	84.2372553012
444	573	5	0	5	78.666698935
444	577	0	0	0	96.2421703837
444	580	1	0	1	81.1094311026
444	581	0	0	0	87.6629475719
444	585	1	0	1	103.213735806
445	1	2	0	2	145.632995321
445	70	2	0	2	124.033193258
445	73	7	0	7	120.9884085
445	82	1	0	1	120.757416337
445	83	1	0	1	120.382812159
445	87	1	0	1	116.195748042
445	163	2	0	2	83.3559191132
445	177	0	0	0	99.6727227019
445	382	3	1	2	19.5177950713
445	385	0	0	0	49.7849172451
445	389	0	0	0	31.243108178
445	391	1	0	1	52.4896599927
445	396	1	0	1	45.0724087105
445	398	1	0	1	17.1445973823
445	401	1	0	1	30.6685975598
445	405	2	0	2	32.0659846396
445	406	4	0	4	41.1226666888
445	408	47	0	47	37.0073612094
445	409	2	0	2	44.0329064544
445	411	6	0	6	36.7350510222
445	413	4	1	3	23.7780332925
445	414	1	0	1	44.7808313138
445	415	1	0	1	44.3773857648
445	416	3	0	3	37.4764357686
445	417	2	0	2	41.2099032156
445	418	0	0	0	34.9622010911
445	424	2	0	2	25.9795966563
445	425	1	0	1	28.6396219459
445	426	1	0	1	32.9603666025
445	427	3	0	3	33.0842796997
445	428	3	0	3	20.2347163053
445	430	19	14	5	8.86086578753
445	431	1	0	1	28.5845513019
445	433	64	9	55	13.9193392402
445	437	2	1	1	18.8263472897
445	438	17	0	17	12.8980927541
445	439	63	12	51	8.4666181721
445	440	38	16	22	8.37253686259
445	441	2	0	2	17.703042118
445	442	12	0	12	25.4357420109
445	443	10	0	10	20.6790379312
445	446	1	0	1	22.5842893766
445	447	1	0	1	41.3014102491
445	448	2	0	2	34.0894062323
445	453	1	0	1	48.2758282202
445	460	1	0	1	57.5601402217
445	512	2	0	2	38.908393466
445	515	1	0	1	24.9420217061
445	516	30	1	29	8.749497355
445	518	8	4	4	18.3453961206
445	520	1	0	1	28.1003853213
445	528	1	0	1	17.4373279196
445	540	1	0	1	56.2783080372
445	554	1	0	1	54.9651511093
445	573	1	0	1	72.6357361586
445	581	0	0	0	86.0735078566
446	73	1	0	1	142.429449508
446	76	1	0	1	142.353552465
446	78	0	0	0	139.513901406
446	85	0	0	0	138.788346523
446	142	0	0	0	123.738433669
446	162	1	0	1	138.919665197
446	177	0	0	0	120.106657877
446	277	0	0	0	193.04972438
446	307	1	0	1	176.027087641
446	345	1	0	1	209.72700237
446	408	5	0	5	59.4840646315
446	411	1	0	1	59.286338568
446	420	16	0	16	16.9992460254
446	423	9	0	9	26.5424872639
446	424	10	0	10	30.1828224753
446	425	1	0	1	48.2133337464
446	426	36	3	33	45.277420203
446	431	1	0	1	46.6920633859
446	433	13	4	9	25.6155271361
446	436	7	0	7	51.3575131854
446	437	179	40	139	9.55893147243
446	441	0	0	0	39.2926242756
446	442	1	0	1	45.3603903031
446	443	1	0	1	28.8547493334
446	516	4	0	4	16.4566337982
446	518	5	1	4	12.986882401
446	521	0	0	0	39.4455970484
446	528	1	0	1	32.051848706
446	540	0	0	0	55.7767134521
446	581	0	0	0	105.628504224
447	1	1	0	1	124.820123107
447	9	1	0	1	121.9860343
447	48	1	0	1	83.4971479491
447	71	1	0	1	106.696057914
447	73	7	1	6	111.833701542
447	74	1	0	1	109.976224944
447	75	3	1	2	109.431102614
447	78	2	0	2	111.087282542
447	81	1	0	1	115.558279244
447	82	4	0	4	113.426493446
447	95	1	0	1	113.119266605
447	113	3	0	3	104.087708285
447	129	1	1	0	101.504682802
447	141	1	0	1	62.5482875758
447	142	1	0	1	89.1068055818
447	156	1	0	1	117.396294284
447	158	1	0	1	98.3481330504
447	163	1	0	1	76.6589471984
447	177	1	0	1	97.7610447571
447	277	1	0	1	160.724123499
447	281	0	0	0	154.110465677
447	379	0	0	0	48.9001564473
447	396	3	1	2	31.570226517
447	397	1	0	1	34.9793347747
447	399	3	0	3	24.2738903819
447	400	4	1	3	22.9640769719
447	401	5	0	5	27.4129094325
447	403	1	0	1	13.4004729276
447	405	2	0	2	22.3590638218
447	406	14	0	14	24.6245579521
447	407	1	0	1	28.4001551124
447	408	76	9	67	27.3411135452
447	409	3	0	3	21.674208044
447	410	2	0	2	31.5523240242
447	411	5	1	4	34.1137464115
447	412	9	2	7	18.5184200071
447	414	9	0	9	18.4748496542
447	415	7	0	7	37.2355321347
447	416	5	0	5	17.8489843948
447	417	1	0	1	38.558545902
447	419	3	0	3	24.4408529079
447	421	73	69	4	7.43879117283
447	422	15	6	9	17.2259353672
447	423	3	0	3	44.813987184
447	424	1	0	1	34.3615183609
447	425	13	2	11	13.4838531644
447	426	351	138	213	17.8836078909
447	427	33	0	33	13.7573249912
447	428	1	0	1	21.7016882364
447	429	194	74	120	5.3170355442
447	431	7	3	4	12.7354010825
447	432	93	3	90	6.95342070937
447	433	4	0	4	33.3633432586
447	435	4	0	4	20.1501161715
447	436	88	29	59	14.076360146
447	437	2	1	1	50.3771242415
447	438	3	0	3	28.7950933914
447	439	1	0	1	34.3900424982
447	440	0	0	0	36.8689964483
447	441	4	1	3	25.7175349943
447	442	89	5	84	16.6808398074
447	443	3	1	2	31.8089146587
447	444	224	55	169	6.94177506116
447	445	1	0	1	41.3014102491
447	448	20	4	16	8.9373736167
447	455	1	0	1	62.0682775525
447	458	1	0	1	43.0643358896
447	460	0	0	0	48.1835612825
447	466	1	0	1	41.706615368
447	469	1	0	1	50.7114292174
447	472	1	1	0	61.569595632
447	475	0	0	0	53.3284600629
447	476	1	0	1	71.7557089858
447	485	1	0	1	43.5071151113
447	491	1	0	1	52.0047984501
447	495	1	0	1	33.4467661185
447	503	2	0	2	34.5000873642
447	506	13	8	5	9.16245720176
447	511	0	0	0	123.942093586
447	521	1	0	1	55.162847438
447	554	0	0	0	77.4201812309
447	573	3	0	3	81.5321998296
447	579	1	0	1	94.1978744671
448	73	11	0	11	107.683053855
448	74	3	0	3	105.523137746
448	75	1	0	1	105.278846619
448	78	1	0	1	106.538931132
448	80	1	0	1	110.992486603
448	82	2	0	2	108.914044401
448	83	2	0	2	107.673024945
448	84	2	0	2	106.697371577
448	85	0	0	0	107.132530343
448	86	1	0	1	102.844205147
448	87	2	0	2	103.260213359
448	92	1	0	1	117.032439196
448	96	1	0	1	115.246071138
448	98	1	0	1	100.520938133
448	112	1	0	1	105.232606798
448	113	1	1	0	100.027475661
448	142	3	0	3	85.4203606951
448	155	1	0	1	106.803963487
448	166	1	0	1	108.726762052
448	172	1	0	1	90.140706949
448	177	4	0	4	92.0419341445
448	272	1	0	1	169.291548512
448	318	1	0	1	113.989702819
448	319	1	0	1	104.948136868
448	338	0	0	0	136.127279636
448	382	0	0	0	33.448534675
448	385	2	0	2	48.7609063673
448	391	2	1	1	44.9085737192
448	392	1	0	1	49.0582201804
448	396	6	1	5	25.7300325408
448	398	3	1	2	25.7512962654
448	400	6	3	3	15.1717384791
448	401	6	0	6	18.956916373
448	403	3	0	3	10.1163665854
448	405	8	3	5	14.1338756656
448	406	46	1	45	18.6647715422
448	407	1	0	1	23.5382085039
448	408	170	13	157	19.9953106791
448	409	11	7	4	17.3446900929
448	410	1	0	1	24.4560768838
448	411	3	1	2	26.2859528663
448	412	24	12	12	10.3370860638
448	414	17	6	11	15.3903854081
448	415	3	1	2	30.4868109066
448	416	17	4	13	11.4109605294
448	417	5	0	5	31.1080734248
448	419	0	0	0	15.5693181501
448	421	124	71	53	4.37303014418
448	422	7	0	7	15.2116628915
448	424	2	0	2	32.5946481906
448	425	60	17	43	5.45289440068
448	426	37	6	31	18.9758779422
448	427	147	30	117	5.42184117968
448	428	2	0	2	16.2035280414
448	429	9	2	7	12.417183859
448	430	1	0	1	39.9423819964
448	431	24	19	5	7.44588477239
448	432	16	0	16	10.2009505678
448	433	5	0	5	28.4656538877
448	434	3	0	3	12.861368138
448	435	17	6	11	11.3168541174
448	436	6	1	5	17.9503913095
448	437	2	0	2	45.5878447344
448	438	15	0	15	21.2346363643
448	439	2	0	2	28.1120263522
448	441	7	0	7	17.4063654609
448	442	289	98	191	8.67040829367
448	444	93	0	93	4.89032966471
448	445	1	0	1	34.0894062323
448	447	32	13	19	8.9373736167
448	451	1	0	1	33.7556562044
448	460	1	0	1	42.631688922
448	468	1	0	1	63.1723543513
448	506	6	0	6	9.74275540163
448	516	1	0	1	42.8324131726
448	524	2	0	2	62.7224830661
448	544	0	0	0	121.221558378
448	554	0	0	0	68.6556762821
448	569	1	0	1	82.7130736494
448	573	5	0	5	73.9663525654
448	581	0	0	0	82.8083842145
448	585	1	0	1	98.8012189317
449	1	0	0	0	84.2948377208
449	59	0	0	0	59.0450527211
449	70	4	1	3	65.5168260621
449	73	71	0	71	61.1616610721
449	74	3	0	3	58.6577764739
449	75	6	0	6	58.7762826153
449	76	1	0	1	63.0367548366
449	78	11	2	9	59.5807126646
449	81	2	0	2	64.4536635414
449	82	10	0	10	61.9775310272
449	83	3	1	2	60.9538508161
449	84	5	0	5	60.0789041497
449	85	3	0	3	60.0005254604
449	87	6	0	6	56.5731134553
449	88	2	0	2	55.3036487127
449	95	1	0	1	63.9553224485
449	103	3	0	3	57.7542066812
449	109	1	0	1	68.0761831276
449	110	6	0	6	55.0608555479
449	113	4	0	4	53.719241855
449	116	1	0	1	63.7055138434
449	141	4	2	2	11.4543545886
449	142	7	0	7	40.1950174703
449	147	2	0	2	21.9633811558
449	154	6	0	6	31.8878038087
449	155	1	0	1	59.8687750169
449	163	3	0	3	24.2899553924
449	168	2	0	2	47.7463370794
449	171	1	0	1	56.3182896133
449	172	1	0	1	42.9723475054
449	176	2	0	2	16.9617917698
449	177	2	2	0	45.171025978
449	257	1	0	1	86.000499282
449	323	1	0	1	52.7368899475
449	353	1	0	1	83.5758829641
449	377	0	0	0	111.648001944
449	379	5	0	5	18.4402237833
449	381	1	0	1	33.6809102704
449	384	1	0	1	19.4259767761
449	385	15	0	15	21.7432128083
449	386	1	0	1	26.4152154719
449	390	2	0	2	12.6666056413
449	391	6	1	5	12.6012418207
449	392	10	0	10	17.0794120174
449	394	3	0	3	20.8846656964
449	395	1	0	1	28.3352512316
449	396	18	1	17	21.4787799866
449	397	4	0	4	17.8060014897
449	399	2	0	2	29.4632843611
449	401	1	0	1	33.2826647913
449	404	2	0	2	31.7516998324
449	406	16	1	15	28.54152547
449	407	6	0	6	24.1990760279
449	408	143	10	133	28.461818789
449	410	4	0	4	24.1440248751
449	411	16	5	11	25.4785493385
449	412	2	0	2	38.0677792237
449	414	2	0	2	34.3468930271
449	415	18	1	17	18.199623651
449	416	1	0	1	35.7947547599
449	417	3	1	2	20.5747145413
449	422	1	0	1	60.8704684813
449	431	1	0	1	52.7685177413
449	438	2	0	2	53.5071738139
449	442	4	1	3	48.6491320083
449	444	1	0	1	52.0654061921
449	450	3	0	3	10.5273160944
449	451	3	0	3	13.6605671029
449	453	3	0	3	14.7183702069
449	454	29	3	26	4.08811156713
449	455	19	17	2	10.0690926718
449	457	9	0	9	10.3771410995
449	458	8	2	6	9.9313113778
449	460	129	51	78	4.62908713288
449	462	5	2	3	7.12446280704
449	467	8	4	4	4.42701933924
449	469	3	0	3	26.8049277451
449	470	1	0	1	26.0418934744
449	475	9	8	1	11.8612168386
449	497	1	1	0	9.45689070527
449	503	3	0	3	19.8868222037
449	566	2	1	1	26.2218201354
449	571	0	0	0	33.0290030558
449	573	8	0	8	35.7378841408
449	577	1	0	1	50.1114097047
450	1	1	0	1	89.404118147
450	59	0	0	0	68.7667828993
450	70	7	0	7	64.8169049994
450	71	5	1	4	54.5703665241
450	72	3	0	3	66.2951290504
450	73	100	22	78	61.5518862606
450	74	12	1	11	58.400126074
450	75	9	0	9	59.2564771053
450	76	2	0	2	62.1759151939
450	78	16	1	15	59.0528482824
450	79	2	0	2	65.3671721944
450	81	5	1	4	64.2936101669
450	82	6	1	5	61.4627098046
450	83	7	0	7	60.9756240377
450	84	23	0	23	60.3189783332
450	85	7	1	6	58.8057787026
450	86	1	0	1	54.8156008279
450	87	13	1	12	56.7649326206
450	88	2	0	2	55.2200468531
450	90	1	0	1	61.5877626708
450	92	1	0	1	69.6743353291
450	98	1	0	1	51.8175418117
450	103	3	0	3	59.0249255089
450	107	1	0	1	46.7780593295
450	110	2	0	2	57.0001917616
450	112	1	0	1	61.3157272937
450	113	9	6	3	54.6565827854
450	117	0	0	0	54.1649995467
450	128	2	0	2	35.9753325589
450	137	0	0	0	42.5424430949
450	141	2	0	2	16.6856959198
450	142	3	0	3	43.068746013
450	147	5	0	5	26.2938392567
450	154	6	1	5	32.4710942167
450	155	4	0	4	56.4188681328
450	160	2	0	2	35.7237482453
450	161	1	0	1	27.5617290638
450	163	14	3	11	23.9419404167
450	164	1	0	1	50.0904348067
450	166	1	0	1	57.7280189198
450	167	3	0	3	25.4668649829
450	168	5	2	3	45.5128020128
450	171	2	0	2	53.6267822741
450	172	6	0	6	40.7745150293
450	173	1	0	1	37.2517115924
450	174	3	0	3	18.8862919208
450	176	3	0	3	15.5249209251
450	177	14	0	14	41.7308281297
450	178	0	0	0	19.1437345725
450	180	1	0	1	31.9544200907
450	183	1	0	1	152.274479721
450	229	1	0	1	146.218937508
450	245	1	0	1	84.3681779793
450	272	1	0	1	122.126795041
450	319	15	0	15	54.9840988015
450	338	1	0	1	85.1984974529
450	341	1	0	1	96.3617212593
450	373	1	0	1	112.40812325
450	379	15	2	13	13.391740908
450	380	19	1	18	5.07595186643
450	381	1	0	1	26.0956971292
450	384	1	0	1	8.89881972563
450	385	111	25	86	12.9679427669
450	386	6	2	4	17.6513363208
450	387	2	1	1	19.0779667154
450	389	5	1	4	29.3389240151
450	390	1	1	0	10.8012691487
450	391	19	13	6	7.03131190886
450	392	32	8	24	8.01296461534
450	394	8	0	8	18.0804045912
450	395	1	0	1	22.5652542019
450	396	10	0	10	26.2406570394
450	397	3	1	2	23.2139810133
450	398	3	0	3	42.79478647
450	400	1	0	1	36.168869951
450	401	2	0	2	34.3962560562
450	402	1	0	1	33.8645879123
450	403	2	0	2	44.5349445812
450	404	1	0	1	30.8657691347
450	406	19	4	15	33.0627955862
450	407	9	1	8	30.0921771719
450	408	175	61	114	31.1741736558
450	410	6	3	3	26.6616553331
450	411	19	11	8	26.0271505264
450	412	1	0	1	41.09394709
450	415	23	1	22	20.5987856297
450	416	3	0	3	40.0024778904
450	417	12	1	11	20.6992764382
450	421	2	0	2	50.3786264058
450	425	1	0	1	51.1681210703
450	427	1	0	1	45.7770411122
450	438	1	0	1	53.1682908425
450	441	1	0	1	48.6418440103
450	442	2	0	2	50.7597887213
450	444	1	0	1	55.9563476316
450	451	1	0	1	20.3921515859
450	452	1	0	1	13.0061871463
450	453	5	3	2	18.6163395813
450	454	36	27	9	6.43972974029
450	455	172	13	159	7.78668692333
450	456	2	1	1	14.5953961377
450	457	3	2	1	18.3743760197
450	458	4	1	3	15.5986716139
450	459	9	6	3	15.0467209282
450	460	68	7	61	12.0246066217
450	461	3	0	3	8.8315061101
450	462	4	0	4	7.35195109123
450	469	1	0	1	37.3025383074
450	471	1	0	1	56.2718704553
450	475	2	0	2	22.0124921267
450	495	1	0	1	39.3249539712
450	503	1	1	0	28.1871822213
450	505	1	0	1	54.0870987561
450	507	0	0	0	114.222395783
450	520	0	0	0	37.1167879153
450	522	2	0	2	43.5978637052
450	536	1	0	1	78.7202387244
450	551	0	0	0	40.8182215372
450	554	0	0	0	38.5239196707
450	555	1	0	1	43.2576667089
450	563	1	0	1	35.4990005774
450	566	18	8	10	15.7053530295
450	568	4	2	2	18.3179489416
450	569	2	0	2	34.3232126653
450	573	62	3	59	26.08220625
450	575	1	0	1	35.0668754693
450	578	6	0	6	13.3408328246
450	579	1	0	1	37.073012295
450	580	1	0	1	25.8185079454
450	581	3	0	3	31.8319157565
450	585	1	0	1	54.4606996904
450	586	1	0	1	63.6301354584
451	70	2	0	2	78.7444117716
451	71	1	0	1	68.3342629791
451	73	16	8	8	74.0405303817
451	75	10	1	9	71.639595712
451	76	2	1	1	76.3224395833
451	78	3	0	3	72.789799913
451	82	0	0	0	75.1684058019
451	83	1	0	1	73.973179491
451	84	3	0	3	73.0245625928
451	85	1	0	1	73.3854306353
451	86	1	0	1	69.0911404695
451	87	5	0	5	69.5655259184
451	95	1	0	1	76.2536699864
451	96	1	0	1	81.677800039
451	99	1	0	1	64.0942622576
451	103	2	0	2	70.2808720727
451	112	1	0	1	71.9289195907
451	113	1	0	1	66.443900529
451	141	1	0	1	24.0896014303
451	142	0	0	0	52.1807841503
451	146	1	0	1	62.5928455856
451	168	1	0	1	61.3524753772
451	172	2	0	2	56.5887747982
451	177	3	0	3	58.8292433218
451	254	1	0	1	104.195917322
451	319	2	0	2	75.2130221832
451	321	1	0	1	79.104608006
451	379	0	0	0	18.5344215485
451	385	9	0	9	25.5700257911
451	389	1	0	1	29.9714491962
451	390	1	0	1	13.1399474227
451	391	5	0	5	16.9693453595
451	394	4	2	2	17.0346530491
451	395	1	0	1	26.2113303109
451	396	44	0	44	8.30619599512
451	397	28	10	18	4.57166881411
451	399	1	0	1	16.2141874058
451	400	1	0	1	20.7912739391
451	401	11	0	11	22.0376155939
451	402	1	0	1	28.5565523466
451	403	2	0	2	25.5380660658
451	404	1	0	1	22.7572942924
451	406	40	28	12	15.1403951205
451	407	3	0	3	10.5385376269
451	408	250	38	212	16.2290852452
451	409	7	0	7	17.2724422902
451	410	12	0	12	12.6334596797
451	411	32	10	22	15.9076585305
451	412	1	0	1	25.1290253597
451	413	1	1	0	28.5579580936
451	414	6	0	6	20.7293198982
451	415	19	4	15	8.64028861391
451	416	4	0	4	22.3632839918
451	417	13	0	13	13.0223711327
451	418	1	0	1	19.6121354938
451	421	1	0	1	32.0396043995
451	427	1	0	1	28.9875186473
451	431	1	0	1	39.6679942781
451	438	0	0	0	42.5120114604
451	441	0	0	0	37.157470053
451	442	7	1	6	35.9838799237
451	452	2	1	1	8.44074971443
451	453	1	0	1	5.22127259502
451	454	2	0	2	15.8296131379
451	455	4	1	3	23.3291350515
451	457	27	0	27	3.74990733442
451	458	8	7	1	4.81046261138
451	459	1	0	1	12.9312325605
451	460	36	8	28	9.33369286511
451	466	1	0	1	29.3656598521
451	469	4	1	3	25.766522897
451	475	6	0	6	17.5779321519
451	494	1	0	1	20.0975374296
451	496	2	0	2	11.1848842325
451	497	1	0	1	7.65911229565
451	503	8	2	6	8.30357294236
451	506	1	0	1	30.2435511429
451	573	11	0	11	46.3037162127
451	585	1	0	1	74.272598245
452	24	1	0	1	83.9210778791
452	70	2	1	1	75.3967087462
452	71	3	0	3	64.9976679451
452	73	15	2	13	71.3443735432
452	74	2	0	2	68.655352992
452	75	4	0	4	68.9743174842
452	82	4	1	3	71.9066845892
452	83	1	0	1	71.0392548259
452	84	1	0	1	70.2203422748
452	85	1	0	1	69.6891314053
452	86	2	0	2	65.5151138376
452	87	2	0	2	66.6907613775
452	110	1	0	1	65.5228228847
452	113	5	0	5	64.0058174955
452	142	2	0	2	50.7227486519
452	154	3	0	3	41.9624205618
452	155	1	1	0	68.5192836736
452	164	1	0	1	61.4299186052
452	165	1	0	1	49.5653453971
452	168	1	0	1	56.949256084
452	172	1	0	1	52.1590057436
452	177	1	0	1	53.7549540393
452	307	1	0	1	102.834503126
452	319	4	0	4	67.9341405635
452	327	1	0	1	74.033108982
452	338	0	0	0	98.1594981049
452	349	1	0	1	84.9040279779
452	379	5	2	3	10.7746200669
452	380	2	0	2	17.6198319495
452	385	35	2	33	17.2404032546
452	386	1	0	1	21.1400423615
452	387	2	0	2	19.6446694872
452	388	1	0	1	15.6317127353
452	389	1	0	1	24.8197579666
452	390	7	1	6	4.81657947215
452	391	11	1	10	8.56071984788
452	392	7	2	5	14.2596832789
452	394	5	0	5	11.1390511732
452	395	1	0	1	19.7536019101
452	396	24	13	11	13.2346891962
452	397	9	1	8	10.3166255702
452	398	1	0	1	34.0592188518
452	399	1	0	1	23.8225974451
452	401	3	1	2	23.0011697937
452	404	1	0	1	21.1914568279
452	405	4	0	4	25.5539304376
452	406	27	4	23	20.1075686218
452	407	4	0	4	17.1685987053
452	408	232	43	189	18.7678838588
452	409	1	1	0	23.6216794407
452	410	16	0	16	14.271967229
452	411	51	0	51	14.9856998853
452	412	1	0	1	28.6532166705
452	414	3	0	3	27.3756392065
452	415	26	4	22	8.10274805057
452	416	5	0	5	27.1512562474
452	417	10	2	8	10.0139670076
452	418	1	0	1	16.3806145662
452	419	1	0	1	28.4114536217
452	421	2	0	2	37.4641302481
452	426	1	0	1	56.5861068777
452	427	3	0	3	33.1699904695
452	439	1	0	1	51.6531958327
452	442	8	1	7	38.8455613598
452	444	1	0	1	43.2697219004
452	450	2	0	2	13.0061871463
452	451	4	0	4	8.44074971443
452	453	11	4	7	5.61017989311
452	454	8	3	5	10.4231234932
452	455	12	2	10	17.9140844942
452	457	10	4	6	8.33015479878
452	458	11	1	10	4.15988515551
452	459	7	5	2	6.36001473393
452	460	78	1	77	6.46159974351
452	462	4	0	4	5.88317701367
452	467	1	0	1	14.7409583155
452	475	0	0	0	19.8898779422
452	503	4	0	4	16.7432431496
452	504	1	0	1	21.4933208496
452	506	1	0	1	36.5933688108
452	507	1	0	1	113.373622249
452	524	1	0	1	48.9640662422
452	554	1	0	1	44.6411922052
452	573	12	2	10	38.3111532283
452	578	1	0	1	26.1563213373
452	581	1	0	1	44.8057495727
453	47	1	0	1	67.1873359423
453	71	1	0	1	69.774034071
453	72	1	0	1	81.1024864984
453	73	24	0	24	75.8790555649
453	74	1	0	1	73.3598188854
453	75	4	1	3	73.4927560316
453	76	1	0	1	77.6909369007
453	78	1	0	1	74.2641120076
453	79	1	0	1	79.7844825088
453	82	3	0	3	76.6648138084
453	83	1	0	1	75.6691756257
453	84	2	0	2	74.7972180175
453	86	3	0	3	70.3807134357
453	87	4	0	4	71.2904754064
453	88	1	0	1	70.0119723623
453	96	1	0	1	82.3782046701
453	141	1	0	1	26.026515698
453	142	1	0	1	54.6668735836
453	146	1	0	1	64.2229548393
453	154	1	0	1	46.5947408937
453	155	1	0	1	73.8403449963
453	163	1	0	1	38.842229537
453	168	2	0	2	62.0815944741
453	177	0	0	0	59.0765011831
453	183	1	0	1	166.008551611
453	323	1	0	1	64.0636212238
453	379	5	0	5	13.8864372445
453	380	1	0	1	23.1861298233
453	385	11	10	1	21.3729316761
453	386	1	0	1	24.6774590635
453	388	1	0	1	16.3085457633
453	390	6	0	6	9.33606081499
453	391	7	0	7	13.7052294098
453	392	2	0	2	19.1692319088
453	394	4	0	4	11.8561401914
453	396	37	4	33	7.6246050279
453	397	17	10	7	4.9416432611
453	401	6	2	4	18.7298808894
453	402	1	0	1	23.8291498846
453	404	1	0	1	18.3187949126
453	406	26	3	23	14.5442347482
453	407	4	2	2	11.6556095158
453	408	304	27	277	13.7517727354
453	409	3	0	3	18.0233718137
453	410	23	1	22	9.4405265226
453	411	60	35	25	11.5433835362
453	412	2	0	2	23.4680230153
453	413	2	0	2	24.6336639035
453	414	6	0	6	21.7918384894
453	415	53	0	53	3.90413931094
453	416	8	0	8	21.6602243644
453	417	19	6	13	7.9264329314
453	418	1	0	1	14.6314102736
453	419	1	0	1	24.0332415161
453	421	1	0	1	31.9131547865
453	427	2	0	2	27.8383699678
453	438	2	0	2	39.1622187211
453	441	0	0	0	33.9637522292
453	442	6	1	5	33.9437439724
453	448	1	0	1	32.9689454629
453	449	1	0	1	14.7183702069
453	450	1	0	1	18.6163395813
453	451	4	3	1	5.22127259502
453	452	1	0	1	5.61017989311
453	454	6	0	6	15.5650462037
453	455	7	1	6	23.1930626096
453	457	11	3	8	7.6449641145
453	458	5	0	5	4.94006090118
453	459	4	1	3	8.02586619166
453	460	32	4	28	10.1036290052
453	462	1	0	1	11.4332189242
453	469	1	0	1	30.9256476571
453	475	1	0	1	21.5059986277
453	487	1	0	1	59.6759296961
453	503	1	0	1	12.7834660222
453	524	0	0	0	50.7173200855
453	554	1	0	1	48.1164926034
453	558	1	0	1	35.3789409762
453	566	2	0	2	31.2866135076
453	573	5	0	5	43.7195778002
453	581	1	0	1	50.4081958617
454	70	1	0	1	64.9928390885
454	73	34	3	31	61.0472059643
454	74	2	0	2	58.2814740739
454	75	7	0	7	58.6883374144
454	76	3	0	3	62.4426531564
454	78	9	0	9	59.103098992
454	81	5	0	5	64.1356198144
454	82	3	0	3	61.5135919897
454	83	3	0	3	60.6947867977
454	84	7	0	7	59.9018623284
454	85	2	0	2	59.267192568
454	87	9	0	9	56.3636080901
454	88	1	0	1	54.9813331013
454	96	0	0	0	66.8363171804
454	103	3	0	3	57.9735531893
454	111	1	0	1	75.1501174108
454	112	1	0	1	60.0221709671
454	113	4	0	4	53.7901147796
454	131	1	0	1	37.7446414823
454	141	0	0	0	12.6839663737
454	142	1	0	1	40.9653370386
454	147	2	0	2	23.1304001749
454	154	2	0	2	31.651845005
454	160	1	0	1	35.8447319127
454	163	2	0	2	23.5531825048
454	168	1	0	1	46.5603779479
454	172	5	0	5	41.7692025854
454	176	2	0	2	15.5465607227
454	177	3	0	3	43.5182251143
454	207	1	0	1	133.600910072
454	277	0	0	0	111.671570929
454	296	1	0	1	101.22277589
454	319	3	0	3	59.5947975948
454	329	1	0	1	66.2329653312
454	335	1	0	1	106.94143148
454	338	1	0	1	88.8135987507
454	379	2	0	2	15.8956150748
454	380	1	0	1	11.277022205
454	385	15	0	15	18.1412762023
454	387	3	0	3	23.3924619174
454	388	0	0	0	22.9648087579
454	389	1	0	1	32.0828331645
454	390	1	0	1	10.871149629
454	391	10	0	10	9.52520229487
454	392	9	0	9	13.3281773059
454	394	2	1	1	19.2164664733
454	396	13	0	13	22.9211783999
454	397	6	2	4	19.4580463101
454	401	2	0	2	33.3779490493
454	404	1	0	1	31.0396701722
454	406	19	0	19	29.9876866741
454	407	7	1	6	26.1872427844
454	408	120	24	96	29.1456842624
454	409	1	0	1	32.9004422617
454	410	1	0	1	24.6729507048
454	411	23	2	21	25.226736066
454	412	1	0	1	38.9834232457
454	414	1	0	1	36.4783881788
454	415	15	10	5	18.5179303661
454	416	1	0	1	37.1794739368
454	417	5	2	3	20.0259759483
454	418	1	0	1	25.7514259781
454	421	1	0	1	47.3191250934
454	425	1	0	1	49.2669334629
454	426	1	0	1	66.9146957912
454	427	2	0	2	43.4023893512
454	438	1	0	1	53.1798627654
454	442	1	0	1	49.2631105582
454	443	1	1	0	70.4953624713
454	449	2	1	1	4.08811156713
454	450	5	4	1	6.43972974029
454	451	1	0	1	15.8296131379
454	453	5	0	5	15.5650462037
454	455	37	0	37	7.64979062317
454	456	1	0	1	12.2857041328
454	457	4	2	2	13.097311262
454	458	14	1	13	11.3796906719
454	459	5	1	4	15.0155734577
454	460	130	17	113	6.58807970568
454	462	7	6	1	5.12104415587
454	467	1	1	0	7.58808064629
454	469	0	0	0	30.8748840051
454	471	1	0	1	50.0280673967
454	475	2	0	2	15.7306398611
454	503	2	1	1	22.9257245277
454	524	0	0	0	52.4720387931
454	536	1	0	1	84.8038720795
454	566	3	0	3	22.1349446939
454	571	2	1	1	28.9474449645
454	573	8	1	7	31.9037262503
454	578	1	0	1	18.8028925776
454	580	1	1	0	30.5111280869
454	581	0	0	0	35.7251009799
454	585	1	0	1	60.4782805934
455	1	4	0	4	81.6761106994
455	7	1	0	1	70.6350860959
455	13	2	0	2	67.3473092684
455	28	1	0	1	81.3651279234
455	35	0	0	0	61.3036047597
455	36	1	0	1	59.499256995
455	42	1	0	1	65.6458352727
455	48	1	0	1	56.0134167332
455	50	1	0	1	57.9871926984
455	70	35	1	34	57.8202766833
455	71	10	0	10	47.479244582
455	72	4	0	4	59.1057313564
455	73	426	0	426	54.2126295651
455	74	42	6	36	51.2371413116
455	75	33	0	33	51.8871150071
455	76	16	2	14	55.2279438148
455	77	1	0	1	58.5057521961
455	78	55	17	38	51.9791803143
455	79	4	1	3	58.0623141193
455	80	1	0	1	57.0701061891
455	81	25	3	22	57.1190276448
455	82	45	0	45	54.3928079677
455	83	16	0	16	53.7368657448
455	84	49	4	45	53.0164629599
455	85	12	3	9	51.9702503504
455	86	13	0	13	47.8664966555
455	87	58	11	47	49.4641554647
455	88	10	0	10	47.9925555136
455	89	3	1	2	66.0150907246
455	90	2	0	2	55.1284494129
455	92	2	0	2	62.6189109755
455	103	12	1	11	51.4769485174
455	104	1	0	1	62.5439782965
455	107	2	1	1	39.8113558213
455	109	2	0	2	59.8643033387
455	110	4	0	4	49.3353370761
455	111	1	0	1	68.0336399683
455	112	13	4	9	53.698828401
455	113	48	3	45	47.1648238581
455	116	1	0	1	55.6400358323
455	118	1	0	1	52.4803130099
455	119	2	0	2	50.0264834034
455	120	2	0	2	60.1535887477
455	127	2	0	2	38.7178564526
455	131	2	0	2	37.3127958316
455	135	2	0	2	18.7222288902
455	140	3	0	3	43.3328903543
455	141	24	3	21	9.90194545078
455	142	25	8	17	35.2917785943
455	144	1	0	1	32.1326655203
455	145	1	0	1	40.4974724934
455	146	1	0	1	42.3233471642
455	147	7	1	6	18.6739324493
455	150	1	0	1	17.3571105423
455	152	1	0	1	31.2030136345
455	154	14	1	13	24.9364399247
455	155	2	0	2	50.6484875053
455	157	2	0	2	27.0674089125
455	158	2	0	2	36.2801594823
455	159	2	0	2	43.9715991434
455	160	12	0	12	28.6320645992
455	161	6	0	6	20.8799273118
455	163	72	53	19	16.5212522537
455	164	4	0	4	43.5592595956
455	165	2	1	1	31.8777157324
455	166	6	0	6	52.838909157
455	167	9	0	9	20.2985713589
455	168	13	0	13	39.0563311524
455	170	3	0	3	40.2366424943
455	171	6	3	3	47.4359002409
455	172	37	0	37	34.2689656435
455	173	2	0	2	32.8603289158
455	174	9	4	5	11.1559179239
455	176	54	27	27	8.18823458992
455	177	37	8	29	35.8839241615
455	178	4	1	3	13.2362223918
455	180	2	0	2	26.7899693829
455	183	1	0	1	144.907898846
455	242	0	0	0	174.857874832
455	256	1	0	1	72.4526238661
455	264	1	1	0	85.4080826796
455	277	2	1	1	104.933086183
455	305	1	0	1	92.5182047231
455	319	14	0	14	52.7220535733
455	320	1	0	1	49.1043298725
455	321	1	0	1	56.0219155106
455	323	2	1	1	42.679095951
455	329	2	0	2	58.6774068517
455	338	2	0	2	81.3570802096
455	353	0	0	0	73.8701503152
455	364	1	0	1	65.9865921582
455	379	18	0	18	21.0074370064
455	380	9	6	3	9.45834154661
455	384	4	3	1	14.1445365427
455	385	112	3	109	20.4617985808
455	386	5	0	5	25.0229816532
455	387	1	0	1	26.7890473704
455	388	1	0	1	28.4508822049
455	390	1	0	1	17.3614071318
455	391	18	2	16	14.4429059946
455	392	21	9	12	15.5953090108
455	394	8	1	7	25.3298094177
455	395	1	0	1	30.345682022
455	396	15	1	14	30.5704013128
455	397	7	2	5	27.088942802
455	398	2	0	2	50.0865555861
455	399	1	0	1	39.3954517363
455	400	1	0	1	41.7110459781
455	401	6	0	6	40.6555185204
455	404	1	0	1	37.7997418511
455	406	32	2	30	37.6373929902
455	407	12	0	12	33.7739303661
455	408	316	153	163	36.681933025
455	409	2	0	2	40.5008199066
455	410	1	0	1	32.1829815211
455	411	33	0	33	32.3809099134
455	412	1	0	1	46.5573704214
455	414	2	0	2	44.0415751109
455	415	34	0	34	26.0085411567
455	416	9	0	9	44.8256777882
455	417	12	2	10	27.080571951
455	427	2	0	2	51.0187929846
455	428	1	0	1	64.8342812259
455	431	1	0	1	61.2418566365
455	436	1	0	1	74.1069835715
455	438	3	0	3	60.0899266689
455	441	2	0	2	55.360142385
455	442	3	0	3	56.7235758287
455	444	2	1	1	61.0496870674
455	449	2	0	2	10.0690926718
455	450	36	0	36	7.78668692333
455	451	11	4	7	23.3291350515
455	453	6	0	6	23.1930626096
455	454	51	7	44	7.64979062317
455	456	10	4	6	6.95643140981
455	457	4	0	4	20.3226422349
455	458	4	0	4	19.0041014862
455	459	6	0	6	21.6951992092
455	460	124	0	124	13.9965319764
455	461	14	9	5	6.36954346535
455	462	6	0	6	12.1878463047
455	466	1	0	1	44.7309213369
455	467	1	0	1	10.4455641851
455	469	2	0	2	34.2185394854
455	470	1	0	1	31.0631271914
455	475	15	4	11	18.4771376867
455	488	1	0	1	58.205680707
455	494	1	0	1	28.1378689418
455	500	1	0	1	31.3183018236
455	503	1	0	1	29.9512313206
455	507	1	0	1	121.580333258
455	510	1	0	1	105.786785746
455	516	1	0	1	72.3300806012
455	520	0	0	0	44.892677608
455	524	8	0	8	54.2922958257
455	530	1	0	1	95.6615961829
455	535	0	0	0	94.1940889056
455	554	3	0	3	44.2421767823
455	555	3	0	3	47.245935516
455	561	1	0	1	57.0308265974
455	563	2	1	1	39.045506888
455	566	18	3	15	19.9669435585
455	568	13	0	13	15.4208549672
455	569	2	0	2	34.1161585462
455	571	2	0	2	27.1281496995
455	573	133	4	129	26.9021343307
455	574	1	0	1	26.4438872309
455	577	2	0	2	40.2337227383
455	578	7	1	6	13.8596802725
455	579	2	0	2	35.4027284293
455	580	2	1	1	23.9911726221
455	581	9	0	9	28.5420227818
455	585	2	0	2	55.5127563756
455	588	1	0	1	75.1432531423
456	36	1	0	1	52.9968874829
456	70	6	0	6	53.0313106086
456	71	8	0	8	42.613730036
456	73	118	0	118	48.8456758475
456	74	12	1	11	46.2130635221
456	75	11	1	10	46.4754255178
456	76	1	0	1	50.5365986918
456	78	21	3	18	47.1044301627
456	81	13	5	8	52.0348514686
456	82	12	0	12	49.5061094642
456	83	5	0	5	48.5595664228
456	84	17	5	12	47.7261054514
456	85	6	1	5	47.4865998962
456	86	2	0	2	43.2390079917
456	87	29	3	26	44.2007965792
456	88	9	1	8	42.8778429417
456	89	2	0	2	60.7006001178
456	92	1	0	1	57.7048941283
456	95	2	0	2	52.0372393801
456	96	1	0	1	55.663090295
456	99	2	1	1	40.9056876667
456	103	1	0	1	45.6913662846
456	107	1	0	1	35.2563383224
456	110	1	0	1	43.2637789522
456	112	3	0	3	47.7393399759
456	113	20	1	19	41.5283212164
456	116	1	0	1	51.1913912769
456	118	1	0	1	48.2791302886
456	121	1	0	1	39.9806480439
456	130	1	0	1	18.1411744438
456	131	1	0	1	31.2781681271
456	135	3	1	2	12.4287186456
456	140	1	0	1	37.2847366105
456	141	14	10	4	4.40950740687
456	142	9	1	8	28.8242822203
456	145	3	1	2	33.6365023253
456	146	2	0	2	37.1035019266
456	147	13	0	13	11.7251698831
456	150	1	0	1	11.0945829255
456	154	3	1	2	19.4733498357
456	155	2	0	2	47.7017889313
456	156	2	0	2	52.5787453891
456	157	2	0	2	24.0426020711
456	160	1	0	1	24.086505528
456	161	2	0	2	17.5096493047
456	163	27	0	27	11.8008809944
456	164	1	0	1	39.6512173405
456	165	1	0	1	29.9829538781
456	166	2	0	2	50.9503509074
456	167	7	1	6	19.3720307818
456	168	3	0	3	35.3440135304
456	169	1	0	1	59.0623202576
456	171	3	0	3	43.9660054582
456	172	18	0	18	30.5933622512
456	174	8	6	2	4.34588905504
456	176	25	9	16	5.73139330853
456	177	13	0	13	33.1389957946
456	178	6	3	3	12.3053786524
456	180	1	0	1	25.3532407324
456	277	1	0	1	99.4149810951
456	312	1	0	1	98.4240994272
456	319	1	0	1	53.5843627481
456	329	1	0	1	57.2885088117
456	379	2	0	2	27.4368386669
456	384	1	1	0	20.8650787751
456	385	9	1	8	27.4068249553
456	388	1	0	1	34.7904990396
456	391	1	0	1	20.821535316
456	392	1	0	1	22.5168508713
456	394	2	0	2	31.3292627725
456	396	3	0	3	33.9822032966
456	397	1	0	1	30.2887382932
456	401	1	0	1	45.4935119103
456	406	8	0	8	41.0314219268
456	407	1	0	1	36.5230139092
456	408	59	0	59	40.9104770418
456	410	1	0	1	36.533098435
456	411	7	2	5	37.4434136589
456	414	1	0	1	46.5078628446
456	415	4	0	4	30.474481331
456	416	1	0	1	48.2851265894
456	417	1	0	1	32.2895958762
456	441	0	0	0	60.5165150946
456	442	3	2	1	61.1019057197
456	449	3	0	3	12.5142634426
456	450	1	0	1	14.5953961377
456	451	1	0	1	26.0221879731
456	453	1	0	1	27.160319335
456	454	9	0	9	12.2857041328
456	455	49	0	49	6.95643140981
456	457	2	1	1	22.5071668261
456	460	21	10	11	17.13225502
456	461	4	0	4	11.5322621518
456	467	1	0	1	10.1468697083
456	469	1	0	1	30.9025335554
456	475	2	0	2	15.8135847234
456	476	1	0	1	37.1944139275
456	503	3	0	3	31.2428479803
456	504	1	0	1	24.7856207511
456	507	1	0	1	128.531777313
456	555	0	0	0	52.8487299365
456	563	0	0	0	44.4999213692
456	566	3	0	3	26.1954881135
456	568	1	0	1	17.7121841905
456	573	31	0	31	31.0305740793
456	578	1	0	1	18.847839141
456	579	1	0	1	37.2426661963
456	581	2	0	2	29.1615033843
456	585	2	0	2	59.1016585713
457	1	1	0	1	90.081702938
457	5	1	0	1	88.121972549
457	39	1	0	1	82.420974733
457	70	2	0	2	75.0756429096
457	73	39	7	32	70.3216825339
457	74	4	2	2	68.103598303
457	75	6	1	5	67.9198484025
457	76	1	0	1	72.6676985618
457	78	6	0	6	69.1190599189
457	81	1	0	1	73.8156404966
457	82	5	1	4	71.4932414795
457	84	5	2	3	69.3130846771
457	85	1	0	1	69.7597445805
457	87	1	0	1	65.860733717
457	90	1	0	1	73.6424424095
457	92	1	0	1	79.6141100556
457	98	1	0	1	63.2256971752
457	103	1	0	1	66.5389643371
457	113	2	0	2	62.7139555763
457	117	1	0	1	63.076294913
457	128	1	0	1	42.4859360315
457	133	1	0	1	56.366650998
457	142	3	0	3	48.4308769288
457	147	2	0	2	30.1789102391
457	154	2	0	2	41.4174082476
457	155	1	0	1	70.135256767
457	163	1	0	1	34.2858047446
457	168	1	0	1	57.8503201634
457	172	1	0	1	53.1001416976
457	177	0	0	0	55.4756913696
457	319	4	0	4	72.6919537646
457	325	1	0	1	71.4151317619
457	332	0	0	0	114.167351924
457	338	0	0	0	101.672158075
457	379	5	1	4	19.0868753998
457	380	1	0	1	23.4340985918
457	385	9	0	9	25.3916170326
457	386	1	0	1	29.4327330552
457	388	1	0	1	23.211985528
457	390	2	0	2	13.1006435686
457	391	2	1	1	16.2006401621
457	392	4	0	4	21.9201630221
457	394	3	1	2	18.6425753275
457	396	27	0	27	12.056095324
457	397	16	0	16	8.31681763203
457	398	1	0	1	38.7055915069
457	399	3	0	3	19.0928249532
457	401	6	0	6	25.614981678
457	406	31	0	31	18.849834475
457	407	8	4	4	14.0342935227
457	408	272	109	163	19.9241823952
457	409	3	1	2	20.7156103499
457	410	11	0	11	16.1737515607
457	411	35	8	27	19.0575363158
457	413	1	0	1	31.9606916197
457	414	4	0	4	24.0307502003
457	415	10	5	5	11.4946480051
457	416	2	0	2	26.0487101683
457	417	6	3	3	15.5122512747
457	421	1	0	1	35.5892214057
457	425	1	0	1	39.1000426362
457	426	1	0	1	56.2902851326
457	427	2	0	2	32.7040970043
457	438	1	0	1	46.1157288451
457	442	7	0	7	39.7333134764
457	444	2	0	2	42.2272734566
457	450	0	0	0	18.3743760197
457	451	21	13	8	3.74990733442
457	452	4	1	3	8.33015479878
457	453	6	0	6	7.6449641145
457	454	8	1	7	13.097311262
457	455	7	0	7	20.3226422349
457	456	1	0	1	22.5071668261
457	458	7	3	4	4.19569308682
457	459	3	0	3	14.0952140459
457	460	103	5	98	6.52604195559
457	461	2	0	2	25.589477698
457	462	4	1	3	11.3930223043
457	465	1	0	1	21.528765398
457	469	1	0	1	23.7781865729
457	471	1	1	0	44.3710545778
457	475	8	1	7	14.0477194195
457	495	1	0	1	21.1370410495
457	496	0	0	0	9.09805621696
457	497	1	0	1	4.2195256468
457	502	1	0	1	19.5185159812
457	503	12	1	11	9.86388313439
457	504	1	0	1	13.4040868876
457	505	1	0	1	35.8694522169
457	524	2	0	2	57.141734423
457	566	1	0	1	33.2834721008
457	573	12	2	10	44.4561187657
457	579	1	0	1	55.0053489983
457	581	1	0	1	48.7665502314
458	1	1	0	1	92.5808292142
458	67	1	0	1	75.9603359578
458	70	3	0	3	75.4470790964
458	71	3	0	3	65.0268363993
458	73	64	36	28	71.0377133987
458	74	7	0	7	68.5791977713
458	75	9	1	8	68.6475856457
458	76	1	0	1	72.9680325291
458	78	11	4	7	69.5095812695
458	81	1	0	1	74.366426798
458	82	7	0	7	71.9053326755
458	83	5	0	5	70.8590050144
458	84	4	1	3	69.9694281984
458	85	0	0	0	69.9254300454
458	86	5	0	5	65.6778741817
458	87	7	0	7	66.4718693303
458	88	1	0	1	65.2201243008
458	90	1	0	1	73.5293094714
458	92	1	0	1	80.0862153122
458	103	1	0	1	67.5270713516
458	111	1	0	1	85.4881809784
458	113	7	2	5	63.5506391392
458	118	1	0	1	70.6863914862
458	131	1	0	1	39.9933182921
458	132	1	0	1	27.2490200786
458	135	1	0	1	34.3347174087
458	141	2	0	2	21.1237868785
458	142	1	0	1	49.7328473558
458	150	1	0	1	25.8675968692
458	154	2	0	2	41.8083621193
458	156	1	0	1	74.4855609235
458	160	1	0	1	46.5118171226
458	165	1	0	1	50.8796254861
458	168	1	0	1	57.5720607708
458	176	1	0	1	26.6228270645
458	177	2	0	2	54.7780084957
458	277	0	0	0	121.3392001
458	319	4	0	4	70.4870563873
458	338	0	0	0	100.132211192
458	375	1	0	1	136.53811865
458	379	4	0	4	14.8933593046
458	380	2	0	2	20.5286763462
458	382	1	0	1	36.7337190554
458	383	1	0	1	31.4743307046
458	385	19	1	18	21.3494535375
458	386	2	0	2	25.2979612315
458	389	1	0	1	28.1977042433
458	391	12	0	12	12.3794407812
458	392	5	0	5	18.1268074167
458	394	3	0	3	14.6302705381
458	396	64	1	63	11.6351953554
458	397	34	31	3	8.08521977944
458	399	1	0	1	20.9269368603
458	401	8	1	7	23.6699183264
458	404	2	0	2	23.0092181247
458	405	1	0	1	25.4246368621
458	406	40	0	40	18.7197316789
458	407	11	1	10	14.8242213712
458	408	376	6	370	18.576322212
458	409	3	0	3	21.5245430364
458	410	25	1	24	14.3523090184
458	411	58	2	56	16.3389885372
458	412	3	0	3	28.1364800967
458	413	2	0	2	29.4938677971
458	414	9	4	5	25.128696608
458	415	38	9	29	8.73096745033
458	416	8	2	6	25.9574178317
458	417	24	2	22	12.1246789417
458	418	2	0	2	18.8479799219
458	421	1	0	1	35.9875305345
458	425	1	0	1	38.4530800692
458	427	1	1	0	32.3493635027
458	433	1	0	1	56.9990556227
458	435	1	0	1	34.5539748233
458	438	2	2	0	44.0942468858
458	441	3	1	2	38.9034604494
458	442	10	0	10	38.7448687859
458	445	1	0	1	53.0522940376
458	449	2	1	1	9.9313113778
458	451	25	18	7	4.81046261138
458	452	4	1	3	4.15988515551
458	453	19	11	8	4.94006090118
458	454	16	1	15	11.3796906719
458	455	24	0	24	19.0041014862
458	456	1	0	1	22.4398894081
458	457	31	17	14	4.19569308682
458	459	9	0	9	9.98608260629
458	460	161	52	109	5.30775508802
458	462	4	2	2	8.27383288688
458	463	1	0	1	39.8071101728
458	470	1	0	1	30.2676467513
458	471	1	0	1	48.4411790636
458	475	5	0	5	16.949808896
458	503	6	0	6	12.9355656266
458	524	1	0	1	52.9684418377
458	554	2	0	2	48.7917060332
458	555	1	0	1	56.0972609167
458	558	1	0	1	36.6731592561
458	561	1	0	1	60.0400586034
458	563	0	0	0	49.0709339409
458	566	3	0	3	29.8087634338
458	573	14	1	13	41.4947338931
458	576	1	0	1	55.0379296952
458	577	2	0	2	57.4197562285
458	579	1	0	1	52.6344073472
458	581	0	0	0	46.9204253286
459	70	1	0	1	79.5042516354
459	73	28	3	25	75.8564039861
459	74	9	0	9	72.9309379102
459	75	2	0	2	73.5161011116
459	76	1	0	1	76.9004897888
459	81	3	0	3	78.8109231252
459	82	1	0	1	76.085982025
459	86	3	0	3	69.5364273627
459	87	1	0	1	71.1286760738
459	88	0	0	0	69.6786356151
459	99	2	0	2	68.0831136754
459	103	2	0	2	72.9274333135
459	110	2	0	2	70.5422309706
459	113	1	0	1	68.6983065839
459	117	1	1	0	68.4586437127
459	131	1	0	1	49.4719113216
459	141	1	0	1	27.4434629269
459	142	2	0	2	55.9681715302
459	154	3	1	2	46.4951546765
459	160	0	0	0	50.3203685902
459	164	1	0	1	65.0267366745
459	168	1	0	1	60.4688562416
459	172	1	0	1	55.7086998667
459	175	1	0	1	64.1181007931
459	177	4	0	4	56.7766474052
459	319	10	6	4	68.3456123451
459	320	1	0	1	63.32169501
459	322	1	0	1	60.3118485905
459	323	1	0	1	59.3345255406
459	329	2	0	2	77.71982265
459	331	1	0	1	64.9116041605
459	338	0	0	0	99.4910606471
459	379	43	38	5	5.96357442969
459	380	2	0	2	18.5024021905
459	381	2	0	2	20.5026172637
459	384	1	0	1	19.0827118527
459	385	66	50	16	13.767601424
459	386	2	0	2	16.7244202126
459	387	2	0	2	14.3281835298
459	388	4	0	4	9.28466560039
459	389	0	0	0	18.4607932674
459	390	21	13	8	4.34005827843
459	391	21	5	16	8.32365751807
459	392	7	4	3	12.5996037105
459	394	111	24	87	4.78064986406
459	395	1	0	1	13.5783302125
459	396	38	1	37	14.040998947
459	397	8	6	2	12.6117773027
459	398	1	0	1	28.644147147
459	399	2	0	2	25.7325777221
459	400	5	0	5	21.5417111991
459	401	6	1	5	19.3627584411
459	402	0	0	0	20.0955311608
459	404	2	0	2	16.1171361011
459	405	2	0	2	22.9284066215
459	406	55	8	47	19.7514937992
459	407	16	4	12	18.5913882065
459	408	329	38	291	16.6954326515
459	409	7	5	2	24.1627088166
459	410	28	3	25	12.3552502861
459	411	162	39	123	10.9944403132
459	412	2	0	2	26.4638145336
459	413	3	0	3	23.263319485
459	414	8	0	8	27.9873754405
459	415	45	33	12	7.19751314471
459	416	5	1	4	26.0584752996
459	417	126	81	45	5.69814950566
459	418	4	1	3	10.7358670344
459	419	1	0	1	24.7042960057
459	422	1	0	1	48.3409001311
459	425	1	1	0	36.3287937398
459	427	6	0	6	31.2821438033
459	429	1	0	1	48.640542099
459	432	1	0	1	46.8702058847
459	433	1	0	1	51.5492599109
459	435	2	0	2	30.944008804
459	438	2	1	1	38.394727661
459	441	0	0	0	33.705933072
459	442	12	0	12	35.7749876807
459	448	1	0	1	36.6744261024
459	449	1	0	1	16.2925240341
459	450	1	0	1	15.0467209282
459	451	6	2	4	12.9312325605
459	452	1	0	1	6.36001473393
459	453	1	0	1	8.02586619166
459	454	5	0	5	15.0155734577
459	455	11	0	11	21.6951992092
459	457	2	0	2	14.0952140459
459	458	0	0	0	9.98608260629
459	460	22	1	21	12.6738602734
459	462	1	0	1	9.89455953539
459	475	4	0	4	26.2428694518
459	483	1	0	1	67.9378622353
459	493	1	0	1	54.7693565423
459	503	2	0	2	20.8077873464
459	506	2	0	2	36.5356891305
459	516	0	0	0	51.7597032694
459	520	1	0	1	27.7544785306
459	524	3	1	2	43.0940254951
459	548	1	0	1	115.046778641
459	554	1	0	1	40.1034058669
459	566	18	4	14	24.6365858602
459	568	0	0	0	32.9633261022
459	573	31	19	12	37.6802763306
459	579	1	0	1	50.3360405076
459	581	4	0	4	46.2540682956
459	585	1	0	1	64.224574112
460	1	3	0	3	88.2037063563
460	36	1	1	0	68.3594033993
460	59	2	0	2	60.5734710963
460	70	9	1	8	70.1450430604
460	71	1	0	1	59.7250469063
460	72	2	0	2	71.0142047273
460	73	274	5	269	65.7776482736
460	74	20	2	18	63.2865266824
460	75	27	1	26	63.3905352005
460	76	6	3	3	67.6626410104
460	77	1	0	1	70.2541666942
460	78	23	4	19	64.2095021655
460	80	1	0	1	68.9201735908
460	81	18	14	4	69.0808156818
460	82	35	0	35	66.6065098334
460	83	24	1	23	65.5790434816
460	84	46	1	45	64.6996980581
460	85	7	1	6	64.6176877974
460	86	6	1	5	60.3706563361
460	87	16	1	15	61.1963991495
460	88	6	1	5	59.9315422261
460	89	0	0	0	77.6309052747
460	92	2	0	2	74.7912954022
460	95	1	0	1	68.5004537041
460	98	4	1	3	57.9305934712
460	103	9	2	7	62.3299985142
460	107	2	1	1	52.3867840548
460	110	8	1	7	59.5879266004
460	111	1	0	1	80.1951132392
460	112	5	1	4	64.1749918456
460	113	16	12	4	58.3182979893
460	116	1	0	1	68.3218812971
460	121	1	0	1	56.9404030691
460	131	1	0	1	36.9265131135
460	136	1	1	0	41.9061040468
460	141	6	2	4	15.9560110168
460	142	4	1	3	44.6629462514
460	146	2	0	2	54.13770295
460	147	4	0	4	26.3716475967
460	154	9	0	9	36.516267417
460	155	3	0	3	64.3165354081
460	163	5	0	5	28.888568251
460	165	1	0	1	45.7956823268
460	166	1	0	1	66.7969858617
460	168	4	0	4	52.2944837055
460	171	2	0	2	60.8411813623
460	172	5	0	5	47.5138061335
460	174	2	1	1	20.9030893647
460	175	1	0	1	56.7508654421
460	176	4	0	4	21.3939773575
460	177	7	0	7	49.5884616529
460	244	1	0	1	186.803467
460	319	12	0	12	66.1736521158
460	323	3	0	3	56.3218048471
460	338	1	0	1	95.3287161729
460	361	0	0	0	81.6451039964
460	379	19	0	19	15.9855928789
460	380	3	1	2	17.1003408571
460	381	2	0	2	31.6208897949
460	385	66	2	64	20.8187368786
460	386	3	0	3	25.258595773
460	387	1	0	1	24.6282089047
460	389	0	0	0	31.0691033976
460	390	8	0	8	9.78217850189
460	391	35	2	33	11.30954874
460	392	18	0	18	16.6977224564
460	394	7	0	7	17.4300287492
460	396	69	14	55	16.9020465066
460	397	28	2	26	13.2706906069
460	399	5	1	4	25.4435908839
460	400	5	1	4	28.7678615407
460	401	6	0	6	28.7379862619
460	404	4	2	2	27.503169916
460	405	6	0	6	30.6923450072
460	406	86	18	68	23.9793514725
460	407	28	9	19	19.8173603976
460	408	727	227	500	23.8375698487
460	409	9	2	7	26.554411702
460	410	25	0	25	19.5398400449
460	411	99	1	98	21.0708887086
460	412	6	0	6	33.4418059346
460	414	11	0	11	30.0568891041
460	415	63	0	63	13.6631562543
460	416	8	2	6	31.2275832025
460	417	33	1	32	16.3519954977
460	419	2	0	2	34.0869527692
460	421	1	0	1	41.1786191622
460	424	2	0	2	71.2825351261
460	425	1	0	1	43.758806142
460	426	1	0	1	61.2652601008
460	427	4	0	4	37.6510844847
460	431	1	0	1	48.1456017468
460	433	1	0	1	62.0303640143
460	438	7	0	7	49.0452227887
460	439	1	0	1	57.7646269144
460	441	1	0	1	43.9315117125
460	442	11	0	11	44.022367619
460	449	13	2	11	4.62908713288
460	450	14	3	11	12.0246066217
460	451	20	10	10	9.33369286511
460	452	8	4	4	6.46159974351
460	453	25	0	25	10.1036290052
460	454	93	33	60	6.58807970568
460	455	67	2	65	13.9965319764
460	456	2	0	2	17.13225502
460	457	50	15	35	6.52604195559
460	458	37	32	5	5.30775508802
460	459	20	19	1	12.6738602734
460	462	13	0	13	5.70562613577
460	465	1	0	1	26.4180095536
460	466	1	1	0	34.3708529374
460	467	2	0	2	8.39773229487
460	469	1	0	1	27.0266201807
460	470	1	0	1	27.7992761696
460	475	14	8	6	13.7224482382
460	477	0	0	0	34.0368974433
460	485	1	0	1	53.9347405951
460	494	1	0	1	20.593050653
460	495	1	0	1	27.3004185067
460	496	1	0	1	13.3914756147
460	497	1	0	1	7.36856534904
460	503	9	2	7	16.3825168337
460	507	4	0	4	119.357720151
460	519	1	0	1	76.6676939941
460	520	1	0	1	40.227037428
460	521	0	0	0	48.7477051976
460	524	3	0	3	54.1658702578
460	528	1	0	1	53.0304181811
460	529	1	0	1	93.4223676239
460	554	3	0	3	48.2916975907
460	555	1	0	1	54.4881978298
460	556	1	0	1	83.0361199229
460	566	26	0	26	27.3529578625
460	568	1	0	1	28.8775963708
460	569	3	0	3	46.1869596287
460	570	1	0	1	53.226922374
460	573	52	9	43	38.0718974457
460	574	1	0	1	29.5705535808
460	577	1	0	1	53.298414378
460	581	3	0	3	42.3039573651
460	585	2	0	2	66.4841715367
461	1	1	0	1	84.1585877476
461	70	6	0	6	56.6013527163
461	71	3	0	3	46.4910268588
461	72	2	0	2	58.2862988543
461	73	44	2	42	53.7736744373
461	74	5	0	5	50.3877932954
461	75	10	1	9	51.5386824835
461	76	1	0	1	53.923001375
461	78	4	0	4	50.935096218
461	81	1	0	1	56.2730319277
461	82	3	0	3	53.3320263115
461	84	8	1	7	52.4885993258
461	85	3	0	3	50.4682803729
461	87	5	0	5	48.9485730934
461	88	1	0	1	47.3059084789
461	90	1	0	1	53.00609648
461	98	1	0	1	43.4321510986
461	103	3	1	2	51.6792577949
461	109	1	0	1	58.0649232219
461	110	2	0	2	50.0320666325
461	113	3	0	3	47.2025919317
461	128	1	0	1	29.7508124418
461	135	1	0	1	20.755423752
461	140	1	0	1	44.0772085901
461	141	0	0	0	15.4538684976
461	142	5	0	5	36.9727997871
461	147	1	1	0	22.3544400054
461	154	5	1	4	25.3906780695
461	155	5	0	5	47.62836334
461	158	1	0	1	32.6029344704
461	160	2	1	1	27.7980518345
461	161	1	0	1	19.3611049621
461	163	7	3	4	16.8784763341
461	166	1	0	1	48.9160256394
461	167	5	2	3	16.6545110598
461	168	2	0	2	36.9776818442
461	170	1	0	1	35.6635628995
461	171	4	0	4	44.9488652174
461	172	9	0	9	32.2917522029
461	175	1	0	1	40.3268961829
461	176	4	1	3	9.10164213921
461	177	11	1	10	32.9793638381
461	178	1	0	1	10.6757606078
461	319	10	1	9	47.1025112219
461	320	1	0	1	43.1726377629
461	329	1	0	1	54.3314476597
461	338	1	0	1	76.6432241169
461	349	2	0	2	63.4044257273
461	379	3	1	2	21.5264315566
461	380	6	1	5	6.58908343387
461	384	1	0	1	10.3268528633
461	385	14	0	14	18.5745676454
461	386	0	0	0	22.6100172152
461	391	2	0	2	15.6558678571
461	392	2	0	2	14.3704691688
461	396	3	1	2	34.7288743488
461	400	1	0	1	44.9805804387
461	406	4	0	4	41.662840947
461	407	1	0	1	38.3477175591
461	408	19	0	19	39.9760734738
461	411	2	0	2	34.8381484523
461	415	7	3	4	29.3570590098
461	417	2	1	1	29.5172400155
461	427	1	0	1	54.5583932451
461	441	0	0	0	57.3121687678
461	442	1	0	1	59.587733984
461	449	0	0	0	15.8125693972
461	450	5	1	4	8.8315061101
461	451	1	0	1	28.202639268
461	452	1	0	1	21.5570311297
461	454	1	0	1	12.4922930346
461	455	52	43	9	6.36954346535
461	456	2	0	2	11.5322621518
461	457	2	0	2	25.589477698
461	460	7	2	5	19.0734417793
461	462	1	0	1	15.6974889671
461	470	0	0	0	37.1415912524
461	475	1	0	1	24.8396005219
461	507	2	1	1	118.326136221
461	524	1	0	1	50.7619589168
461	555	1	0	1	41.382128397
461	558	0	0	0	32.6437769616
461	563	1	0	1	33.0786219828
461	566	10	0	10	14.7689327289
461	568	26	1	25	9.83745477639
461	571	0	0	0	21.828613699
461	573	92	2	90	20.5335162464
461	577	1	0	1	34.3211431494
461	578	10	4	6	7.57092492765
461	579	3	0	3	29.489798406
461	580	3	0	3	18.0500466786
461	581	8	0	8	23.3577819004
461	585	2	0	2	49.1466139975
461	587	1	0	1	57.1819852391
462	1	0	0	0	91.0283532552
462	70	4	1	3	69.9217749979
462	73	48	4	44	66.0898135762
462	74	3	0	3	63.2615808131
462	75	5	0	5	63.7377514948
462	78	5	1	4	64.0523115516
462	79	3	0	3	69.9657421402
462	81	3	0	3	69.1272859203
462	82	6	0	6	66.464850272
462	83	4	0	4	65.7042611093
462	84	7	1	6	64.931480049
462	85	0	0	0	64.126596003
462	87	1	0	1	61.3882251347
462	88	5	0	5	59.9791172912
462	103	1	0	1	63.0715783276
462	112	2	0	2	65.1351664255
462	113	4	0	4	58.870146298
462	141	0	0	0	17.6664729549
462	142	2	0	2	46.0804751637
462	145	1	0	1	50.1293551749
462	146	3	0	3	54.2573251637
462	154	1	0	1	36.7006305268
462	158	1	0	1	48.0279969494
462	160	1	1	0	40.7416703411
462	163	3	0	3	28.5048946909
462	166	3	0	3	64.4772874825
462	167	1	0	1	31.9763947447
462	168	3	0	3	51.2392180458
462	172	3	0	3	46.4534264397
462	173	1	0	1	44.1446870561
462	175	1	0	1	55.2253449385
462	176	3	0	3	20.3293774999
462	177	2	1	1	47.930570817
462	319	2	0	2	62.3231644802
462	323	2	0	2	52.7360267456
462	338	0	0	0	92.3297779459
462	349	1	0	1	79.0822816704
462	379	5	0	5	11.3193274479
462	380	1	0	1	12.2558429776
462	383	1	0	1	31.9368511313
462	385	35	21	14	15.206065667
462	386	0	0	0	19.7391379754
462	389	2	0	2	27.2784628049
462	390	10	1	9	5.80185449637
462	391	11	1	10	5.73434307204
462	392	11	7	4	10.9922440312
462	394	7	3	4	14.1609023424
462	395	1	0	1	21.2247470824
462	396	15	6	9	19.0362583826
462	397	6	4	2	15.8967107003
462	398	2	0	2	38.5385774371
462	399	1	0	1	29.1453345153
462	401	5	0	5	28.4792175016
462	404	1	0	1	25.9369486958
462	405	1	0	1	31.308647657
462	406	28	0	28	25.9702713387
462	407	3	0	3	22.7723694207
462	408	189	27	162	24.5725020139
462	409	1	0	1	29.344208224
462	410	8	0	8	20.0563069304
462	411	32	8	24	20.2423944074
462	413	1	0	1	33.0233128554
462	414	2	0	2	33.0542278709
462	415	21	0	21	13.8840063494
462	416	1	0	1	33.0334017004
462	417	8	0	8	14.9860024198
462	419	1	0	1	33.895365801
462	425	1	0	1	44.7018688773
462	441	0	0	0	43.2860427716
462	442	4	0	4	44.5474553675
462	447	1	0	1	50.5799214546
462	449	2	0	2	7.12446280704
462	450	2	0	2	7.35195109123
462	451	7	0	7	13.0817887333
462	452	6	2	4	5.88317701367
462	453	4	1	3	11.4332189242
462	454	26	0	26	5.12104415587
462	455	18	5	13	12.1878463047
462	457	12	0	12	11.3930223043
462	458	9	2	7	8.27383288688
462	459	3	1	2	9.89455953539
462	460	149	0	149	5.70562613577
462	475	6	0	6	18.6243242335
462	500	1	0	1	25.8448760697
462	503	3	1	2	21.0415932614
462	507	1	0	1	114.782062967
462	509	1	0	1	124.965191986
462	519	1	0	1	71.8594670539
462	524	1	0	1	48.9698350557
462	554	0	0	0	42.6112277167
462	555	1	0	1	48.8396154467
462	561	1	0	1	54.5194843169
462	566	3	0	3	21.9046644926
462	568	1	0	1	25.4523754578
462	573	16	0	16	33.2439457744
462	578	1	0	1	20.6796669022
462	581	5	0	5	38.9975789999
462	585	3	0	3	61.3839940225
463	1	12	0	12	88.6341178389
463	5	1	0	1	82.7059761768
463	8	1	0	1	92.0656951459
463	13	1	0	1	80.7081639744
463	15	1	0	1	80.6427395597
463	21	1	1	0	80.3257608756
463	32	1	0	1	94.3133608989
463	33	1	0	1	75.4736145263
463	36	5	0	5	79.4078342614
463	37	1	0	1	66.2792236057
463	45	3	0	3	32.6489200172
463	48	7	0	7	45.447221992
463	50	1	0	1	55.6389620629
463	51	1	0	1	59.4376856977
463	68	1	0	1	50.3199062806
463	70	3	0	3	92.7550983412
463	71	1	0	1	83.3852467518
463	72	1	0	1	91.8839066737
463	73	24	2	22	86.0884181337
463	74	2	0	2	85.7076632431
463	75	5	0	5	83.8470119626
463	76	1	0	1	91.0089012827
463	77	1	0	1	90.6155114555
463	78	1	0	1	87.1836963444
463	82	2	0	2	89.2043745216
463	84	2	0	2	85.5891918182
463	87	2	0	2	82.7924820634
463	88	2	0	2	82.4520923816
463	103	2	0	2	80.7839952591
463	112	3	0	3	81.0818202677
463	113	9	1	8	78.4721135408
463	118	1	0	1	90.9791027385
463	124	2	0	2	50.4597331532
463	126	1	0	1	43.2966725432
463	128	1	0	1	60.6588558157
463	130	1	0	1	55.4806546199
463	131	2	0	2	36.0969211283
463	136	1	0	1	55.535980439
463	138	1	0	1	65.118797068
463	140	1	0	1	72.4023101189
463	141	2	0	2	46.3146693617
463	142	20	1	19	63.1773312336
463	146	1	0	1	77.2120084055
463	147	1	0	1	50.1199789219
463	148	1	0	1	60.062018971
463	154	3	0	3	63.084745499
463	166	1	0	1	99.2427467771
463	188	0	0	0	171.76634867
463	277	1	0	1	130.226542209
463	294	1	0	1	141.710144676
463	338	1	0	1	129.302327313
463	396	1	0	1	36.6676566596
463	399	1	1	0	27.0985216225
463	406	1	0	1	36.4301031565
463	408	0	0	0	41.9117921587
463	415	1	0	1	42.5011019651
463	425	1	0	1	48.3894861255
463	444	1	0	1	45.7512202325
463	464	12	0	12	25.1926763937
463	465	19	2	17	15.947560267
463	466	857	134	723	7.79646380538
463	467	5	0	5	41.9489925258
463	468	1	0	1	34.9577938013
463	469	170	4	166	21.0115800613
463	470	2	0	2	29.5869492402
463	471	8	0	8	26.3020243698
463	472	6	1	5	28.1403574632
463	474	124	43	81	3.64567694258
463	475	4	0	4	34.6871011973
463	476	3	0	3	36.4002648258
463	477	12	2	10	14.6868313396
463	478	36	0	36	8.46161904926
463	480	17	1	16	20.6951884567
463	481	6	6	0	19.8880354172
463	482	27	1	26	15.1881629323
463	483	5	0	5	20.1941206503
463	484	9	1	8	31.1744255889
463	485	44	26	18	12.6675342997
463	486	1	0	1	26.0101295949
463	487	7	1	6	25.156239143
463	488	21	3	18	15.8627108268
463	489	12	0	12	28.4899950549
463	490	1	0	1	22.0416137265
463	491	44	1	43	12.9894065848
463	492	13	2	11	8.72882875124
463	493	74	22	52	9.4247017856
463	494	1	0	1	25.200698772
463	495	21	5	16	15.6007779563
463	496	1	0	1	28.4068560388
463	499	3	0	3	19.8230699645
463	500	3	1	2	21.3720418273
463	501	46	24	22	12.8465995841
463	502	2	1	1	22.6183315823
463	503	11	3	8	27.6710710659
463	505	82	2	80	7.87558757713
463	573	0	0	0	78.9401885578
464	0	6	4	2	60.0748978817
464	1	172	6	166	63.5198121341
464	2	1	0	1	51.4395071605
464	5	5	0	5	58.0220438525
464	6	1	0	1	51.9571210583
464	7	2	0	2	56.986584035
464	13	6	0	6	55.6599200402
464	15	4	0	4	55.4555570181
464	17	1	0	1	47.2203659195
464	19	1	0	1	62.7124549512
464	20	1	0	1	50.3396040117
464	21	2	0	2	55.3674565303
464	22	1	0	1	66.6459530524
464	23	2	0	2	53.3942974013
464	24	3	0	3	52.4555980021
464	26	3	0	3	42.1055646798
464	28	3	0	3	66.0962249482
464	29	2	0	2	44.3801918756
464	31	1	0	1	46.7898962714
464	32	2	0	2	69.4769006788
464	33	2	0	2	50.5517155755
464	34	10	2	8	34.9536190994
464	35	13	1	12	46.6280608843
464	36	22	0	22	55.0987740944
464	37	2	0	2	41.0880769427
464	38	1	0	1	41.9557795441
464	39	1	0	1	65.0365230468
464	42	1	0	1	60.661510032
464	43	4	0	4	31.7331232432
464	45	54	21	33	11.001944953
464	46	17	1	16	39.9283966093
464	47	15	3	12	21.1345198402
464	48	187	42	145	20.8383205302
464	49	10	3	7	36.9477173891
464	50	62	12	50	30.5425668752
464	52	3	0	3	24.7649819396
464	54	3	0	3	29.611511342
464	55	6	1	5	28.4920349919
464	56	1	0	1	35.1223992326
464	57	13	0	13	13.1123720421
464	58	4	1	3	42.4290563426
464	59	82	22	60	19.5920822664
464	60	33	5	28	26.7830972569
464	61	2	0	2	32.6679458415
464	65	21	9	12	35.8337769584
464	66	1	0	1	36.4858929285
464	68	68	3	65	25.1550373308
464	69	97	3	94	16.171707782
464	70	7	2	5	71.1293730315
464	71	2	0	2	62.7189227371
464	73	105	13	92	63.969407777
464	74	13	1	12	64.3876428251
464	75	25	1	24	61.9045282414
464	76	4	0	4	69.7547367359
464	77	0	0	0	68.2906838777
464	78	10	0	10	65.9938017513
464	79	1	0	1	67.2387590775
464	80	0	0	0	67.7351201464
464	81	4	1	3	68.4105384793
464	82	9	2	7	67.753828548
464	83	12	2	10	65.1170969003
464	84	17	1	16	63.7018870536
464	85	1	0	1	68.5563697686
464	86	6	0	6	64.5289094271
464	87	8	0	8	61.3357871672
464	88	4	1	3	61.3804006365
464	89	1	0	1	73.5984584321
464	90	3	0	3	74.2990983439
464	92	1	0	1	74.0742355219
464	95	3	0	3	61.6408659812
464	96	1	0	1	79.5885266818
464	98	1	0	1	64.6445008402
464	99	1	0	1	49.2499447915
464	102	2	0	2	67.3928083043
464	103	16	0	16	58.3366019523
464	109	1	0	1	76.0603745594
464	110	4	1	3	54.0305445835
464	112	14	0	14	58.1337568025
464	113	36	0	36	56.7677076296
464	114	1	0	1	55.2782660023
464	116	1	0	1	71.6771220259
464	120	2	0	2	67.1575040867
464	122	0	0	0	80.2234936822
464	124	24	2	22	27.3456769435
464	125	3	0	3	32.2369569504
464	126	11	2	9	23.2172035262
464	127	2	0	2	49.7940240708
464	128	3	0	3	42.0017504891
464	130	1	1	0	37.613820749
464	131	310	35	275	13.6746838662
464	133	4	0	4	43.1298925793
464	134	6	1	5	44.7206949375
464	135	2	0	2	40.6283043032
464	136	1	0	1	33.94004889
464	138	2	0	2	41.2379867349
464	139	4	0	4	24.2818965412
464	140	4	0	4	50.6428507922
464	141	4	1	3	36.6605813272
464	142	177	0	177	42.3607746127
464	143	6	0	6	35.0762433491
464	144	1	0	1	47.1885634858
464	145	4	0	4	37.1737543411
464	146	11	0	11	56.7725537856
464	147	24	1	23	34.9390773469
464	148	1	0	1	36.3812487546
464	149	3	0	3	27.3077124993
464	150	1	0	1	30.4204796133
464	151	27	5	22	20.154761215
464	152	2	0	2	28.5385455285
464	153	3	0	3	29.835934401
464	154	4	0	4	46.135759497
464	155	1	0	1	75.6934782553
464	157	0	0	0	56.8882759685
464	163	0	0	0	45.8335892934
464	171	2	0	2	70.552588721
464	172	1	0	1	59.5532963718
464	177	0	0	0	64.4660176549
464	183	1	0	1	142.231540033
464	185	0	0	0	149.975632857
464	190	2	0	2	137.398752178
464	194	0	0	0	156.296023924
464	202	1	1	0	162.342556853
464	208	4	0	4	141.316137793
464	213	1	0	1	146.832077146
464	220	0	0	0	161.985074512
464	225	1	0	1	143.046965793
464	229	2	0	2	147.853209799
464	238	1	0	1	138.125822686
464	245	3	2	1	82.7951911249
464	262	0	0	0	95.8670652911
464	271	1	0	1	125.162946726
464	272	1	0	1	120.5796672
464	274	2	0	2	99.7738331064
464	276	1	0	1	109.592091727
464	277	11	0	11	105.577463788
464	282	0	0	0	105.10955479
464	303	4	0	4	72.8494129753
464	304	1	0	1	66.733057774
464	307	3	0	3	79.4991126466
464	356	1	0	1	115.744301498
464	392	0	0	0	57.3683819263
464	399	1	0	1	42.4318491403
464	406	4	2	2	50.0088721828
464	408	6	5	1	54.2717496384
464	414	2	0	2	48.1567470881
464	415	3	0	3	49.6655553846
464	416	2	0	2	54.7011911494
464	426	1	0	1	80.4278481148
464	463	4	0	4	25.1926763937
464	465	44	11	33	21.3205147511
464	466	657	0	657	21.1546198754
464	467	2	1	1	36.7842358055
464	468	60	26	34	16.2215819156
464	469	1005	60	945	15.3205585301
464	470	52	9	43	14.8213836446
464	471	306	75	231	5.85444285529
464	472	326	0	326	8.63014469747
464	473	9	2	7	20.7907943882
464	474	35	1	34	23.6040468489
464	475	70	0	70	28.4634190396
464	476	1002	15	987	11.6984084339
464	477	149	4	145	12.7916816095
464	478	9	0	9	27.9596010833
464	479	107	5	102	6.52315785961
464	480	751	384	367	6.3040926652
464	481	14	0	14	26.5786055753
464	482	24	0	24	28.9613656929
464	483	1	0	1	37.8711632416
464	484	189	55	134	18.3993237781
464	485	5	1	4	33.5586946496
464	486	19	6	13	23.942218698
464	487	99	89	10	18.5874403164
464	488	109	21	88	17.239783454
464	489	10	1	9	28.7539648526
464	490	31	9	22	11.1963011081
464	491	337	0	337	12.2618098223
464	492	9	2	7	22.1935701288
464	493	10	5	5	33.4537118783
464	494	29	0	29	21.1555595911
464	495	15	1	14	29.9459255933
464	496	7	1	6	29.9129857594
464	499	4	0	4	29.5814674767
464	500	3	0	3	26.4541168914
464	501	15	8	7	34.0369587936
464	502	2	0	2	38.2126990578
464	503	17	0	17	36.377730704
464	504	8	2	6	25.5290148174
464	505	24	0	24	32.7226235242
464	524	1	0	1	95.5277774966
464	553	1	0	1	128.104301645
464	555	2	0	2	93.0892360786
464	578	1	0	1	59.5182062548
464	586	1	0	1	109.679503374
465	0	1	0	1	76.4426563787
465	1	34	1	33	82.1215929828
465	3	1	0	1	75.8618661413
465	7	1	0	1	74.0479966053
465	13	1	0	1	72.0389305125
465	14	1	0	1	68.673402823
465	15	2	0	2	73.0046295437
465	24	1	0	1	70.8747438351
465	28	3	0	3	84.0198844444
465	30	1	0	1	57.5471963644
465	33	1	0	1	66.4545260357
465	36	5	0	5	68.9804422825
465	39	1	0	1	79.7114743362
465	45	1	0	1	32.0047747673
465	46	2	0	2	61.0649274818
465	48	17	0	17	41.4767751994
465	50	3	0	3	49.891322108
465	55	2	0	2	49.651678573
465	57	2	0	2	33.7660340868
465	59	6	0	6	40.3292338568
465	60	1	0	1	46.5680032979
465	65	7	2	5	57.1491110434
465	68	5	0	5	43.293491055
465	69	7	0	7	34.424281468
465	70	4	0	4	79.455842928
465	73	47	4	43	73.2283402248
465	74	6	0	6	72.3198743555
465	75	11	0	11	70.8987453023
465	76	4	0	4	77.5028412008
465	77	1	0	1	77.8381402437
465	78	8	0	8	73.6946003345
465	79	1	0	1	76.9552576753
465	81	3	0	3	77.3725955669
465	82	4	0	4	75.8436610382
465	83	3	1	2	73.8167042335
465	84	4	0	4	72.5724093587
465	86	2	0	2	71.0259937693
465	87	3	0	3	69.5387443932
465	89	1	0	1	84.3008221423
465	90	1	0	1	80.3849453835
465	92	1	0	1	83.3064573853
465	95	2	0	2	73.0641319715
465	97	0	0	0	99.265971849
465	101	0	0	0	93.0542702252
465	102	1	0	1	80.6870534873
465	103	9	0	9	68.272272809
465	107	1	0	1	64.0538903712
465	110	2	1	1	64.4003012468
465	112	9	2	7	68.9930815721
465	113	19	1	18	65.4626483911
465	124	4	0	4	39.6859132705
465	126	1	0	1	30.9169157878
465	127	1	0	1	57.0351535895
465	128	4	0	4	46.5176065104
465	129	1	0	1	60.5082048354
465	131	16	0	16	26.3743962509
465	133	1	0	1	54.7203472134
465	134	3	0	3	54.0588263786
465	135	1	0	1	40.7544719844
465	136	1	0	1	43.2076778103
465	139	2	0	2	27.7310391172
465	140	3	0	3	59.5697950537
465	141	2	1	1	30.4686271363
465	142	72	0	72	50.0215684438
465	143	2	0	2	41.4329136255
465	145	3	0	3	48.3233073805
465	146	2	0	2	63.4779753485
465	147	13	0	13	35.1761623707
465	148	1	0	1	49.3634737994
465	149	3	0	3	23.7640323058
465	150	1	0	1	28.2151465027
465	151	2	0	2	32.8886346371
465	152	1	0	1	36.5433589087
465	154	3	0	3	48.253275517
465	155	1	0	1	79.2698878975
465	163	0	0	0	44.1264022073
465	167	0	0	0	53.8545055902
465	171	1	0	1	74.7043293482
465	177	1	0	1	65.7129085232
465	183	1	0	1	158.084491086
465	208	1	0	1	151.665531305
465	209	1	0	1	150.673376005
465	214	1	0	1	144.259583118
465	245	1	0	1	94.6184163031
465	255	1	0	1	101.671157486
465	277	6	0	6	119.820213802
465	282	0	0	0	117.708905048
465	284	1	0	1	126.795096509
465	307	1	0	1	95.7772116018
465	356	1	0	1	111.58577567
465	406	10	0	10	28.8374641014
465	408	14	0	14	33.398127018
465	411	1	0	1	36.511850457
465	415	1	0	1	30.4821452869
465	416	2	1	1	33.3852003236
465	426	2	1	1	60.0486923239
465	441	1	0	1	52.8083717861
465	442	1	0	1	48.1572441074
465	460	1	0	1	26.4180095536
465	463	2	0	2	15.947560267
465	464	28	0	28	21.3205147511
465	466	1438	476	962	8.24583147416
465	467	2	0	2	26.0418323499
465	468	8	0	8	23.0528454362
465	469	1517	617	900	8.10515613669
465	470	30	4	26	17.0457024189
465	471	15	5	10	25.6998261554
465	472	24	14	10	18.8713591875
465	473	4	0	4	15.3266490183
465	474	44	13	31	17.9322347628
465	475	93	65	28	18.7880790286
465	476	33	2	31	29.111432924
465	477	55	4	51	9.39151719085
465	478	38	0	38	11.3269599277
465	479	2	1	1	27.6265236971
465	480	62	14	48	15.0164841713
465	481	5	2	3	32.3117316928
465	482	13	0	13	29.7183555436
465	483	2	0	2	36.003783684
465	484	12	1	11	35.8592649623
465	485	12	2	10	28.6127238102
465	486	4	0	4	35.4261312158
465	487	9	1	8	32.1677973256
465	488	22	0	22	24.3307874354
465	490	6	1	5	25.7315167847
465	491	99	3	96	14.9194613022
465	492	8	2	6	21.4270646647
465	493	19	2	17	24.8676586648
465	494	57	17	40	9.62967690588
465	495	158	70	88	9.25395810578
465	496	28	10	18	13.0285338258
465	497	2	0	2	19.0548126337
465	499	24	6	18	8.3320285029
465	500	23	2	21	6.54825325626
465	501	54	0	54	15.9773004943
465	502	7	3	4	17.028248646
465	503	95	35	60	15.8848862595
465	504	23	7	16	10.107504334
465	505	28	0	28	19.3356873813
465	506	4	1	3	33.9477124
465	555	2	0	2	80.9005972687
465	564	1	0	1	89.9865468134
466	0	9	1	8	79.9100270506
466	1	98	4	94	84.367925493
466	3	1	0	1	79.7363152755
466	5	3	0	3	79.1580387034
466	6	1	0	1	73.0628786532
466	7	1	0	1	77.1598468298
466	8	4	0	4	89.5439195555
466	13	3	0	3	75.4769086207
466	15	1	0	1	75.8525200687
466	21	3	0	3	76.40197071
466	24	2	0	2	73.2054976347
466	27	1	0	1	66.040689594
466	28	1	0	1	86.6947511409
466	29	1	0	1	65.4996523994
466	30	1	0	1	60.6928557008
466	31	1	0	1	64.9706410764
466	32	3	0	3	88.7312454509
466	33	2	0	2	70.0742997857
466	34	3	0	3	54.3513941732
466	35	2	0	2	66.565497608
466	36	16	2	14	73.4437846686
466	37	1	0	1	61.5994388784
466	38	2	0	2	60.7983750311
466	39	2	0	2	83.9388705175
466	41	3	0	3	67.9077050207
466	42	2	0	2	79.4163613992
466	45	5	0	5	30.4708918073
466	46	4	0	4	60.7243916131
466	47	2	0	2	40.1110019118
466	48	36	1	35	41.9880891694
466	49	3	0	3	57.8689525381
466	50	16	2	14	51.5128942649
466	54	1	0	1	48.9262157455
466	55	3	0	3	49.330920639
466	56	1	0	1	56.1995046829
466	57	2	0	2	34.2660261444
466	58	1	0	1	62.5262107641
466	59	13	0	13	38.072920338
466	60	9	1	8	47.8534805052
466	61	1	0	1	52.136377749
466	62	1	0	1	59.567557178
466	65	10	0	10	55.8285669667
466	68	14	4	10	45.581897861
466	69	13	0	13	36.473403225
466	70	12	0	12	85.7071934085
466	71	4	1	3	76.1735753358
466	73	141	6	135	79.192831666
466	74	14	1	13	78.6184754945
466	75	17	1	16	76.9150366807
466	76	6	0	6	83.8839986069
466	77	1	0	1	83.7579672819
466	78	11	2	9	80.0601553506
466	79	5	0	5	82.8223615414
466	81	5	0	5	83.4464591751
466	82	6	0	6	82.1296609788
466	83	8	1	7	79.933304596
466	84	17	0	17	78.634847528
466	85	3	0	3	81.9617203226
466	86	2	0	2	77.6505059769
466	87	10	8	2	75.7472813369
466	88	3	1	2	75.3246604573
466	89	1	0	1	89.9315780244
466	90	2	0	2	87.1629735931
466	92	1	0	1	89.3464422325
466	95	3	0	3	78.3999044886
466	96	3	0	3	92.309930597
466	99	1	0	1	65.5240811134
466	103	20	1	19	74.0086698093
466	109	1	0	1	89.9822152882
466	110	4	0	4	69.9749913937
466	111	1	0	1	94.2420419178
466	112	25	2	23	74.4675169814
466	113	51	16	35	71.5079995589
466	116	1	0	1	85.4340627011
466	119	1	0	1	82.5186668438
466	120	1	0	1	83.341175493
466	121	1	0	1	71.6523928033
466	122	1	0	1	94.9581198775
466	124	11	2	9	44.2114690783
466	126	2	0	2	36.4104736195
466	127	0	0	0	63.3466263221
466	128	4	0	4	53.2707332051
466	129	1	0	1	65.4353932671
466	131	33	4	29	30.0578735055
466	132	1	0	1	26.858789281
466	133	2	0	2	59.8071642411
466	134	3	0	3	59.79298185
466	136	1	0	1	48.7470069057
466	137	2	0	2	65.0358790575
466	138	0	0	0	59.0097222441
466	139	1	0	1	34.0856535588
466	140	5	1	4	65.4895533365
466	141	10	1	9	38.5201481294
466	142	173	9	164	56.1247284225
466	143	2	0	2	47.6658041257
466	146	2	0	2	69.9883530062
466	147	17	0	17	42.4796782872
466	148	3	0	3	53.90795064
466	149	0	0	0	31.2858188537
466	150	1	0	1	35.7058744201
466	151	3	0	3	37.0162658712
466	153	1	0	1	39.8406846749
466	154	3	0	3	55.4925808476
466	161	1	0	1	58.3227811097
466	164	1	0	1	76.7586319551
466	169	0	0	0	96.6829633125
466	171	2	1	1	81.8338159439
466	172	1	0	1	69.2304453498
466	179	0	0	0	101.373378899
466	183	5	0	5	161.993428401
466	185	1	0	1	169.394255998
466	188	2	0	2	166.011074263
466	190	1	0	1	157.668354898
466	191	1	0	1	185.017864318
466	208	1	0	1	157.609221345
466	220	1	0	1	181.456380311
466	229	1	0	1	165.487026681
466	242	0	0	0	197.342048674
466	243	1	0	1	191.515685797
466	245	1	0	1	99.9534632086
466	251	1	0	1	105.705627459
466	261	1	0	1	100.723657642
466	272	0	0	0	138.568858511
466	275	1	0	1	126.448079223
466	277	15	0	15	124.36842302
466	282	1	0	1	122.863901026
466	303	1	0	1	93.5087406002
466	304	1	0	1	86.7342011905
466	305	2	0	2	108.472644273
466	307	2	0	2	99.3648231053
466	309	1	0	1	92.0072293725
466	319	1	0	1	96.2887528111
466	347	0	0	0	102.796692112
466	350	1	0	1	120.111713452
466	366	1	0	1	104.294228306
466	373	1	0	1	144.351857087
466	391	1	0	1	45.2114659651
466	399	1	0	1	23.841943795
466	400	1	0	1	39.4582873566
466	401	1	0	1	43.9965632435
466	406	6	0	6	32.7422003742
466	408	10	0	10	37.9009428157
466	410	1	0	1	37.3263991596
466	411	2	0	2	42.0758648604
466	414	1	0	1	28.7336413747
466	415	3	0	3	36.8529581302
466	416	2	0	2	35.8586671752
466	426	2	0	2	59.5307827322
466	428	1	0	1	58.7979426448
466	429	1	0	1	46.3661736332
466	430	1	0	1	76.1519492038
466	431	2	0	2	50.3291620657
466	433	1	0	1	70.9503595664
466	460	2	0	2	34.3708529374
466	463	64	6	58	7.79646380538
466	464	101	16	85	21.1546198754
466	465	296	50	246	8.24583147416
466	467	8	1	7	34.286928772
466	468	6	0	6	28.1329906808
466	469	1566	180	1386	13.5533253697
466	470	22	1	21	22.4707692618
466	471	43	3	40	23.8908975683
466	472	89	0	89	22.0475610854
466	473	2	0	2	22.5539165902
466	474	348	40	308	9.72964542459
466	475	93	2	91	26.9055329581
466	476	31	9	22	31.3216991431
466	477	142	21	121	8.72812317487
466	478	153	8	145	6.81181256767
466	479	8	1	7	27.6551426033
466	480	118	7	111	15.5246454799
466	481	18	1	17	24.9140960976
466	482	91	9	82	21.6761725214
466	483	3	0	3	27.7582414615
466	484	37	1	36	31.7410137605
466	485	74	0	74	20.4182324085
466	486	7	0	7	29.2084572841
466	487	37	7	30	26.8757119371
466	488	80	10	70	18.083364442
466	489	15	0	15	32.5926117661
466	490	10	0	10	21.6928995029
466	491	413	0	413	10.599034251
466	492	60	7	53	13.6375858906
466	493	141	6	135	17.0272212562
466	494	46	1	45	17.4067898346
466	495	176	47	129	10.9174010872
466	496	13	1	12	21.0574179771
466	497	1	0	1	27.0097495961
466	499	19	5	14	13.6747742918
466	500	14	0	14	14.1515860061
466	501	149	0	149	12.9068612646
466	502	9	0	9	19.2541258514
466	503	80	2	78	21.8464622388
466	504	20	5	15	18.3532185728
466	505	243	35	208	12.8099504434
466	555	1	0	1	88.8355742411
466	563	1	0	1	81.404534491
466	573	2	0	2	71.4036620192
466	586	4	0	4	109.471460097
467	0	1	0	1	70.4830496339
467	1	6	0	6	79.9498037668
467	5	1	0	1	78.9950244539
467	34	1	0	1	48.0186013559
467	36	3	1	2	59.9673394825
467	43	1	0	1	66.6922639415
467	45	1	0	1	46.8564229873
467	48	2	0	2	49.4505796393
467	51	1	0	1	53.1070862256
467	52	1	0	1	39.9039520205
467	59	1	0	1	55.2088895472
467	61	1	0	1	65.9016145021
467	68	2	0	2	45.7278594603
467	70	7	2	5	62.4721242945
467	71	3	0	3	52.0638507995
467	73	208	30	178	57.8145028841
467	74	8	1	7	55.516626109
467	75	15	0	15	55.4168137143
467	76	10	2	8	60.0567141136
467	78	13	1	12	56.5169873779
467	79	2	0	2	61.7252940459
467	81	2	0	2	61.2496544898
467	82	10	0	10	58.8950346656
467	83	9	0	9	57.7148507425
467	84	17	1	16	56.7809472414
467	85	2	0	2	57.1478629396
467	86	3	0	3	52.8407156791
467	87	7	5	2	53.3107401119
467	88	9	0	9	52.132305298
467	90	1	0	1	61.0773119713
467	92	5	1	4	67.0295245494
467	95	1	0	1	60.2756587403
467	96	1	0	1	65.652778768
467	99	1	0	1	48.3992847156
467	103	9	0	9	54.1841379034
467	110	9	1	8	51.3353879314
467	112	11	1	10	55.9476924142
467	113	30	1	29	50.2628482932
467	114	1	0	1	56.7122408924
467	124	1	0	1	35.2284081327
467	126	1	0	1	25.7077479517
467	128	3	0	3	30.0999429539
467	131	11	1	10	30.2019940868
467	132	4	0	4	17.3462300921
467	134	3	0	3	41.4863642257
467	135	4	0	4	21.1453721571
467	136	1	0	1	33.5295537244
467	140	4	0	4	45.4860726324
467	141	119	19	100	7.82787806229
467	142	113	0	113	36.3445634541
467	143	1	0	1	28.8570315458
467	144	1	0	1	35.1610736413
467	145	2	0	2	39.4109204674
467	146	1	0	1	46.3232090519
467	147	123	0	123	18.0266766914
467	149	8	1	7	11.8808059424
467	150	2	0	2	12.8996994916
467	152	1	0	1	28.2020390445
467	154	14	0	14	28.806951364
467	155	1	0	1	57.8290718245
467	163	2	1	1	21.7876220932
467	164	1	0	1	49.5998554439
467	171	1	0	1	54.0189430031
467	172	6	0	6	40.6441333946
467	174	1	0	1	13.1974465162
467	175	1	0	1	50.2270898409
467	177	3	0	3	43.2856703378
467	178	1	0	1	21.8961764298
467	179	0	0	0	73.565153063
467	207	1	0	1	131.653314761
467	245	2	0	2	80.6745893276
467	276	1	0	1	106.392821941
467	277	0	0	0	107.987721309
467	282	0	0	0	103.716810673
467	307	0	0	0	88.2343701479
467	319	2	0	2	62.7076112245
467	379	1	0	1	22.8352597143
467	385	2	0	2	25.7221492042
467	386	1	0	1	30.4372644258
467	391	1	0	1	16.8415664746
467	392	0	0	0	20.9146695885
467	396	2	0	2	24.4747080018
467	397	3	1	2	20.7239415238
467	401	1	0	1	37.0432991074
467	406	4	0	4	31.4105705407
467	407	1	0	1	26.6323108497
467	408	31	0	31	31.908983891
467	411	3	0	3	29.4655032813
467	414	1	0	1	36.4694795716
467	415	12	5	7	22.007687226
467	417	3	0	3	24.7208288624
467	427	1	0	1	45.247291191
467	431	2	0	2	55.892159014
467	438	0	0	0	57.4120137542
467	449	2	0	2	4.42701933924
467	450	1	0	1	13.6429820201
467	451	4	2	2	16.273414317
467	454	1	0	1	7.58808064629
467	455	20	8	12	10.4455641851
467	456	2	1	1	10.1468697083
467	457	5	0	5	12.6135944139
467	460	21	4	17	8.39773229487
467	464	4	0	4	36.7842358055
467	465	12	5	7	26.0418323499
467	466	48	15	33	34.286928772
467	468	5	1	4	24.2345458481
467	469	181	3	178	24.0824603602
467	470	7	0	7	22.2454713535
467	471	4	0	4	42.6333822033
467	472	5	0	5	28.7027322441
467	473	7	3	4	16.0052769832
467	474	1	0	1	43.9304018947
467	475	542	30	512	8.45260390474
467	476	4	0	4	35.9937057493
467	477	1	0	1	31.8218537716
467	478	0	0	0	35.8497427229
467	480	2	0	2	32.5217252016
467	482	1	0	1	55.4688929471
467	484	0	0	0	55.0880725284
467	487	1	0	1	53.8188020863
467	488	7	0	7	48.0707231113
467	489	0	0	0	62.7652045946
467	491	8	0	8	38.1499992524
467	493	1	0	1	50.5333867738
467	494	25	3	22	17.8388785119
467	495	2	0	2	29.6607547518
467	496	14	0	14	14.1927098812
467	497	15	2	13	10.1776226134
467	499	2	0	2	24.4382100573
467	500	2	0	2	21.0166283305
467	501	2	0	2	37.9271480193
467	503	41	1	40	21.096280236
467	504	15	9	6	15.9385111434
467	506	1	0	1	45.9875817472
467	566	3	0	3	28.970992705
467	573	8	2	6	37.2629722072
467	581	0	0	0	38.3280237366
468	0	2	0	2	53.7300495905
468	1	26	1	25	60.4982078665
468	6	1	0	1	53.8486601928
468	7	2	0	2	51.6167565035
468	10	0	0	0	48.0812728888
468	13	3	0	3	49.3697698054
468	15	2	0	2	50.8267563421
468	23	0	0	0	50.9259177514
468	26	1	0	1	41.0501619472
468	28	1	0	1	61.9101932562
468	33	1	0	1	43.6989137283
468	34	1	1	0	28.4822567722
468	35	3	0	3	40.9282048886
468	36	10	0	10	45.9284567842
468	39	1	0	1	56.6785783764
468	40	1	0	1	61.4640631654
468	41	0	0	0	40.9996151277
468	46	1	0	1	44.7155206561
468	47	1	0	1	32.4726113033
468	48	12	0	12	25.2629826168
468	49	5	3	2	35.6234340099
468	50	10	0	10	30.212980038
468	51	1	0	1	31.4460666967
468	52	3	0	3	18.3260751011
468	54	1	0	1	23.376183218
468	55	1	0	1	34.3012484748
468	57	1	0	1	19.4542123629
468	59	5	0	5	31.8071697963
468	60	1	0	1	27.8585870949
468	65	3	0	3	43.4891879339
468	68	13	4	9	22.8716829579
468	69	7	0	7	15.8204704331
468	70	2	1	1	57.8138063997
468	71	2	0	2	48.6013915616
468	72	1	0	1	56.934962467
468	73	76	5	71	51.1383328791
468	74	10	1	9	50.7920733647
468	75	9	0	9	48.8902686544
468	76	3	0	3	56.1147488096
468	77	1	0	1	55.6788305463
468	78	10	1	9	52.292393694
468	79	1	0	1	54.7269784676
468	80	0	0	0	54.8803913639
468	81	1	0	1	55.4384782711
468	82	3	0	3	54.2774680671
468	83	6	0	6	51.9595516135
468	84	11	1	10	50.6314011238
468	85	4	0	4	54.4451294114
468	86	2	1	1	50.2252633419
468	87	3	0	3	47.8547221785
468	88	2	0	2	47.5701481573
468	89	1	0	1	61.7985914126
468	92	4	0	4	61.3101684775
468	95	1	0	1	50.303229115
468	97	0	0	0	78.4703782417
468	99	4	0	4	37.4095085193
468	103	8	0	8	45.8897768227
468	105	1	0	1	59.365714439
468	112	9	0	9	46.3410842377
468	113	25	0	25	43.5148978485
468	115	1	0	1	71.0515388661
468	122	0	0	0	67.0542249422
468	124	26	22	4	16.663274553
468	125	2	0	2	22.5932243964
468	126	18	7	11	8.34014073037
468	128	1	0	1	26.539379783
468	129	1	0	1	37.5164503598
468	130	6	0	6	21.7798663952
468	131	388	194	194	5.98236458065
468	132	13	9	4	7.00992942325
468	134	3	1	2	31.6916554475
468	135	4	0	4	24.4091117749
468	136	4	0	4	20.6224475424
468	137	1	0	1	38.2664421923
468	138	2	0	2	31.4166781209
468	139	18	11	7	8.06064387741
468	140	5	1	4	37.4464129937
468	141	1	0	1	21.8467924606
468	142	149	10	139	28.2658773045
468	145	5	2	3	25.3909307277
468	147	90	35	55	18.7274919921
468	148	1	0	1	26.3148803782
468	149	7	0	7	12.7948424959
468	151	19	5	14	10.2973736457
468	152	10	1	9	14.1719802257
468	154	5	0	5	30.167857547
468	155	1	0	1	60.4083731926
468	163	1	0	1	29.6360349907
468	172	1	0	1	43.794065852
468	183	0	0	0	135.077743348
468	188	1	0	1	138.474435882
468	245	1	0	1	71.8688700347
468	257	1	0	1	70.8054925778
468	277	2	0	2	96.7772339238
468	304	1	0	1	60.681278162
468	307	1	0	1	72.9344885866
468	385	1	0	1	49.9259176989
468	408	2	0	2	49.6981240914
468	416	1	0	1	52.962400932
468	433	1	0	1	88.216736598
468	464	42	7	35	16.2215819156
468	465	14	0	14	23.0528454362
468	466	67	11	56	28.1329906808
468	467	2	0	2	24.2345458481
468	469	252	12	240	15.0802663344
468	470	99	19	80	6.01795517543
468	471	7	0	7	21.5732454815
468	472	97	3	94	8.01037855514
468	473	3	0	3	11.027129273
468	474	5	0	5	34.8670011281
468	475	43	7	36	17.3053728402
468	476	41	19	22	11.7801784256
468	477	11	2	9	20.3139878076
468	479	10	2	8	17.3460512163
468	480	22	5	17	15.7185061153
468	482	1	0	1	43.2596034752
468	484	4	0	4	33.9112582052
468	486	1	0	1	40.1525618565
468	487	1	0	1	34.8056303767
468	488	9	1	8	32.4558876418
468	490	1	0	1	27.3850071025
468	491	38	1	37	24.4232458114
468	494	8	2	6	15.9058549928
468	495	5	0	5	32.006770318
468	496	4	0	4	23.6784552119
468	499	1	0	1	28.9834770804
468	500	0	0	0	24.3774610434
468	501	3	0	3	38.9758545738
468	503	4	0	4	32.68365475
468	504	2	0	2	20.0273908725
468	505	4	1	3	40.9321420009
468	506	1	0	1	55.9949512687
468	507	3	0	3	150.255257315
468	561	1	0	1	88.3763907815
468	572	0	0	0	75.8451522206
468	573	2	0	2	56.6570512725
469	0	11	1	10	68.3375213732
469	1	275	13	262	74.1248847593
469	2	2	0	2	60.9718200651
469	3	1	0	1	67.7721360369
469	4	1	0	1	64.0377062542
469	5	5	0	5	70.0809713783
469	6	1	0	1	65.0898790365
469	7	6	0	6	65.9531091566
469	11	1	0	1	78.0075640761
469	12	3	0	3	74.8621437738
469	13	6	0	6	63.933879225
469	15	6	0	6	64.9310843714
469	17	2	0	2	57.7475062365
469	18	1	0	1	64.5283985843
469	20	2	1	1	62.0405965419
469	21	2	0	2	66.7784453945
469	23	6	1	5	64.2444139115
469	24	2	0	2	62.8753462918
469	26	3	0	3	53.6043304458
469	28	4	0	4	75.9587537351
469	29	2	0	2	57.5194863257
469	30	4	1	3	49.4575830874
469	31	1	0	1	52.5086838787
469	32	4	0	4	76.6376627364
469	33	2	1	1	58.3505524452
469	34	6	0	6	42.8154076747
469	35	11	0	11	55.251054396
469	36	37	10	27	60.9638656312
469	37	2	0	2	51.0500058242
469	38	2	0	2	48.7507654642
469	39	2	0	2	71.6618401312
469	41	1	0	1	55.845342127
469	43	2	0	2	47.0536813877
469	45	12	0	12	26.3223716304
469	46	20	1	19	54.0583650739
469	47	3	1	2	36.4445730494
469	48	81	7	74	34.2377346891
469	49	11	0	11	48.1814735681
469	50	49	1	48	42.125002498
469	51	1	0	1	44.5390851097
469	53	4	0	4	67.7968695304
469	55	5	0	5	42.7409902892
469	56	1	0	1	48.6370246122
469	57	7	2	5	26.6770641907
469	58	4	0	4	57.2262035617
469	59	29	0	29	34.9071353117
469	60	17	3	14	38.9392791714
469	61	1	0	1	47.8211460522
469	62	1	0	1	56.8489023299
469	63	0	0	0	40.275408312
469	64	1	0	1	60.0237139793
469	65	14	0	14	50.7500008351
469	66	2	0	2	48.8359501741
469	67	1	1	0	50.6444470312
469	68	17	0	17	35.3723269889
469	69	21	9	12	26.6385957072
469	70	25	0	25	72.2197528296
469	71	8	2	6	62.6324376645
469	72	2	0	2	71.5848795154
469	73	426	54	372	65.7939721236
469	74	40	8	32	65.1163343688
469	75	48	3	45	63.495633485
469	76	8	0	8	70.3661253886
469	77	3	1	2	70.3793205723
469	78	54	19	35	66.5440426581
469	79	8	1	7	69.464606992
469	80	0	0	0	69.5015508285
469	81	17	1	16	70.0110331722
469	82	39	0	39	68.6320314268
469	83	16	0	16	66.4819939948
469	84	50	1	49	65.2005130502
469	85	6	0	6	68.414453508
469	86	14	4	10	64.0997372593
469	87	22	0	22	62.266511644
469	88	6	1	5	61.8089229881
469	89	6	1	5	76.6869434502
469	90	2	0	2	73.6103679385
469	92	6	0	6	75.925708515
469	95	6	2	4	65.308187055
469	96	2	0	2	78.7608769288
469	98	3	1	2	63.255396469
469	99	5	0	5	52.3996749936
469	102	3	0	3	72.7453501388
469	103	44	1	43	60.701732202
469	104	0	0	0	69.614337618
469	105	1	0	1	74.3871858968
469	107	2	1	1	57.424207247
469	108	0	0	0	84.2423448484
469	110	10	0	10	56.7431895428
469	111	1	0	1	80.8764366376
469	112	39	2	37	61.2933816571
469	113	102	0	102	58.074618357
469	115	1	0	1	85.6555346062
469	116	2	0	2	71.8955242521
469	117	2	0	2	59.5607474913
469	118	2	0	2	70.1204267819
469	119	1	0	1	68.9749856225
469	120	3	2	1	70.0903456309
469	122	1	0	1	81.469399885
469	124	38	0	38	31.6455790181
469	125	2	0	2	37.5280131872
469	126	6	2	4	23.1512223943
469	127	3	1	2	49.8334139144
469	128	21	0	21	39.7220643029
469	129	4	2	2	52.5956338848
469	131	153	74	79	18.2875939188
469	132	10	0	10	13.3449495268
469	133	5	0	5	46.850925592
469	134	7	0	7	46.4717234949
469	135	5	0	5	34.9568399125
469	136	5	0	5	35.5014833662
469	137	1	0	1	51.4959667577
469	138	2	1	1	46.4533382125
469	139	5	1	4	20.5377302337
469	140	10	0	10	52.0966884131
469	141	14	0	14	26.5267555869
469	142	440	89	351	42.6584235962
469	143	9	3	6	34.1552836881
469	144	3	0	3	45.456494578
469	145	4	0	4	40.4524726152
469	146	1	0	1	56.4458112625
469	147	86	22	64	29.1559074796
469	148	3	0	3	41.3426867513
469	149	14	1	13	18.3172158446
469	150	1	0	1	22.6172621699
469	151	8	0	8	24.7901886702
469	152	4	0	4	28.8870804826
469	153	1	0	1	26.290333781
469	154	10	2	8	42.0799163671
469	155	1	0	1	73.0862560389
469	157	0	0	0	51.4472048853
469	160	1	0	1	48.2684965457
469	163	0	0	0	38.9934063408
469	164	5	0	5	63.2473763003
469	165	1	0	1	58.4637621054
469	167	0	0	0	49.5175630359
469	171	4	1	3	68.3424071447
469	172	1	0	1	55.8582934467
469	177	0	0	0	60.0391856281
469	183	4	0	4	150.012115494
469	191	1	0	1	172.24659847
469	196	1	0	1	171.531674465
469	207	1	0	1	140.580916923
469	208	3	0	3	144.244326931
469	212	1	0	1	133.818013138
469	220	3	0	3	169.22591662
469	223	0	0	0	156.044409288
469	229	2	0	2	152.422880168
469	237	1	0	1	136.131754411
469	242	1	0	1	184.730350793
469	244	1	0	1	185.473084319
469	245	4	0	4	86.876184914
469	246	1	0	1	87.8392435815
469	247	2	0	2	100.097874981
469	253	1	0	1	105.672828787
469	255	1	0	1	93.7226459393
469	257	3	0	3	85.882772774
469	277	27	0	27	111.843836304
469	282	0	0	0	109.906878773
469	291	1	0	1	128.656576127
469	293	1	0	1	118.716415987
469	303	7	0	7	82.8207430266
469	305	1	0	1	96.277940121
469	307	1	0	1	87.6755986277
469	309	1	0	1	80.1828476993
469	319	2	0	2	84.0497854028
469	320	1	0	1	81.574592207
469	338	1	0	1	108.396085982
469	349	2	0	2	96.0257530368
469	350	1	0	1	106.568245733
469	384	1	0	1	46.1902728355
469	392	1	0	1	43.5402070176
469	394	1	0	1	42.4111564851
469	395	1	0	1	51.4413284913
469	396	2	0	2	31.3548413814
469	397	4	1	3	28.8919621106
469	399	2	0	2	28.392944021
469	401	1	0	1	45.540726939
469	406	16	4	12	35.1836324721
469	408	33	10	23	39.1666921674
469	410	1	0	1	37.0493327476
469	411	3	0	3	41.1895431833
469	414	2	0	2	34.4361953964
469	415	7	0	7	34.3660786957
469	416	4	0	4	40.4384168326
469	426	3	1	2	67.9281815653
469	431	0	0	0	57.0572408732
469	437	1	0	1	92.3786989761
469	438	1	0	1	64.8544556941
469	442	1	0	1	55.3535917049
469	450	1	0	1	37.3025383074
469	451	1	0	1	25.766522897
469	455	1	0	1	34.2185394854
469	456	1	0	1	30.9025335554
469	457	1	0	1	23.7781865729
469	460	2	0	2	27.0266201807
469	463	12	2	10	21.0115800613
469	464	244	16	228	15.3205585301
469	465	616	9	607	8.10515613669
469	466	1828	43	1785	13.5533253697
469	467	6	0	6	24.0824603602
469	468	64	9	55	15.0802663344
469	470	255	111	144	9.14625065136
469	471	80	0	80	20.628908732
469	472	249	74	175	11.0007674964
469	473	27	0	27	9.54639055073
469	474	84	0	84	21.8036088848
469	475	567	0	567	15.7453353228
469	476	118	21	97	21.3428445909
469	477	369	121	248	7.90138519058
469	478	40	15	25	18.7277422916
469	479	19	2	17	21.0347037634
469	480	374	22	352	9.47963667504
469	481	11	1	10	33.2020732681
469	482	40	3	37	32.2745070888
469	483	4	1	3	39.8029979052
469	484	91	1	90	32.2804187253
469	485	52	0	52	33.1301265886
469	486	19	3	16	34.3071653538
469	487	59	0	59	30.0557729909
469	488	86	0	86	24.0002999414
469	489	9	4	5	38.7023885299
469	490	19	5	14	22.7416147563
469	491	424	17	407	14.114399798
469	492	12	0	12	23.7951895421
469	493	23	6	17	30.4220382277
469	494	394	117	277	6.46414803654
469	495	158	46	112	17.3066998892
469	496	69	0	69	14.7123864719
469	497	7	0	7	20.2167975005
469	499	44	12	32	15.287311613
469	500	70	7	63	11.4425072391
469	501	88	7	81	23.9101494111
469	502	15	6	9	24.63098277
469	503	246	53	193	21.2488510328
469	504	80	40	40	10.3756164932
469	505	95	0	95	26.1623293805
469	506	8	0	8	41.8691205251
469	507	1	0	1	144.354896329
469	524	1	0	1	80.8001822309
469	540	0	0	0	110.327115289
469	551	0	0	0	77.0696360305
469	554	0	0	0	75.2199054142
469	555	4	0	4	80.5414974346
469	559	1	0	1	86.1038278195
469	563	1	0	1	72.6529186443
469	565	2	0	2	123.869759037
469	573	2	0	2	61.0988902327
469	581	0	0	0	59.7893858939
469	586	4	0	4	99.2672006355
470	0	3	0	3	59.6839449882
470	1	37	13	24	66.1575398777
470	3	1	0	1	58.9393584667
470	5	1	0	1	62.8435287535
470	13	9	1	8	55.3107182751
470	15	1	0	1	56.6330077618
470	21	1	0	1	59.2319608331
470	22	1	0	1	70.8249346064
470	23	2	0	2	56.4657305482
470	24	1	0	1	54.9326487599
470	25	1	0	1	64.8178823387
470	33	1	0	1	49.6597633349
470	35	3	0	3	46.7933165248
470	36	14	7	7	51.9419494828
470	38	1	0	1	39.942801988
470	39	1	0	1	62.6965204017
470	41	1	0	1	47.0021991932
470	42	3	0	3	58.1164053492
470	45	1	0	1	24.6116962933
470	46	3	0	3	48.6886766014
470	48	13	0	13	28.8409532587
470	49	1	0	1	40.8322540485
470	50	8	0	8	35.1259987855
470	54	1	0	1	29.1322584269
470	56	1	0	1	42.7766292543
470	59	7	1	6	33.0049303688
470	60	3	0	3	32.397732111
470	63	1	0	1	37.3477297393
470	65	6	2	4	46.60299024
470	68	8	0	8	27.9637300911
470	69	2	0	2	19.9955456881
470	70	6	0	6	63.2467470637
470	71	2	0	2	53.7998876457
470	72	1	0	1	62.5240173172
470	73	74	0	74	56.7290323472
470	74	5	0	5	56.1697764547
470	75	13	2	11	54.4462537192
470	76	1	0	1	61.452053318
470	78	4	0	4	57.6268646146
470	79	0	0	0	60.3751165978
470	80	1	0	1	60.4495572985
470	81	4	0	4	60.975971464
470	82	8	3	5	59.676432082
470	83	5	0	5	57.4628731934
470	84	6	0	6	56.1643451425
470	85	3	0	3	59.6140200839
470	86	3	0	3	55.3340817548
470	87	6	2	4	53.2847702001
470	96	1	0	1	70.128124993
470	99	1	0	1	43.2536980592
470	103	10	1	9	51.5887596456
470	105	1	0	1	65.2411504655
470	107	3	0	3	48.9065038738
470	109	1	0	1	67.5834738547
470	110	2	0	2	47.6089778594
470	111	1	0	1	71.7922199039
470	112	2	1	1	52.1513288606
470	113	27	0	27	49.037413467
470	124	16	0	16	22.679558592
470	126	11	1	10	14.0105775755
470	128	1	0	1	31.1736004857
470	129	1	0	1	43.4806545103
470	130	5	0	5	26.1024283019
470	131	172	52	120	10.4287377553
470	132	14	8	6	6.05994813514
470	133	2	1	1	37.7177915915
470	134	3	1	2	37.3612050149
470	135	0	0	0	27.528707564
470	136	2	0	2	26.3645871697
470	137	1	0	1	42.9807935275
470	139	6	2	4	11.9063609874
470	140	7	1	6	43.0261023664
470	141	3	1	2	21.8869732233
470	142	101	0	101	33.6598799258
470	143	6	1	5	25.2466172731
470	144	2	0	2	36.8402459342
470	145	4	0	4	31.3186320974
470	147	38	0	38	21.6553659686
470	148	1	0	1	32.3312759705
470	149	8	1	7	12.5772487878
470	150	1	1	0	16.0873239102
470	151	14	1	13	16.1340884814
470	152	1	0	1	19.7717224005
470	154	6	0	6	34.1043774874
470	155	1	0	1	64.8777260023
470	163	2	0	2	32.213661651
470	183	1	0	1	141.094876936
470	188	0	0	0	144.473407016
470	208	1	0	1	135.162766812
470	220	1	0	1	160.223415019
470	229	1	0	1	143.276995933
470	242	0	0	0	175.630646774
470	245	1	0	1	77.7300227021
470	272	1	0	1	116.522086654
470	277	3	0	3	102.775163758
470	282	0	0	0	100.763886688
470	293	1	0	1	109.610149879
470	297	1	0	1	117.012765105
470	303	1	0	1	74.5682488197
470	348	1	0	1	85.6837074006
470	406	1	0	1	41.4569168968
470	408	3	0	3	44.6872983458
470	415	1	0	1	38.0597696982
470	416	1	0	1	47.4168449055
470	442	1	0	1	62.3417988681
470	464	65	9	56	14.8213836446
470	465	30	8	22	17.0457024189
470	466	180	106	74	22.4707692618
470	467	4	0	4	22.2454713535
470	468	123	6	117	6.01795517543
470	469	912	368	544	9.14625065136
470	471	25	16	9	20.6523781735
470	472	128	107	21	6.46005631857
470	473	34	2	32	6.70198543991
470	474	4	0	4	29.8372786139
470	475	229	33	196	14.2303909105
470	476	53	16	37	15.1032460684
470	477	26	8	18	15.193918138
470	478	3	1	2	27.8736354935
470	479	5	0	5	18.1605161223
470	480	65	25	40	12.0588144064
470	481	2	0	2	38.7229184667
470	482	1	0	1	39.0999528412
470	483	0	0	0	47.2618270464
470	484	1	0	1	33.217777652
470	485	2	0	2	41.1498041983
470	486	2	1	1	37.9290473554
470	487	3	0	3	32.900039828
470	488	13	0	13	29.0830554345
470	490	2	0	2	25.2885288309
470	491	49	0	49	20.1417834533
470	492	1	0	1	30.8898589021
470	494	62	32	30	10.2765163048
470	495	16	8	8	25.9932326775
470	496	13	1	12	18.6699649634
470	499	3	0	3	23.0816963113
470	500	4	0	4	18.5507661759
470	501	5	1	4	32.9902788763
470	503	23	1	22	27.2783371009
470	504	9	1	8	14.6765197088
470	505	8	0	8	35.211136192
470	506	1	0	1	50.0825029759
470	507	1	0	1	147.051041486
470	559	1	0	1	84.4816739566
471	0	1	0	1	60.6180245478
471	1	73	15	58	62.7904750078
471	2	1	0	1	51.4818985082
471	5	3	0	3	56.4635638438
471	6	3	0	3	49.7016039223
471	7	3	0	3	57.2282688106
471	12	1	0	1	61.1429762189
471	13	1	0	1	56.2661329066
471	15	1	0	1	55.4581765672
471	17	1	0	1	46.7912786844
471	18	1	0	1	57.9864994005
471	20	2	0	2	49.1272418821
471	23	1	0	1	52.6609436568
471	25	1	0	1	54.727877786
471	26	1	0	1	41.1926105168
471	27	2	0	2	43.3784003346
471	28	1	0	1	65.7487356948
471	29	3	0	3	42.2339494429
471	30	1	0	1	41.5176933748
471	32	1	0	1	70.4116258569
471	33	2	0	2	51.4783631285
471	35	4	1	3	47.2407300193
471	36	4	1	3	56.790565468
471	41	2	0	2	50.269383787
471	42	2	0	2	62.0273251924
471	43	3	0	3	26.7757586785
471	45	65	37	28	6.57999882148
471	46	7	1	6	36.9643783809
471	47	11	3	8	16.4651653635
471	48	67	8	59	19.3384774235
471	49	11	0	11	36.3522983232
471	50	24	1	23	29.9598818979
471	51	1	0	1	34.328042294
471	52	1	0	1	26.8335996406
471	54	1	0	1	31.1986993845
471	55	3	0	3	25.6690467193
471	56	1	0	1	32.8553748502
471	57	11	0	11	12.3803876226
471	58	3	0	3	38.6513782065
471	59	117	1	116	14.6300233452
471	60	7	2	5	25.9733919156
471	61	1	0	1	28.3950416842
471	62	1	0	1	36.6067907379
471	63	1	0	1	20.5949836172
471	65	9	0	9	31.960635819
471	66	2	0	2	35.1327966765
471	68	22	1	21	25.7641134522
471	69	33	3	30	17.5519085532
471	70	1	1	0	74.3379404757
471	71	1	0	1	66.373177917
471	72	1	0	1	72.6304376395
471	73	37	1	36	67.0173942021
471	74	6	0	6	67.778766591
471	75	25	7	18	65.0536051661
471	76	1	0	1	73.126312241
471	78	5	2	3	69.4221068959
471	79	1	0	1	70.1159585162
471	80	0	0	0	70.7596500517
471	81	2	0	2	71.4821738098
471	82	2	0	2	71.0625113841
471	83	3	1	2	68.3004963634
471	84	3	0	3	66.8588115061
471	86	1	0	1	68.2627902217
471	87	2	1	1	64.7004947602
471	96	1	0	1	83.3089458674
471	99	1	0	1	52.080692615
471	102	1	0	1	69.1174163318
471	103	6	0	6	61.2793581188
471	112	9	1	8	60.806839119
471	113	21	5	16	60.0764103015
471	114	1	0	1	57.5141648218
471	120	1	0	1	69.7928256892
471	121	1	0	1	61.2231288256
471	124	5	0	5	30.5289268975
471	126	4	1	3	27.887121565
471	130	4	0	4	42.4186665089
471	131	42	0	42	18.078460985
471	133	1	0	1	45.901017746
471	134	2	0	2	48.1090822658
471	136	2	0	2	37.6946662318
471	139	2	0	2	29.5780256866
471	140	2	0	2	54.0044243311
471	141	1	0	1	42.444106666
471	142	37	15	22	46.233262025
471	143	2	0	2	39.4559519928
471	144	1	0	1	51.5004211202
471	145	1	0	1	40.2742709719
471	146	2	0	2	60.5685258294
471	147	4	0	4	40.2694502658
471	151	3	0	3	23.7568546248
471	153	1	0	1	34.9175263072
471	154	3	0	3	50.9884160267
471	155	1	0	1	79.9262679498
471	163	0	0	0	51.1873584869
471	171	1	0	1	74.7195885105
471	175	0	0	0	73.5033652686
471	183	2	0	2	142.487039202
471	196	1	0	1	169.464868466
471	200	1	0	1	159.752375216
471	229	1	0	1	149.444178995
471	246	2	0	2	87.3234776083
471	264	1	0	1	85.0358033844
471	277	3	0	3	106.63210384
471	282	0	0	0	106.764676519
471	307	1	0	1	79.869611412
471	309	1	0	1	72.9537806248
471	408	4	0	4	59.0308838932
471	415	2	0	2	54.9578511817
471	416	1	0	1	58.8160587773
471	464	245	76	169	5.85444285529
471	465	10	1	9	25.6998261554
471	466	132	0	132	23.8908975683
471	468	3	0	3	21.5732454815
471	469	195	22	173	20.628908732
471	470	2	0	2	20.6523781735
471	472	44	0	44	14.3586244597
471	474	8	0	8	23.9926593276
471	475	10	0	10	34.2974312602
471	476	173	26	147	14.4271079119
471	477	13	0	13	16.5001108898
471	478	7	0	7	30.6176778367
471	479	48	43	5	6.53675440329
471	480	82	2	80	11.1788593535
471	481	10	0	10	23.1949375118
471	482	17	1	16	26.799479289
471	483	2	0	2	35.7887617572
471	484	351	217	134	12.5716407773
471	485	2	0	2	32.6012278904
471	486	18	5	13	19.1350802616
471	487	113	4	109	13.5834308987
471	488	87	28	59	14.7844981061
471	489	35	5	30	23.9322144181
471	490	31	6	25	7.09528219786
471	491	80	0	80	13.6270053759
471	492	3	0	3	21.3843796428
471	493	3	0	3	33.504607481
471	494	4	0	4	26.7219988831
471	495	5	1	4	33.7088771971
471	496	1	0	1	35.3344734057
471	497	1	0	1	40.6729033034
471	501	1	0	1	36.7003672674
471	503	6	0	6	41.2505702679
471	504	1	1	0	30.974276308
471	505	6	0	6	34.1365728321
471	507	3	0	3	164.962852675
471	538	2	0	2	115.902898513
471	552	1	0	1	115.851017487
471	555	1	0	1	98.9361886693
471	560	1	0	1	100.201810012
472	0	1	0	1	57.9978269147
472	1	42	4	38	63.2594581029
472	3	1	0	1	57.7135633802
472	5	1	0	1	59.0808933164
472	7	1	0	1	55.40811526
472	9	2	0	2	61.1929708399
472	12	1	0	1	63.8623325412
472	13	3	0	3	53.5708003206
472	15	2	0	2	54.2593856805
472	17	2	0	2	46.857982368
472	23	2	0	2	53.3266007204
472	26	1	0	1	42.6134764524
472	28	1	0	1	65.2339350028
472	29	1	0	1	46.6109546543
472	30	1	0	1	38.8961986319
472	34	2	0	2	32.4107764928
472	35	5	0	5	44.7432354061
472	36	16	2	14	51.42698002
472	37	1	0	1	40.2249765135
472	38	1	0	1	38.7545781027
472	39	1	0	1	61.8917284846
472	44	1	0	1	50.7254951021
472	45	5	1	4	18.1603906309
472	46	5	1	4	43.4709344743
472	47	2	0	2	27.7123559022
472	48	32	0	32	23.557245588
472	49	8	1	7	37.197403237
472	50	9	0	9	31.1242407436
472	52	2	0	2	21.790338619
472	54	1	0	1	27.004690689
472	55	2	0	2	32.312345034
472	57	2	0	2	16.2845127989
472	59	10	1	9	26.5955708184
472	60	5	1	4	27.9667837501
472	65	5	0	5	40.7951742864
472	68	17	1	16	24.4237015588
472	69	12	0	12	15.6379692094
472	70	6	0	6	65.1188198584
472	71	4	0	4	56.1729097593
472	73	68	0	68	58.2380941985
472	74	6	1	5	58.1823392949
472	75	13	10	3	56.0535645851
472	76	3	1	2	63.5346392556
472	77	2	1	1	62.7079398465
472	78	4	0	4	59.7253204894
472	79	2	1	1	61.7132644355
472	80	2	0	2	62.0019862557
472	81	1	0	1	62.6071365417
472	82	4	0	4	61.6331468678
472	83	1	0	1	59.1887148073
472	84	7	2	5	57.8227261884
472	85	1	0	1	62.0270006259
472	86	3	0	3	57.8636693578
472	87	5	0	5	55.1934784624
472	88	2	0	2	55.0298168206
472	89	4	0	4	68.5225814037
472	90	1	0	1	67.5932077755
472	92	1	0	1	68.4151273767
472	95	5	1	4	56.7868402336
472	96	3	1	2	72.855984628
472	98	1	0	1	57.631259722
472	103	7	0	7	52.8133227873
472	110	4	0	4	48.6361409476
472	112	11	0	11	52.9953435395
472	113	34	0	34	50.7500051892
472	124	23	2	21	22.3235495851
472	125	1	0	1	27.9339253781
472	126	12	0	12	15.9014040276
472	127	1	0	1	43.1803215376
472	128	4	0	4	34.475411088
472	129	1	0	1	43.6116093033
472	130	1	0	1	29.7812311455
472	131	237	115	122	8.01893711537
472	132	5	0	5	12.114644039
472	133	1	0	1	38.1220867188
472	134	2	0	2	38.7667272551
472	135	2	0	2	32.2849396472
472	136	2	0	2	27.6994785491
472	139	4	1	3	15.9716814882
472	140	2	1	1	44.6294187688
472	142	135	36	99	35.7494105011
472	143	6	0	6	27.8668311236
472	145	4	0	4	31.8369684081
472	147	29	1	28	26.516102325
472	148	1	0	1	31.9602766858
472	149	1	0	1	18.7265353589
472	151	16	0	16	15.0313046794
472	152	9	0	9	21.6191609741
472	153	1	0	1	21.7326679527
472	154	2	0	2	38.1776064464
472	163	1	0	1	37.3613382364
472	168	1	0	1	55.3554923902
472	171	1	0	1	63.2989312392
472	172	1	0	1	51.7971802306
472	183	0	0	0	139.990713862
472	188	1	0	1	143.969339066
472	208	0	0	0	136.340813563
472	220	1	0	1	159.414856949
472	241	1	0	1	181.611247912
472	256	1	0	1	68.9108724111
472	262	1	0	1	91.9178301146
472	276	1	0	1	105.178050093
472	277	2	0	2	102.338647581
472	281	0	0	0	97.084301449
472	282	0	0	0	101.029409195
472	303	1	0	1	72.0872099136
472	304	1	0	1	64.8673661304
472	305	1	0	1	86.4287651677
472	309	2	0	2	70.0231550168
472	334	1	0	1	113.508777484
472	392	1	0	1	49.5158662041
472	397	1	0	1	38.6885953757
472	415	2	0	2	43.6510584002
472	464	254	74	180	8.63014469747
472	465	24	22	2	18.8713591875
472	466	197	23	174	22.0475610854
472	467	1	0	1	28.7027322441
472	468	130	6	124	8.01037855514
472	469	688	55	633	11.0007674964
472	470	118	2	116	6.46005631857
472	471	29	0	29	14.3586244597
472	473	6	1	5	12.9641520975
472	474	13	1	12	27.6068865499
472	475	54	0	54	20.6149613844
472	476	171	3	168	10.3474460497
472	477	39	3	36	13.5416081615
472	478	4	1	3	28.332812916
472	479	17	2	15	11.7776802755
472	480	268	147	121	7.92058155915
472	481	4	1	3	34.0801313285
472	482	4	0	4	35.3757745226
472	484	18	5	13	26.9235898728
472	485	3	0	3	38.5809847609
472	486	2	0	2	32.350645846
472	487	4	0	4	27.1129691047
472	488	11	1	10	24.4476295745
472	490	5	0	5	19.5834340142
472	491	83	2	81	16.7198098861
472	492	2	0	2	27.6394161341
472	493	4	1	3	37.2888631182
472	494	19	0	19	15.0255075128
472	495	15	4	11	28.1230275369
472	496	4	0	4	23.9064017265
472	499	1	0	1	26.2748388526
472	500	3	0	3	22.2295403223
472	501	4	0	4	34.0283537596
472	503	17	3	14	31.7388702806
472	504	7	1	6	19.621743222
472	505	9	0	9	34.7538674466
472	559	1	0	1	90.9183599725
472	573	2	0	2	63.3893699003
473	1	12	0	12	71.3570920927
473	5	1	0	1	68.6164583364
473	13	1	0	1	59.7367540716
473	15	0	0	0	61.5187738103
473	21	0	0	0	64.8117932905
473	22	1	0	1	76.3907068836
473	34	2	0	2	39.168207199
473	36	3	0	3	55.4085579824
473	37	1	0	1	48.4218515464
473	41	0	0	0	51.0472605109
473	46	1	1	0	55.2172757239
473	48	5	0	5	35.4365475123
473	49	1	0	1	46.6499760441
473	50	1	0	1	41.184446713
473	52	1	0	1	29.2680716933
473	58	0	0	0	59.3842148432
473	59	2	1	1	39.5537095121
473	60	1	0	1	38.675426098
473	69	1	0	1	26.3805663705
473	70	3	0	3	64.2748075414
473	71	1	0	1	54.3911635672
473	73	50	1	49	58.2165083454
473	74	3	0	3	57.128275547
473	75	8	0	8	55.8612840773
473	76	1	0	1	62.2702845424
473	78	9	0	9	58.472634601
473	82	1	0	1	60.6522628517
473	83	3	1	2	58.7132722809
473	84	5	0	5	57.5026683817
473	85	1	0	1	60.0846119527
473	86	1	0	1	55.7258293832
473	87	2	0	2	54.3957373089
473	88	1	0	1	53.7598641144
473	89	2	0	2	69.4858428911
473	92	1	0	1	68.2263486625
473	95	2	0	2	58.5402864118
473	99	1	0	1	45.6961101402
473	102	1	0	1	66.6753025831
473	103	5	1	4	53.4387421898
473	107	1	0	1	48.7278472951
473	110	5	0	5	49.7199013661
473	112	2	0	2	54.3706112224
473	113	12	0	12	50.4242760094
473	122	1	0	1	73.488968026
473	124	5	0	5	26.7779518646
473	125	0	0	0	32.6857606691
473	126	3	2	1	17.0427478939
473	131	23	0	23	16.5627183678
473	132	17	11	6	5.33987512787
473	134	2	1	1	39.3191259934
473	135	1	0	1	25.6462205536
473	139	2	0	2	12.8416590153
473	140	4	0	4	44.6424142085
473	141	10	1	9	17.1473841714
473	142	61	19	42	35.018618169
473	146	2	0	2	48.216002847
473	147	61	21	40	19.9472487966
473	149	13	0	13	8.80019442402
473	150	2	0	2	13.1718300491
473	151	3	0	3	21.1657744104
473	154	12	1	11	32.9998725362
473	160	2	0	2	39.1396831483
473	177	0	0	0	50.7172727435
473	183	1	0	1	144.664215006
473	208	1	0	1	136.569973675
473	245	1	0	1	80.0025946517
473	254	2	0	2	88.006271066
473	256	0	0	0	72.0047177992
473	277	2	0	2	105.840866724
473	282	0	0	0	103.181424777
473	293	1	0	1	111.219734443
473	392	0	0	0	36.6331171108
473	397	1	0	1	27.226840211
473	399	1	0	1	31.1660011967
473	406	2	0	2	35.8316415198
473	408	3	0	3	38.6710036408
473	411	2	0	2	39.0203417289
473	415	1	0	1	31.5503677055
473	442	1	0	1	56.9696193209
473	451	1	0	1	23.1318561007
473	455	1	0	1	25.4956010519
473	460	1	1	0	21.1131269357
473	463	1	0	1	30.2480135313
473	464	14	0	14	20.7907943882
473	465	10	0	10	15.3266490183
473	466	96	12	84	22.5539165902
473	467	3	0	3	16.0052769832
473	468	9	0	9	11.027129273
473	469	362	227	135	9.54639055073
473	470	72	67	5	6.70198543991
473	471	6	0	6	26.6346611842
473	472	26	1	25	12.9641520975
473	474	6	0	6	31.2837663519
473	475	567	504	63	7.6942524903
473	476	16	0	16	21.6751753603
473	477	12	0	12	17.3508374803
473	478	2	0	2	26.6523228069
473	480	12	4	8	16.6906833518
473	481	3	0	3	42.4240492983
473	482	1	0	1	41.7936080512
473	485	1	0	1	42.5722780002
473	488	2	0	2	33.0012262804
473	491	15	0	15	23.3270519725
473	493	3	0	3	39.5786110245
473	494	78	0	78	6.01550613725
473	495	8	0	8	23.0895985863
473	496	13	10	3	12.6684010982
473	497	3	1	2	15.8923356095
473	499	3	1	2	19.1733569171
473	500	7	4	3	14.4190037195
473	501	4	1	3	30.9180977637
473	503	17	0	17	21.8205574736
473	504	27	18	9	9.28055364858
473	505	2	0	2	34.6141545825
473	506	2	0	2	45.9189544602
473	569	1	0	1	58.7271487311
473	571	0	0	0	51.9553332633
473	576	1	0	1	57.7994723324
474	0	1	0	1	83.6775915312
474	1	14	2	12	86.6777637862
474	5	1	0	1	80.4482189879
474	6	0	0	0	73.5055939733
474	13	1	0	1	79.2637093809
474	23	1	0	1	76.53819803
474	34	1	0	1	58.4960970155
474	35	1	0	1	70.2304501024
474	36	0	0	0	78.4186773088
474	45	1	0	1	30.1404983413
474	46	2	0	2	60.4083527178
474	48	5	2	3	43.3018547477
474	50	4	2	2	53.7218129255
474	56	1	0	1	56.7348342936
474	57	1	0	1	36.0139973656
474	59	3	0	3	36.2724588857
474	65	2	0	2	54.4649116799
474	68	1	0	1	48.7307756011
474	69	2	0	2	39.7754677979
474	71	1	0	1	83.4613248717
474	73	17	1	16	85.8256409094
474	74	7	0	7	85.6420436367
474	75	3	0	3	83.6236815219
474	78	1	0	1	87.1529799586
474	82	1	0	1	89.1173600107
474	84	0	0	0	85.3846350069
474	85	0	0	0	89.3003214614
474	87	4	0	4	82.6855364176
474	92	0	0	0	96.0048778902
474	95	1	0	1	84.316897926
474	96	1	0	1	99.9255705145
474	102	0	0	0	90.6454737882
474	103	3	0	3	80.4198248059
474	107	2	0	2	78.7420436097
474	112	1	0	1	80.5768273311
474	113	7	1	6	78.2913833944
474	117	1	0	1	80.0731077383
474	122	0	0	0	101.860785611
474	124	1	0	1	49.7815204844
474	128	2	0	2	61.0105348253
474	131	8	0	8	35.3984382577
474	134	2	2	0	66.3475556419
474	140	3	1	2	72.185772567
474	141	0	0	0	47.8229774
474	142	26	0	26	63.127006631
474	144	0	0	0	66.6657916103
474	145	5	0	5	59.4148896312
474	146	2	0	2	77.3139689911
474	147	1	0	1	50.9213455039
474	152	1	0	1	49.0020571281
474	154	1	0	1	63.751916506
474	173	0	0	0	83.3849159283
474	177	1	0	1	81.8157695738
474	183	1	0	1	165.823877336
474	208	0	0	0	163.931202322
474	277	1	0	1	129.091150624
474	296	1	0	1	129.969742082
474	305	1	0	1	112.791957763
474	319	1	0	1	105.584537506
474	406	3	1	2	39.9965213623
474	408	1	0	1	45.4517612424
474	410	1	0	1	45.5012257693
474	415	1	0	1	45.7255226236
474	431	1	0	1	54.1920749626
474	438	0	0	0	66.5473430063
474	463	39	2	37	3.64567694258
474	464	13	0	13	23.6040468489
474	465	36	6	30	17.9322347628
474	466	921	530	391	9.72964542459
474	468	1	0	1	34.8670011281
474	469	183	15	168	21.8036088848
474	470	4	0	4	29.8372786139
474	471	12	5	7	23.9926593276
474	472	9	0	9	27.6068865499
474	475	9	0	9	36.3426097758
474	476	8	2	6	35.1193671257
474	477	23	5	18	14.6470696855
474	478	41	1	40	11.9612729051
474	479	1	0	1	29.4442306839
474	480	30	0	30	19.8402636742
474	481	17	6	11	16.3209041409
474	482	107	0	107	12.0774355892
474	483	16	0	16	18.1933141064
474	484	15	5	10	27.889195548
474	485	90	19	71	11.3489299103
474	486	4	0	4	22.3783582535
474	487	10	1	9	21.6969736477
474	488	51	0	51	12.4428677599
474	489	6	3	3	24.8548028095
474	490	1	0	1	19.1288545272
474	491	73	33	40	11.3952785747
474	492	49	19	30	5.08316843716
474	493	82	0	82	9.86863113741
474	494	4	0	4	26.669486728
474	495	28	1	27	18.8908235555
474	496	4	0	4	30.7815532551
474	499	5	1	4	22.7924358975
474	501	32	3	29	16.4852311521
474	503	3	0	3	30.799040853
474	504	3	0	3	28.0247145196
474	505	70	3	67	10.8964451435
474	506	1	0	1	37.254816657
474	515	1	0	1	100.647318666
474	582	1	0	1	124.812774636
475	0	3	0	3	67.6811457834
475	1	51	3	48	76.0482225836
475	2	1	0	1	62.200894999
475	3	1	0	1	66.1422093891
475	5	3	0	3	74.1206894587
475	13	2	0	2	63.5258906954
475	15	2	0	2	65.8698860445
475	21	2	0	2	70.0619212162
475	24	2	0	2	65.073933229
475	27	1	0	1	62.1560294768
475	28	2	0	2	76.8731674067
475	29	0	0	0	63.681707923
475	34	1	0	1	43.7590927299
475	35	1	0	1	55.8105229129
475	36	19	0	19	58.0902390447
475	45	3	0	3	38.7541201291
475	48	8	0	8	42.45318736
475	49	2	0	2	52.3649453887
475	50	4	1	3	47.28517493
475	54	1	0	1	39.2122284486
475	57	1	0	1	36.0912230804
475	59	11	0	11	47.2095806534
475	60	2	0	2	45.1183327215
475	65	8	5	3	60.5267315595
475	68	4	0	4	39.8738130381
475	69	3	0	3	33.1127157891
475	70	27	3	24	63.9752820918
475	71	7	0	7	53.7460626562
475	72	3	0	3	64.1376266573
475	73	509	72	437	58.5373000594
475	74	30	3	27	56.8564745686
475	75	75	5	70	56.1379928379
475	76	7	1	6	61.7567718482
475	77	1	0	1	63.1548110358
475	78	47	1	46	58.0487240856
475	79	5	1	4	62.4139367513
475	80	1	0	1	62.0090307983
475	81	20	1	19	62.3380877731
475	82	24	2	22	60.34401988
475	83	19	0	19	58.7519561204
475	84	39	2	37	57.6626810983
475	85	9	0	9	59.2042169643
475	86	19	0	19	54.8272750331
475	87	18	4	14	54.348270383
475	88	7	0	7	53.4441066243
475	89	2	1	1	70.1675981801
475	92	8	0	8	68.2474888565
475	96	6	1	5	68.5863376163
475	98	1	0	1	53.1696335672
475	99	1	0	1	47.3693994161
475	102	1	0	1	68.6874192614
475	103	38	13	25	54.2624776224
475	105	1	0	1	68.8849553562
475	107	1	0	1	47.3180767766
475	109	2	0	2	67.4033367357
475	110	23	0	23	50.9196916089
475	111	1	0	1	73.5193090742
475	112	29	0	29	55.605577494
475	113	125	2	123	50.774313976
475	116	1	0	1	62.8675127585
475	117	2	0	2	51.5464727827
475	120	1	0	1	63.6987772574
475	121	2	0	2	50.04479564
475	124	13	0	13	30.9512143754
475	125	2	0	2	36.5941032468
475	126	2	0	2	20.9660049477
475	127	2	0	2	41.9487806907
475	128	7	0	7	30.6889726218
475	129	2	0	2	48.8399900873
475	130	8	0	8	25.4577270957
475	131	70	0	70	23.2322491789
475	132	25	1	24	10.332548696
475	133	3	0	3	42.9640899859
475	134	9	0	9	40.6230545229
475	135	8	0	8	23.2306476105
475	136	1	0	1	31.1245132639
475	137	1	0	1	41.6110206364
475	139	12	0	12	15.6274122111
475	140	11	1	10	45.3956909013
475	141	175	4	171	11.7075321289
475	142	348	0	348	35.8112488963
475	143	6	0	6	27.4709099933
475	144	6	0	6	36.2831365845
475	145	3	0	3	36.9629424969
475	146	3	0	3	47.7013336895
475	147	405	208	197	18.353178489
475	148	1	0	1	39.4523288283
475	149	97	4	93	7.66227892024
475	150	18	11	7	11.3703955647
475	151	5	0	5	26.5707070592
475	152	4	0	4	24.9086704713
475	153	6	1	5	18.8873817343
475	154	118	15	103	31.0522439032
475	155	1	0	1	61.6173496679
475	160	1	0	1	36.8632342032
475	163	2	0	2	25.773126009
475	164	2	0	2	52.5678388277
475	165	0	0	0	45.1198903714
475	167	1	0	1	35.0834116349
475	168	1	0	1	48.6803602343
475	171	0	0	0	57.3490165402
475	172	5	0	5	44.1686701164
475	176	2	1	1	21.5443342423
475	177	7	2	5	47.5846872937
475	183	2	0	2	146.953130673
475	185	1	0	1	153.325577423
475	190	2	0	2	144.35777685
475	198	1	0	1	176.495272805
475	208	1	0	1	136.255768735
475	220	0	0	0	165.382659111
475	229	4	0	4	145.919745048
475	236	1	0	1	130.818906337
475	242	0	0	0	179.693962039
475	245	5	0	5	80.9893672457
475	251	0	0	0	84.2112384929
475	262	1	0	1	95.69691003
475	270	1	0	1	106.736912024
475	272	2	0	2	119.980311819
475	275	0	0	0	111.041602724
475	276	1	0	1	107.32108497
475	277	6	0	6	107.625516848
475	282	0	0	0	104.192479678
475	292	1	0	1	117.992265382
475	293	3	1	2	111.234209161
475	307	2	0	2	86.1673055442
475	308	2	0	2	93.5436168019
475	338	2	0	2	95.5403815677
475	360	1	0	1	93.8991506687
475	375	1	0	1	128.248209132
475	382	1	0	1	53.6745984983
475	385	2	0	2	33.5877696769
475	390	1	0	1	23.4882330339
475	391	2	0	2	24.3090794773
475	392	3	0	3	28.9389327917
475	396	6	1	5	25.6250064221
475	397	7	0	7	22.0470670298
475	399	2	0	2	29.054839134
475	400	1	0	1	38.1137820372
475	403	1	0	1	40.3638979641
475	406	8	0	8	31.8233454308
475	408	36	3	33	33.750119383
475	410	4	1	3	30.1902451559
475	411	6	0	6	33.0356748063
475	413	1	0	1	46.0060827674
475	414	3	0	3	34.9905981399
475	415	20	4	16	25.4089198419
475	416	1	0	1	38.6852687969
475	417	3	0	3	29.0738183809
475	431	0	0	0	56.244402758
475	444	1	0	1	54.333018363
475	449	0	0	0	11.8612168386
475	451	3	1	2	17.5779321519
475	453	2	0	2	21.5059986277
475	454	1	0	1	15.7306398611
475	455	4	0	4	18.4771376867
475	456	1	0	1	15.8135847234
475	457	10	2	8	14.0477194195
475	460	10	2	8	13.7224482382
475	464	16	0	16	28.4634190396
475	465	71	13	58	18.7880790286
475	466	312	15	297	26.9055329581
475	467	63	27	36	8.45260390474
475	468	17	0	17	17.3053728402
475	469	1136	638	498	15.7453353228
475	470	70	4	66	14.2303909105
475	471	49	0	49	34.2974312602
475	472	47	0	47	20.6149613844
475	473	81	3	78	7.6942524903
475	474	9	0	9	36.3426097758
475	476	22	1	21	28.7500361422
475	477	28	1	27	23.577672034
475	478	8	0	8	29.4717987762
475	479	2	0	2	32.3765304114
475	480	28	4	24	24.0716208674
475	481	2	0	2	48.9152532207
475	482	5	0	5	47.5824204457
475	484	5	1	4	46.6999163098
475	485	4	1	3	47.3224447759
475	487	8	0	8	45.3669254781
475	488	32	0	32	39.7422287417
475	489	1	0	1	54.363145643
475	490	1	0	1	37.8467982133
475	491	31	1	30	29.8561321224
475	492	7	0	7	39.087572868
475	493	6	3	3	43.644002202
475	494	134	19	115	9.74684184681
475	495	33	0	33	24.2190517002
475	496	144	10	134	9.71285243662
475	497	69	39	30	9.91931578114
475	499	11	3	8	19.3222829736
475	500	21	0	21	15.025380085
475	501	9	0	9	32.5386085233
475	502	3	0	3	27.3659124222
475	503	222	0	222	18.8729653171
475	504	85	17	68	9.18823543779
475	505	7	0	7	37.6912286267
475	506	2	0	2	44.1854871302
475	512	1	0	1	96.855220493
475	539	1	0	1	83.7809029894
475	549	0	0	0	123.185053991
475	552	1	0	1	81.7372798172
475	566	2	1	1	37.4234719025
475	568	3	1	2	33.0655709022
475	573	5	1	4	45.3706015607
475	578	1	0	1	32.3212092503
475	581	0	0	0	44.974293725
475	588	1	0	1	93.5767888233
476	0	5	2	3	48.754742603
476	1	163	28	135	53.1959638887
476	2	2	0	2	40.5180169592
476	5	3	1	2	48.7538661557
476	6	0	0	0	43.8617169157
476	7	5	0	5	45.872506879
476	12	1	0	1	53.5364791448
476	13	10	2	8	44.323773774
476	15	9	4	5	44.5311088332
476	17	3	0	3	36.7821956006
476	19	1	0	1	51.3219334188
476	20	2	0	2	40.7482441971
476	21	3	0	3	45.5577116061
476	22	1	0	1	57.073270251
476	23	2	1	1	43.1856593862
476	24	3	1	2	41.9816046683
476	25	1	0	1	49.9118250974
476	26	6	0	6	32.324397573
476	27	3	0	3	35.8552054655
476	28	3	2	1	55.3885606662
476	30	3	0	3	29.4660571309
476	32	3	0	3	57.9463316001
476	33	5	0	5	39.0762750163
476	34	11	2	9	23.3877017833
476	35	8	0	8	35.3422083986
476	36	21	4	17	43.4074851148
476	37	3	1	2	30.2965721849
476	38	2	0	2	30.2916270059
476	43	1	0	1	31.1474979451
476	45	31	1	30	14.0003021995
476	46	10	0	10	33.5858395064
476	47	12	3	9	21.082778882
476	48	364	12	352	13.7617153939
476	49	14	1	13	26.9327311376
476	50	68	14	54	20.7932317327
476	51	2	0	2	23.5706791277
476	52	7	0	7	13.0714850074
476	53	5	0	5	47.8870534772
476	54	8	1	7	17.9967056469
476	55	7	0	7	22.7689081978
476	56	1	0	1	27.7284045556
476	57	43	0	43	7.75288079116
476	59	95	19	76	20.7211541539
476	60	43	11	32	17.6323138949
476	61	3	0	3	29.9240627349
476	62	2	0	2	40.1658986045
476	64	2	1	1	39.4802829196
476	65	28	0	28	31.7922145099
476	66	2	0	2	27.5085064938
476	68	162	0	162	14.3098529041
476	69	170	28	142	5.3128692501
476	70	3	0	3	59.9448551616
476	71	2	0	2	51.9567362348
476	72	3	0	3	58.3129608715
476	73	59	0	59	52.6641414448
476	74	6	0	6	53.3559173294
476	75	14	0	14	50.6701653765
476	76	5	1	4	58.706347405
476	78	7	0	7	54.9969907571
476	79	0	0	0	55.8292901436
476	81	4	0	4	57.1240815807
476	82	6	1	5	56.6498803012
476	83	3	1	2	53.910475984
476	84	5	0	5	52.4744061966
476	85	1	0	1	57.7436914171
476	87	5	0	5	50.2792906999
476	88	1	0	1	50.4709239638
476	89	1	0	1	62.0254746883
476	92	0	0	0	62.7020707177
476	95	3	0	3	50.0358470728
476	96	1	0	1	68.8965454644
476	99	3	0	3	37.7978568616
476	103	12	1	11	46.9591112136
476	107	1	0	1	49.1059867458
476	109	2	0	2	65.0254947694
476	110	1	0	1	42.6189146323
476	111	1	0	1	67.0148801221
476	112	11	1	10	46.6133629491
476	113	26	0	26	45.6600247284
476	116	1	0	1	60.7243610479
476	124	55	11	44	16.1059375415
476	125	2	0	2	20.6298623765
476	126	12	7	5	14.8552947981
476	128	2	1	1	32.7639281662
476	129	1	1	0	36.5538187848
476	131	349	102	247	5.93575081724
476	132	2	0	2	18.6737104604
476	133	3	0	3	31.6372801493
476	134	5	1	4	33.6825156651
476	135	2	0	2	33.5283220159
476	136	1	0	1	23.3467180766
476	138	3	0	3	29.5682432392
476	139	1	0	1	18.2739117986
476	140	4	0	4	39.5806105498
476	141	2	0	2	33.3832282635
476	142	161	32	129	31.9031520555
476	143	5	0	5	25.575413104
476	144	5	0	5	37.4404433416
476	145	4	1	3	25.8798584575
476	146	4	0	4	46.1849722794
476	147	14	3	11	28.4672543797
476	148	2	0	2	24.7698573628
476	151	63	10	53	9.47411302908
476	152	4	0	4	18.9847819951
476	153	2	0	2	22.5205615237
476	154	4	0	4	37.6632854421
476	155	1	0	1	65.7202179252
476	163	0	0	0	39.1693866132
476	164	1	0	1	55.2760018121
476	166	2	0	2	72.6487798729
476	167	1	0	1	50.7497443835
476	169	1	0	1	73.8393209487
476	171	1	0	1	60.4795822815
476	177	1	0	1	55.5692305696
476	183	1	0	1	130.930434953
476	188	1	0	1	135.42847271
476	207	1	0	1	125.272221408
476	208	0	0	0	129.677696619
476	242	0	0	0	166.914239818
476	250	1	0	1	79.2731677348
476	251	1	0	1	78.8417881726
476	257	1	0	1	68.5381135983
476	259	1	0	1	82.8998016475
476	277	3	0	3	93.9731462703
476	301	1	0	1	104.233220248
476	303	1	0	1	62.2147487755
476	304	1	0	1	55.5132394044
476	305	1	0	1	77.7012686237
476	307	2	0	2	68.215768586
476	345	1	0	1	132.398864435
476	394	1	0	1	59.6888745015
476	399	1	0	1	49.718863237
476	406	1	0	1	56.0888011715
476	408	0	0	0	59.5973130197
476	415	3	0	3	53.1611564911
476	464	267	21	246	11.6984084339
476	465	12	6	6	29.111432924
476	466	69	22	47	31.3216991431
476	467	1	0	1	35.9937057493
476	468	26	1	25	11.7801784256
476	469	231	47	184	21.3428445909
476	470	12	2	10	15.1032460684
476	471	56	0	56	14.4271079119
476	472	72	4	68	10.3474460497
476	473	2	0	2	21.6751753603
476	474	3	0	3	35.1193671257
476	475	13	0	13	28.7500361422
476	477	9	2	7	22.5935891149
476	478	3	0	3	37.919986284
476	479	182	151	31	8.1441505103
476	480	46	0	46	15.869287882
476	481	5	0	5	37.510496469
476	482	5	1	4	40.4925018517
476	484	27	2	25	24.9813269146
476	486	1	0	1	33.3881238212
476	487	12	1	11	27.7978059842
476	488	16	0	16	28.582352333
476	489	7	0	7	38.128753896
476	490	4	0	4	21.4596466619
476	491	35	1	34	23.7241271376
476	493	4	1	3	44.9879793473
476	494	7	0	7	24.9962389888
476	495	5	2	3	38.3365798566
476	496	4	1	3	33.6953315036
476	497	1	0	1	37.5595609057
476	499	3	0	3	36.6220783895
476	501	2	0	2	43.8088252035
476	503	5	0	5	41.9248397623
476	504	1	0	1	29.5540416646
476	505	6	1	5	43.6237519921
476	507	1	0	1	161.829316554
476	555	0	0	0	90.029892506
476	573	1	0	1	67.5516451521
476	585	1	0	1	94.3098501846
477	0	3	0	3	71.214776706
477	1	54	11	43	75.6679991598
477	5	2	0	2	70.6023193144
477	8	1	0	1	81.3312218028
477	13	2	0	2	66.7810754748
477	15	1	0	1	67.1245085994
477	17	1	0	1	59.2740909289
477	19	1	0	1	73.7132977116
477	27	1	0	1	57.5042945096
477	28	3	0	3	77.969348441
477	29	1	0	1	57.1385377836
477	30	1	0	1	51.9805267134
477	33	1	0	1	61.4049468481
477	34	2	0	2	45.6755147843
477	35	5	1	4	57.8549710172
477	36	10	3	7	64.9551010119
477	42	2	0	2	70.8669526341
477	43	2	0	2	43.2004160931
477	45	3	0	3	22.9525909447
477	46	2	0	2	52.6921884797
477	47	1	0	1	32.9648629116
477	48	15	0	15	33.5714077232
477	49	5	0	5	49.1976459214
477	50	3	0	3	42.8631516678
477	54	1	0	1	40.2479616218
477	57	1	0	1	25.8133126672
477	59	12	0	12	31.1051738362
477	60	3	0	3	39.2565591158
477	61	1	0	1	44.8596377923
477	65	2	0	2	48.2915496035
477	66	0	0	0	49.0742561824
477	67	1	0	1	48.8976798483
477	68	4	0	4	36.8586478557
477	69	5	1	4	27.7531110485
477	70	3	0	3	78.1277155144
477	71	3	0	3	68.8590775542
477	72	1	0	1	77.2114900997
477	73	72	2	70	71.4173064904
477	74	11	2	9	71.1026477369
477	75	11	3	8	69.1846224384
477	76	2	0	2	76.4197481638
477	78	5	1	4	72.596086296
477	79	3	0	3	74.9686887983
477	81	3	0	3	75.7362862716
477	82	2	0	2	74.5904366562
477	83	3	0	3	72.2668376131
477	84	13	0	13	70.9321688744
477	86	3	0	3	70.4385373837
477	87	3	0	3	68.168669663
477	89	2	0	2	81.9127158101
477	90	1	0	1	80.0736809745
477	92	3	0	3	81.5945922194
477	95	1	0	1	70.2486920138
477	96	0	0	0	85.2848614413
477	102	1	0	1	77.0355563249
477	103	14	1	13	66.0986535761
477	110	7	0	7	61.981205025
477	112	6	0	6	66.4009791092
477	113	22	3	19	63.8206747528
477	116	1	0	1	78.0802244333
477	120	1	0	1	75.3403660071
477	124	5	0	5	35.8517516848
477	125	0	0	0	41.4732434043
477	126	1	0	1	28.6525920218
477	127	1	0	1	55.9174811228
477	128	2	0	2	46.3650011592
477	131	40	3	37	21.5517376961
477	132	2	0	2	20.5122667055
477	133	1	0	1	51.5980458639
477	134	1	0	1	51.9471389678
477	135	1	0	1	42.3411256763
477	137	0	0	0	58.1714695084
477	140	5	0	5	57.739275058
477	141	3	1	2	34.4165543562
477	142	88	18	70	48.5726865842
477	145	3	1	2	45.2729264908
477	146	1	0	1	62.7018638471
477	147	14	4	10	36.4832941385
477	149	1	0	1	26.023438171
477	151	2	0	2	28.5728213724
477	153	1	0	1	33.0102652271
477	154	1	0	1	49.1968458136
477	177	1	0	1	67.3557367286
477	183	0	0	0	153.328396622
477	208	0	0	0	149.696579401
477	229	1	0	1	157.240974402
477	242	0	0	0	188.836591873
477	245	1	0	1	91.7589573156
477	260	1	0	1	88.0472984289
477	264	1	0	1	94.1627234757
477	277	5	0	5	115.851776391
477	293	1	0	1	124.049343653
477	309	1	0	1	83.3375018998
477	338	0	0	0	115.684974885
477	392	1	0	1	50.7081746692
477	400	1	0	1	45.1136195291
477	406	3	0	3	38.1245431941
477	408	5	1	4	42.7739074121
477	415	2	0	2	39.6350195919
477	455	0	0	0	42.051904892
477	460	0	0	0	34.0368974433
477	463	5	2	3	14.6868313396
477	464	119	6	113	12.7916816095
477	465	102	42	60	9.39151719085
477	466	922	97	825	8.72812317487
477	467	1	0	1	31.8218537716
477	468	9	0	9	20.3139878076
477	469	1601	34	1567	7.90138519058
477	470	12	0	12	15.193918138
477	471	39	10	29	16.5001108898
477	472	98	10	88	13.5416081615
477	473	3	2	1	17.3508374803
477	474	42	5	37	14.6470696855
477	475	65	7	58	23.577672034
477	476	53	1	52	22.5935891149
477	478	21	3	18	15.3951976852
477	479	6	2	4	19.3078927206
477	480	209	138	71	6.84127432611
477	481	3	0	3	25.3376294308
477	482	16	0	16	24.4556454545
477	483	1	0	1	32.2393287222
477	484	38	10	28	26.5113956847
477	485	11	0	11	25.9571990665
477	486	11	0	11	26.9842832473
477	487	51	1	50	23.2072745021
477	488	56	1	55	16.3069788566
477	489	5	0	5	31.1990352471
477	490	10	0	10	16.4376484979
477	491	491	50	441	6.36485470878
477	492	10	7	3	16.0216983895
477	493	21	2	19	23.9919080523
477	494	43	7	36	13.9939791421
477	495	49	0	49	17.278852032
477	496	7	0	7	20.965851197
477	499	8	3	5	17.6569671755
477	500	10	0	10	15.580862744
477	501	32	0	32	21.3980005057
477	502	2	0	2	25.6757680975
477	503	38	4	34	25.2472052125
477	504	16	0	16	17.0178362873
477	505	37	2	35	21.2452341371
477	506	1	0	1	41.6271440698
477	555	2	0	2	88.070226038
477	561	1	0	1	94.0168781847
477	573	1	0	1	68.9482735271
478	1	9	5	4	91.0550644004
478	5	1	1	0	85.9458958597
478	18	1	0	1	82.7329844512
478	23	2	0	2	80.9880313863
478	34	0	0	0	60.7397368283
478	36	0	0	0	79.5013813591
478	46	1	0	1	67.5070385703
478	47	2	0	2	46.7102930187
478	48	5	0	5	48.7960171664
478	49	1	0	1	64.5927800857
478	50	1	0	1	58.2543605218
478	54	1	0	1	55.3269777602
478	55	1	0	1	56.1238078728
478	59	3	0	3	44.6286033082
478	65	2	0	2	62.5037885321
478	67	1	0	1	63.5498347437
478	68	1	0	1	52.2160842237
478	70	1	0	1	90.7291016267
478	73	21	0	21	84.4285793994
478	74	1	0	1	83.5997225374
478	75	1	0	1	82.1122042958
478	76	1	0	1	88.7986175624
478	78	1	0	1	84.9867399399
478	79	0	0	0	88.1284440235
478	81	6	0	6	88.6046421208
478	83	1	0	1	85.0577503391
478	84	2	0	2	83.7991518343
478	85	1	0	1	86.6975399316
478	87	1	0	1	80.7990473008
478	88	0	0	0	80.2589645827
478	90	1	0	1	91.7117841893
478	103	2	1	1	79.3965235678
478	107	3	1	2	75.3771768941
478	110	1	0	1	75.4616996617
478	112	4	0	4	80.0190116007
478	113	6	0	6	76.6806497658
478	119	0	0	0	86.9506911496
478	128	1	0	1	57.8425814264
478	131	4	1	3	36.2725447674
478	134	1	0	1	65.1681776294
478	138	1	0	1	65.0132959669
478	141	2	0	2	41.1566602638
478	142	32	1	31	61.2420862077
478	146	1	0	1	74.7875283998
478	147	2	0	2	46.4560572716
478	208	0	0	0	162.881799513
478	214	2	0	2	155.497966322
478	240	1	0	1	203.068459538
478	244	1	0	1	204.158005374
478	245	0	0	0	105.603588973
478	266	1	0	1	143.679094777
478	275	1	0	1	132.67443412
478	277	1	0	1	130.424024871
478	282	0	0	0	128.624052741
478	323	1	0	1	88.2682618542
478	356	0	0	0	121.505715446
478	399	1	0	1	18.7630445511
478	406	2	0	2	28.0477956032
478	408	5	0	5	33.4907772392
478	414	1	0	1	22.9217702885
478	416	1	0	1	30.2223898184
478	427	1	1	0	35.2088846273
478	463	13	7	6	8.46161904926
478	464	8	2	6	27.9596010833
478	465	32	13	19	11.3269599277
478	466	801	512	289	6.81181256767
478	467	1	0	1	35.8497427229
478	468	1	0	1	33.7694443419
478	469	177	68	109	18.7277422916
478	471	4	0	4	30.6176778367
478	472	8	3	5	28.332812916
478	474	29	3	26	11.9612729051
478	475	7	1	6	29.4717987762
478	476	5	0	5	37.919986284
478	477	11	0	11	15.3951976852
478	479	2	0	2	34.4646493511
478	480	13	0	13	22.2340107553
478	481	1	0	1	28.2819721227
478	482	11	0	11	23.5940927386
478	483	5	1	4	27.6863196304
478	484	4	0	4	37.7530329793
478	485	4	1	3	19.8185037763
478	486	1	1	0	33.9118317383
478	487	4	3	1	32.3538082763
478	488	6	2	4	23.1691974681
478	489	1	0	1	36.7174381438
478	491	31	1	30	17.1305542462
478	492	7	0	7	16.9405707318
478	493	28	16	12	14.956812256
478	494	3	0	3	20.8732804194
478	495	92	1	91	7.35516559391
478	496	1	0	1	21.767158207
478	499	5	0	5	12.1377615598
478	500	4	0	4	14.8340303
478	501	149	14	135	6.10019904352
478	502	5	0	5	14.2256326509
478	503	28	16	12	19.5366582161
478	504	1	0	1	20.3275556202
478	505	62	4	58	8.22283299629
478	506	1	0	1	27.1448533437
478	573	0	0	0	72.1943041299
479	0	2	0	2	54.4653299291
479	1	78	8	70	57.3035209059
479	3	1	0	1	55.051679533
479	5	6	0	6	51.5752401935
479	7	1	0	1	51.2002651626
479	12	2	0	2	56.317478129
479	13	1	0	1	50.0835274109
479	15	4	0	4	49.5424738894
479	16	1	0	1	57.6424017803
479	17	4	0	4	41.0972695488
479	20	1	0	1	43.9610119886
479	21	3	0	3	49.0231800698
479	23	1	0	1	47.1648936365
479	25	1	0	1	50.8945013416
479	27	2	0	2	38.4461768895
479	28	2	0	2	60.0329114877
479	29	1	0	1	37.8594695903
479	32	1	0	1	64.1266185196
479	33	2	0	2	45.1766064929
479	34	5	0	5	29.8566154393
479	35	4	0	4	41.041871632
479	36	7	0	7	50.3105122829
479	37	1	0	1	35.1693590601
479	39	2	0	2	59.8864161949
479	43	4	0	4	26.5980597866
479	45	77	38	39	6.66740035223
479	46	7	0	7	33.4736133978
479	47	20	1	19	15.93948177
479	48	174	4	170	14.3351415761
479	49	7	1	6	30.7351287734
479	50	28	0	28	24.3117414197
479	51	1	0	1	28.3248772049
479	52	4	0	4	20.2968546758
479	53	1	0	1	46.8586978367
479	54	2	0	2	24.7038398437
479	55	5	2	3	22.0433424328
479	56	1	0	1	28.5999258425
479	57	27	6	21	6.66827081158
479	59	91	10	81	14.8472854853
479	60	19	6	13	20.4569978237
479	61	1	0	1	26.8399420895
479	62	2	0	2	36.2347486563
479	63	1	1	0	19.4583154872
479	65	20	6	14	29.7206775382
479	67	2	0	2	29.8222571444
479	68	80	9	71	19.4951156409
479	69	71	4	67	11.0356269323
479	70	1	0	1	67.87784534
479	71	1	0	1	60.0475573848
479	73	22	0	22	60.531337267
479	74	3	0	3	61.367398952
479	75	3	0	3	58.5873412067
479	78	4	0	4	63.0196283116
479	81	3	1	2	64.9977112968
479	84	4	0	4	60.3928444294
479	85	1	0	1	65.818627247
479	86	1	0	1	61.9652179726
479	87	3	0	3	58.2848800808
479	96	1	0	1	76.9909381457
479	99	2	0	2	45.5726361583
479	100	1	0	1	57.390132561
479	103	1	0	1	54.7803022318
479	104	1	0	1	61.1229554065
479	112	4	0	4	54.2794473904
479	113	8	0	8	53.6509240682
479	124	10	3	7	24.1425671442
479	126	7	0	7	22.461778713
479	128	1	0	1	40.7836993778
479	131	56	21	35	12.7287110528
479	132	3	0	3	23.3180008903
479	136	1	0	1	31.4875164828
479	140	1	0	1	47.6010506058
479	141	1	0	1	39.0590882909
479	142	42	6	36	40.0449695238
479	143	1	0	1	33.6216213197
479	145	3	0	3	33.8299159713
479	146	3	0	3	54.3083003802
479	147	1	0	1	35.5619634952
479	148	1	0	1	32.377085078
479	150	1	0	1	32.1822810027
479	151	7	0	7	17.6108386359
479	152	1	0	1	27.0063706519
479	153	1	0	1	29.8736220978
479	154	2	0	2	45.5178500359
479	163	0	0	0	46.431193129
479	164	1	0	1	63.4185113733
479	172	1	0	1	58.4301692001
479	245	1	0	1	78.3476731964
479	277	0	0	0	100.326820447
479	282	1	0	1	100.31017299
479	301	1	0	1	111.781752704
479	307	1	0	1	73.8053218496
479	309	1	0	1	66.7902297377
479	415	1	0	1	55.0299389218
479	416	1	0	1	60.9981257091
479	431	1	0	1	76.9856699763
479	463	1	0	1	31.3338238552
479	464	226	24	202	6.52315785961
479	465	6	1	5	27.6265236971
479	466	56	8	48	27.6551426033
479	468	10	7	3	17.3460512163
479	469	124	39	85	21.0347037634
479	470	4	0	4	18.1605161223
479	471	112	59	53	6.53675440329
479	472	37	3	34	11.7776802755
479	474	2	0	2	29.4442306839
479	475	13	2	11	32.3765304114
479	476	512	8	504	8.1441505103
479	477	8	2	6	19.3078927206
479	478	2	0	2	34.4646493511
479	480	64	22	42	12.6841265375
479	481	1	0	1	29.7253982629
479	482	3	0	3	33.2431349908
479	483	1	0	1	42.2374235703
479	484	48	1	47	17.0650230499
479	486	8	0	8	25.2570050311
479	487	24	2	22	19.6663467795
479	488	18	3	15	21.2235170439
479	489	5	0	5	29.9878863578
479	490	5	2	3	13.6284972424
479	491	34	11	23	18.3460516867
479	493	1	0	1	39.1877381364
479	494	3	0	3	26.2973210388
479	495	4	1	3	36.3983655515
479	496	1	1	0	35.2051218214
479	499	3	0	3	35.799853916
479	501	2	0	2	40.5483164068
479	502	1	0	1	44.601255732
479	503	4	1	3	42.2781020391
479	505	3	0	3	38.9942424569
479	506	1	0	1	60.9242036297
480	0	6	0	6	64.5987210014
480	1	95	0	95	68.8440522304
480	2	1	0	1	56.3621231593
480	5	1	0	1	63.7738512183
480	6	2	0	2	57.9860936306
480	7	3	0	3	61.7415575136
480	9	4	0	4	67.7513962003
480	13	5	0	5	60.1656873043
480	15	3	0	3	60.3782650796
480	18	2	0	2	61.26949872
480	19	1	0	1	67.1375840751
480	23	5	0	5	58.7638831011
480	24	2	0	2	57.6816114859
480	26	5	1	4	47.6340096258
480	27	1	0	1	50.6833897149
480	28	4	1	3	71.1879494728
480	30	1	0	1	45.3250342303
480	32	1	0	1	73.6506313705
480	33	2	0	2	54.8561192817
480	34	7	0	7	39.1295007049
480	35	7	0	7	51.2019400936
480	36	14	6	8	58.7224079777
480	37	1	0	1	46.0951364194
480	38	1	0	1	45.8133685415
480	39	1	0	1	68.9979945051
480	45	14	1	13	17.1349455419
480	46	5	0	5	46.1571428425
480	47	7	0	7	27.286880422
480	48	73	4	69	26.8234396956
480	49	3	0	3	42.3597003609
480	50	22	0	22	36.0220095455
480	51	1	0	1	39.3110031898
480	52	2	0	2	28.5997031063
480	53	1	0	1	59.4148428636
480	54	1	0	1	33.7056419718
480	55	3	0	3	34.7249252215
480	57	7	2	5	19.0606295176
480	59	25	7	18	25.6301067883
480	60	9	1	8	32.4216024272
480	63	1	0	1	31.251131675
480	65	10	2	8	42.1363106619
480	68	13	1	12	30.0734278816
480	69	25	1	24	20.9610586046
480	70	6	0	6	73.0221985561
480	71	4	2	2	64.0922941921
480	72	1	0	1	71.8799060821
480	73	78	12	66	66.1071940003
480	74	15	0	15	66.0968881399
480	75	22	0	22	63.9366650791
480	76	2	0	2	71.4509389087
480	78	12	0	12	67.6429225641
480	79	4	0	4	69.5533963505
480	80	0	0	0	69.873661097
480	81	5	0	5	70.4881507035
480	82	5	1	4	69.5436627849
480	83	3	1	2	67.0821266108
480	84	13	1	12	65.7101253447
480	86	2	0	2	65.7779167789
480	87	8	6	2	63.103475758
480	88	0	0	0	62.9492163025
480	89	2	0	2	76.2795102001
480	90	2	0	2	75.5022961157
480	92	1	0	1	76.2800571699
480	96	2	0	2	80.7615401576
480	103	13	1	12	60.6453101543
480	106	1	0	1	77.887411274
480	109	1	0	1	77.7007801299
480	110	3	0	3	56.4391000953
480	111	2	0	2	80.9296289691
480	112	16	0	16	60.7497257033
480	113	42	4	38	58.6478907513
480	114	2	0	2	58.3806800377
480	115	1	0	1	85.9985889009
480	119	1	0	1	71.1785848928
480	120	1	0	1	69.7452339988
480	124	11	3	8	29.9414088828
480	125	2	0	2	35.3610792055
480	126	2	1	1	23.8018894521
480	128	2	0	2	42.2576409567
480	129	2	0	2	51.1966647249
480	130	1	0	1	37.4460399667
480	131	95	10	85	15.5589216846
480	132	4	2	2	18.0818307627
480	133	1	0	1	45.8146480069
480	134	4	1	3	46.6474229371
480	135	1	0	1	39.4612239791
480	136	1	0	1	35.5963507115
480	138	2	0	2	44.4812768079
480	139	4	1	3	23.38573582
480	140	9	1	8	52.5227460924
480	141	4	0	4	33.5410516155
480	142	131	3	128	43.6699230634
480	143	3	0	3	35.7468180476
480	144	1	0	1	47.7456960246
480	145	3	0	3	39.5907317071
480	146	5	0	5	58.0020629332
480	147	24	1	23	33.6068876129
480	149	1	0	1	24.4225370615
480	150	4	0	4	28.1288428463
480	151	10	0	10	22.5909810324
480	152	1	0	1	29.537890474
480	153	1	0	1	29.2728096703
480	154	2	0	2	45.7252145266
480	155	0	0	0	76.1259462816
480	164	2	0	2	65.9131071702
480	171	2	0	2	71.1197153209
480	172	1	0	1	59.4344518805
480	177	1	0	1	64.0795666729
480	179	1	0	1	90.1593689703
480	205	0	0	0	131.581916237
480	208	0	0	0	144.104672362
480	211	1	0	1	151.866697356
480	220	1	0	1	166.346050188
480	236	1	0	1	134.763526816
480	247	2	0	2	100.792093493
480	249	1	0	1	99.3049918642
480	263	1	0	1	93.5317240114
480	268	1	0	1	129.948516353
480	272	1	0	1	124.134825577
480	277	7	1	6	109.531903824
480	282	2	0	2	108.532216045
480	296	1	0	1	110.210919631
480	304	1	0	1	71.3757207563
480	305	1	0	1	93.412205264
480	307	2	0	2	84.0620785209
480	308	1	0	1	90.5973863044
480	403	1	0	1	46.8195910896
480	406	2	0	2	43.7314292396
480	408	5	3	2	48.0547755386
480	411	2	0	2	50.4735938692
480	414	1	0	1	41.8790688466
480	415	3	1	2	43.7790157445
480	417	1	0	1	48.2255329751
480	424	0	0	0	89.4723498991
480	455	0	0	0	42.1857961359
480	463	6	0	6	20.6951884567
480	464	515	420	95	6.3040926652
480	465	89	13	76	15.0164841713
480	466	771	110	661	15.5246454799
480	468	22	1	21	15.7185061153
480	469	1354	508	846	9.47963667504
480	470	44	2	42	12.0588144064
480	471	75	24	51	11.1788593535
480	472	284	3	281	7.92058155915
480	473	8	0	8	16.6906833518
480	474	36	12	24	19.8402636742
480	475	77	7	70	24.0716208674
480	476	177	100	77	15.869287882
480	477	250	88	162	6.84127432611
480	478	12	2	10	22.2340107553
480	479	22	0	22	12.6841265375
480	481	8	4	4	26.6988668134
480	482	20	9	11	27.5411372708
480	483	13	0	13	36.061428173
480	484	55	16	39	22.9053829068
480	485	8	0	8	30.6909678783
480	486	12	0	12	26.1007927692
480	487	66	8	58	21.3416848309
480	488	58	0	58	17.0439515667
480	489	17	0	17	30.7468795816
480	490	16	2	14	13.7810938798
480	491	683	212	471	8.80001549036
480	492	12	2	10	19.720487647
480	493	16	1	15	29.6241823331
480	494	34	11	23	15.7333998044
480	495	25	8	17	23.7159844526
480	496	4	0	4	24.1910608643
480	499	3	0	3	23.283629904
480	500	10	1	9	20.2657412667
480	501	18	5	13	28.2373019262
480	503	29	1	28	30.1942063824
480	504	15	0	15	19.8521328979
480	505	29	0	29	27.7653478733
480	506	2	0	2	48.2935096638
480	563	1	0	1	81.0760469043
480	565	1	0	1	132.760028024
480	568	0	0	0	55.6302206113
480	573	1	0	1	68.7945137359
480	579	1	0	1	74.6963848777
481	1	24	1	23	83.019999495
481	3	1	0	1	83.7611976936
481	5	0	0	0	75.2780278539
481	12	1	0	1	79.6587724238
481	13	3	1	2	78.3955401637
481	21	1	0	1	74.0302203137
481	26	1	0	1	61.7122451411
481	31	2	0	2	71.781186146
481	32	18	1	17	92.7437706274
481	33	0	0	0	73.9498606394
481	34	1	0	1	59.1920013354
481	35	1	0	1	69.4866979784
481	36	2	0	2	79.7372943636
481	39	1	0	1	88.8627480502
481	45	5	0	5	26.7461850569
481	46	0	0	0	53.4686894845
481	48	7	2	5	40.4477633099
481	49	1	0	1	57.5075486692
481	50	4	2	2	51.4018208949
481	59	9	1	8	29.1150203605
481	60	3	1	2	47.3641831764
481	65	2	0	2	46.1973137803
481	69	2	0	2	40.6837245624
481	73	19	0	19	90.171645258
481	74	9	0	9	90.8119591874
481	75	7	0	7	88.1796880545
481	76	1	0	1	96.1720251537
481	78	1	0	1	92.4378398367
481	79	0	0	0	93.3008741685
481	82	1	0	1	94.1348911726
481	84	0	0	0	89.9836224035
481	90	2	0	2	100.852333426
481	95	1	0	1	87.26077388
481	98	1	0	1	91.2220831509
481	99	1	0	1	75.2640535905
481	110	1	0	1	80.1009805737
481	112	2	0	2	84.0017700276
481	113	5	1	4	83.1410748421
481	119	1	0	1	96.8006908434
481	124	0	0	0	53.592774105
481	128	1	0	1	68.4343307517
481	131	10	0	10	40.252788061
481	132	2	0	2	44.6799539931
481	133	1	0	1	69.0872773602
481	134	1	0	1	71.1253104728
481	140	1	0	1	77.0401540311
481	141	1	0	1	59.5713793892
481	142	19	0	19	68.9280459842
481	147	2	0	2	60.3039662678
481	150	0	0	0	54.7084324955
481	172	1	0	1	85.8620115209
481	183	0	0	0	163.662826967
481	194	0	0	0	179.824453914
481	196	1	0	1	192.309309207
481	208	0	0	0	166.619191214
481	256	1	0	1	97.2980605086
481	258	1	0	1	100.121769975
481	274	1	0	1	123.528870145
481	277	0	0	0	128.92512313
481	282	0	0	0	129.565532724
481	286	1	0	1	126.541836578
481	319	1	0	1	116.441266362
481	356	1	0	1	140.682528311
481	375	1	0	1	164.006199325
481	397	1	0	1	55.4892082173
481	399	1	0	1	46.986234375
481	408	1	0	1	61.7726472145
481	462	0	0	0	64.3655481872
481	463	3	0	3	19.8880354172
481	464	26	0	26	26.5786055753
481	465	17	0	17	32.3117316928
481	466	205	7	198	24.9140960976
481	469	100	2	98	33.2020732681
481	470	2	0	2	38.7229184667
481	471	31	1	30	23.1949375118
481	472	6	0	6	34.0801313285
481	473	0	0	0	42.4240492983
481	474	65	10	55	16.3209041409
481	475	6	0	6	48.9152532207
481	476	7	5	2	37.510496469
481	477	5	3	2	25.3376294308
481	478	6	1	5	28.2819721227
481	480	14	0	14	26.6988668134
481	482	481	143	338	6.93229551396
481	483	44	2	42	14.2024036518
481	484	74	4	70	18.7442562675
481	485	56	0	56	15.2565103254
481	486	117	60	57	8.64404746695
481	487	222	0	222	11.9750691403
481	488	331	7	324	9.66154781094
481	489	258	4	254	9.04292416622
481	490	24	3	21	16.0997399817
481	491	63	0	63	19.114179402
481	492	74	15	59	11.4368845829
481	493	14	14	0	19.7256042008
481	494	3	1	2	39.2909416908
481	495	7	0	7	35.08240523
481	496	0	0	0	45.2900152233
481	500	2	0	2	38.7532889068
481	501	6	0	6	32.4741853203
481	503	3	1	2	46.7075418732
481	504	1	0	1	41.8362096315
481	505	7	1	6	25.5321814363
481	506	1	0	1	52.3652011439
481	507	1	0	1	168.939656168
481	573	1	0	1	94.2858329304
481	585	1	0	1	122.828755037
482	0	1	0	1	87.2421425843
482	1	23	0	23	88.3957796637
482	5	1	0	1	81.0226211216
482	6	1	0	1	73.186058659
482	7	1	0	1	83.712156209
482	24	1	0	1	77.982866373
482	25	0	0	0	77.101114293
482	27	1	0	1	68.3076167182
482	30	1	0	1	68.2628870253
482	32	7	0	7	97.1535791416
482	33	1	0	1	78.2427052211
482	35	0	0	0	73.9333355253
482	36	6	1	5	83.5523324002
482	37	1	0	1	67.6100187003
482	41	1	0	1	77.067542328
482	45	3	1	2	31.4125788622
482	46	2	1	1	59.5355813512
482	47	1	0	1	37.2661878868
482	48	9	3	6	45.2711504988
482	49	1	0	1	62.4564521029
482	50	3	1	2	56.2005271117
482	58	2	0	2	58.8357544626
482	59	3	2	1	34.9673341132
482	60	1	0	1	52.1553622969
482	63	1	0	1	41.1472616317
482	64	1	0	1	64.7265606594
482	65	1	1	0	52.5107368325
482	68	3	0	3	52.5396497425
482	69	1	0	1	44.2677044353
482	70	0	0	0	100.037601969
482	71	3	0	3	91.4140359414
482	73	33	0	33	92.9186774581
482	74	4	0	4	93.2345281986
482	75	2	0	2	90.836665297
482	78	2	0	2	94.8198594535
482	79	2	0	2	96.2000798064
482	81	1	0	1	97.3538186599
482	82	1	0	1	96.6307041356
482	83	1	0	1	94.0380563214
482	84	3	0	3	92.6307273741
482	86	1	0	1	93.1557459738
482	87	1	0	1	90.1996008643
482	90	2	0	2	102.907069605
482	103	4	0	4	87.2970607253
482	112	0	0	0	87.0761747249
482	113	10	0	10	85.660535902
482	120	1	0	1	96.0976842772
482	126	1	0	1	51.267143624
482	127	1	0	1	78.4330111783
482	128	1	0	1	69.7987568861
482	131	7	0	7	42.3561169224
482	132	1	0	1	44.7908276188
482	134	0	0	0	73.6098237393
482	140	3	0	3	79.5280942544
482	141	1	0	1	58.7713662832
482	142	24	7	17	70.9855181412
482	144	2	0	2	75.2745022138
482	146	1	0	1	85.378148854
482	147	4	0	4	60.7164764218
482	148	0	0	0	65.2621584898
482	150	1	0	1	54.6341745251
482	153	1	0	1	56.7438283401
482	154	1	0	1	73.1558760553
482	177	0	0	0	91.4599838998
482	187	1	0	1	177.399911946
482	205	1	0	1	157.933991182
482	208	0	0	0	170.148879465
482	212	1	0	1	158.747570631
482	220	0	0	0	188.847751782
482	245	0	0	0	111.529498715
482	251	1	0	1	119.256816694
482	277	3	0	3	133.37863271
482	282	0	0	0	133.551411419
482	293	0	0	0	144.407577763
482	320	0	0	0	113.841864979
482	401	1	0	1	62.3263638738
482	408	1	0	1	56.8036352783
482	463	12	4	8	15.1881629323
482	464	16	3	13	28.9613656929
482	465	19	1	18	29.7183555436
482	466	332	42	290	21.6761725214
482	467	1	0	1	55.4688929471
482	468	1	0	1	43.2596034752
482	469	183	0	183	32.2745070888
482	471	30	6	24	26.799479289
482	472	6	0	6	35.3757745226
482	473	1	0	1	41.7936080512
482	474	86	0	86	12.0774355892
482	475	12	0	12	47.5824204457
482	476	12	0	12	40.4925018517
482	477	12	0	12	24.4556454545
482	478	9	0	9	23.5940927386
482	479	0	0	0	33.2431349908
482	480	27	0	27	27.5411372708
482	481	190	53	137	6.93229551396
482	483	92	27	65	8.99429967087
482	484	46	12	34	24.8474535358
482	485	200	17	183	8.32423828205
482	486	31	0	31	15.4668001515
482	487	105	0	105	17.8931398201
482	488	229	31	198	12.0211966959
482	489	63	12	51	15.785689763
482	490	17	5	12	19.9654568369
482	491	65	28	37	18.964493487
482	492	114	8	106	8.50059631524
482	493	53	0	53	13.0221310395
482	494	1	1	0	37.8355846191
482	495	18	2	16	30.7884791212
482	496	4	0	4	42.698125738
482	499	2	0	2	34.8592248728
482	500	2	0	2	35.8277524149
482	501	25	3	22	26.9782094873
482	503	7	1	6	42.8195107112
482	505	25	10	15	19.5016548318
482	553	1	0	1	142.433374782
482	565	1	0	1	152.352154825
482	586	1	0	1	130.878195953
483	0	4	0	4	96.1633978941
483	1	16	0	16	97.0493732773
483	8	1	0	1	95.8545011717
483	15	2	0	2	90.6472300287
483	18	1	0	1	93.713020647
483	23	2	0	2	87.0819197998
483	28	1	1	0	100.474700567
483	32	34	0	34	106.11123612
483	34	1	0	1	72.0807190875
483	35	0	0	0	82.8791861799
483	41	0	0	0	86.0580752346
483	46	1	0	1	67.6709696276
483	48	3	0	3	54.1109311198
483	50	1	0	1	65.0593011616
483	55	4	0	4	57.8976975681
483	59	2	0	2	43.2818068601
483	65	1	0	1	60.3609615278
483	68	1	0	1	61.5160950204
483	70	1	0	1	108.853754499
483	73	9	0	9	101.778955966
483	74	1	0	1	102.010943585
483	75	4	0	4	99.6771864515
483	76	1	0	1	107.37572465
483	78	1	0	1	103.583057293
483	79	1	0	1	105.091261346
483	80	0	0	0	105.547945253
483	82	1	0	1	105.424773239
483	84	1	0	1	101.467456877
483	85	0	0	0	105.96745218
483	87	1	0	1	98.9881369447
483	88	1	0	1	98.9137473671
483	90	1	0	1	111.556208108
483	98	0	0	0	101.562965947
483	99	1	0	1	87.1182404892
483	103	3	0	3	96.1825927524
483	112	3	0	3	96.0043364622
483	113	6	4	2	94.4707161562
483	119	0	0	0	107.238221603
483	128	0	0	0	78.2348313014
483	131	7	1	6	51.1450270049
483	134	1	0	1	82.4244271775
483	136	1	0	1	71.4720083009
483	137	3	0	3	89.9961558994
483	138	0	0	0	79.0022339254
483	142	13	2	11	79.680136801
483	143	1	0	1	71.8065871904
483	144	1	0	1	83.7773008179
483	146	1	0	1	94.0443179551
483	147	1	0	1	68.7210154841
483	150	1	0	1	62.3947342715
483	151	1	0	1	57.9378305792
483	167	0	0	0	89.2439746984
483	177	0	0	0	99.5798397222
483	242	0	0	0	214.875008968
483	245	0	0	0	120.513755173
483	272	1	0	1	157.841697502
483	277	1	0	1	142.335084354
483	282	0	0	0	142.545198683
483	296	1	0	1	145.669747832
483	307	1	0	1	115.220795882
483	308	1	0	1	120.897590985
483	319	8	0	8	123.752004606
483	408	2	0	2	59.1681104947
483	415	1	0	1	61.5656120648
483	424	1	0	1	82.8198841279
483	426	2	0	2	65.5994390483
483	454	1	0	1	67.3541486746
483	460	0	0	0	61.6757898077
483	463	8	0	8	20.1941206503
483	464	5	0	5	37.8711632416
483	465	16	0	16	36.003783684
483	466	203	23	180	27.7582414615
483	468	1	0	1	51.7369426327
483	469	76	7	69	39.8029979052
483	470	1	0	1	47.2618270464
483	471	24	0	24	35.7887617572
483	472	2	0	2	43.9633612448
483	474	77	23	54	18.1933141064
483	475	7	0	7	54.5341099833
483	476	3	0	3	49.4504390941
483	477	7	4	3	32.2393287222
483	478	6	1	5	27.6863196304
483	480	10	0	10	36.061428173
483	481	35	0	35	14.2024036518
483	482	321	67	254	8.99429967087
483	484	9	1	8	32.9415812805
483	485	566	4	562	7.89936270051
483	486	9	0	9	22.6028373071
483	487	21	2	19	26.1105804923
483	488	60	3	57	21.014939007
483	489	14	0	14	21.277747816
483	490	5	1	4	28.9143106166
483	491	12	2	10	27.3141017616
483	492	26	19	7	16.3987732395
483	493	112	2	110	13.4258224397
483	495	8	3	5	35.0251711024
483	497	1	0	1	54.3991976156
483	499	1	0	1	39.7249036626
483	500	2	0	2	41.5634099522
483	501	16	2	14	29.3367573161
483	502	2	0	2	40.4099385883
483	503	4	1	3	47.1923072581
483	505	62	22	40	21.2679720696
483	506	1	0	1	45.5518284525
483	573	1	0	1	99.1202397344
483	586	1	0	1	137.12284833
483	588	1	0	1	146.159745183
484	0	1	0	1	64.9601976059
484	1	135	2	133	64.4910979444
484	2	1	0	1	55.1367571333
484	3	1	0	1	66.4594821387
484	4	1	0	1	56.8758006333
484	5	1	0	1	56.5575635698
484	6	1	0	1	48.4595640459
484	7	5	0	5	61.0787213808
484	9	1	0	1	67.6805098373
484	11	3	0	3	61.0628826085
484	12	1	0	1	60.9188808796
484	13	4	0	4	60.8539266163
484	15	3	0	3	58.8916495544
484	18	1	0	1	63.178648635
484	20	1	0	1	50.2841109987
484	21	3	0	3	55.4362162634
484	23	3	0	3	54.6900341831
484	24	1	0	1	54.599181567
484	25	1	0	1	52.2545965099
484	26	4	0	4	43.4162062901
484	27	1	0	1	44.160791218
484	28	4	0	4	68.17084788
484	29	1	0	1	41.654584388
484	30	2	0	2	46.9344788706
484	31	1	0	1	55.9062348055
484	34	1	0	1	43.0471111244
484	35	3	0	3	52.1614198381
484	36	16	1	15	63.3673694085
484	39	1	0	1	71.7649699777
484	41	1	0	1	56.4351328762
484	43	10	0	10	19.3492509228
484	45	216	84	132	11.1532915863
484	46	27	10	17	34.7476824518
484	47	19	6	13	12.6613553253
484	48	149	6	143	23.0736884972
484	49	9	1	8	39.5614355976
484	50	35	5	30	33.7722962402
484	51	1	0	1	38.9984910122
484	52	1	0	1	35.3343003225
484	53	2	0	2	44.3938448644
484	54	1	0	1	38.665106861
484	55	12	3	9	25.1481482619
484	56	1	0	1	32.7505417157
484	57	10	0	10	19.5031893158
484	58	2	0	2	34.0804083025
484	59	392	0	392	10.4387955852
484	60	20	2	18	29.8339445116
484	61	1	0	1	23.2645634707
484	62	1	0	1	28.4902046192
484	63	3	1	2	16.3435161381
484	64	1	0	1	39.879706991
484	65	71	7	64	27.67872999
484	66	1	0	1	36.8729709902
484	67	4	0	4	30.3419856132
484	68	29	0	29	32.15823111
484	69	13	0	13	26.1796718039
484	70	1	0	1	83.2429683866
484	71	2	0	2	76.0859655738
484	73	46	3	43	75.7384760114
484	74	5	0	5	77.0545754759
484	75	10	0	10	73.9672698543
484	76	3	0	3	82.3142300668
484	78	8	0	8	78.7405583567
484	79	1	0	1	78.5105764014
484	80	0	0	0	79.3952261032
484	81	4	0	4	80.188485087
484	82	2	0	2	80.1677939101
484	84	4	0	4	75.7622751111
484	85	3	0	3	81.7528023621
484	87	7	0	7	73.9694327033
484	89	1	0	1	83.8029402647
484	90	1	0	1	87.7337861837
484	95	3	0	3	71.8213187114
484	99	1	0	1	60.6957618912
484	103	12	1	11	69.9079042066
484	104	0	0	0	74.9256413025
484	107	1	0	1	73.8434674088
484	109	1	0	1	88.5988622157
484	110	2	0	2	65.5426772968
484	112	9	2	7	68.9946972618
484	113	19	1	18	69.3163537218
484	116	1	0	1	84.4880436603
484	117	1	1	0	71.8573596494
484	121	0	0	0	70.8310318716
484	124	1	1	0	40.3274580716
484	126	6	0	6	39.5266252225
484	128	2	0	2	57.7452544956
484	131	17	1	16	29.7676422859
484	133	2	0	2	54.570541759
484	134	1	0	1	57.6738400281
484	135	4	0	4	57.9177735147
484	136	1	1	0	48.0133770732
484	137	1	0	1	68.4315447514
484	138	1	0	1	51.4456175852
484	139	1	0	1	41.8041260758
484	140	3	1	2	63.4208192683
484	141	6	1	5	55.0116867703
484	142	52	2	50	56.5396614548
484	144	1	0	1	62.3528546002
484	145	3	0	3	49.603367123
484	147	12	1	11	52.4681499216
484	148	5	0	5	47.4167362811
484	151	1	0	1	34.3910843972
484	152	1	0	1	43.9652844179
484	154	2	0	2	62.5702300444
484	155	0	0	0	90.4455089057
484	163	0	0	0	63.3730376693
484	166	1	0	1	97.5486722872
484	171	0	0	0	85.1671308466
484	177	0	0	0	80.549796414
484	182	1	0	1	150.686652951
484	186	1	0	1	144.953721348
484	188	1	0	1	151.55449764
484	196	1	0	1	175.264200797
484	208	0	0	0	150.230080579
484	209	1	0	1	147.693024497
484	220	1	0	1	165.521869094
484	229	1	0	1	154.883783516
484	245	2	0	2	91.6587745409
484	247	1	0	1	109.704301487
484	258	2	0	2	82.7235325046
484	266	1	0	1	121.269114672
484	267	1	0	1	116.69604176
484	275	2	0	2	111.505029316
484	277	8	0	8	111.274150844
484	279	1	0	1	101.704762757
484	280	1	0	1	117.743277727
484	282	0	0	0	112.573765182
484	303	1	0	1	74.3781079211
484	307	1	0	1	83.4689404814
484	319	1	0	1	108.273872488
484	338	1	0	1	126.977833571
484	408	0	0	0	69.067015694
484	415	1	0	1	66.0884788526
484	416	1	0	1	67.5996101475
484	442	1	0	1	81.524720133
484	463	1	0	1	31.1744255889
484	464	65	38	27	18.3993237781
484	465	14	0	14	35.8592649623
484	466	150	44	106	31.7410137605
484	469	225	6	219	32.2804187253
484	470	3	1	2	33.217777652
484	471	148	26	122	12.5716407773
484	472	14	0	14	26.9235898728
484	474	9	0	9	27.889195548
484	475	14	0	14	46.6999163098
484	476	48	0	48	24.9813269146
484	477	10	0	10	26.5113956847
484	478	8	4	4	37.7530329793
484	479	13	4	9	17.0650230499
484	480	40	1	39	22.9053829068
484	481	38	2	36	18.7442562675
484	482	25	0	25	24.8474535358
484	483	2	0	2	32.9415812805
484	485	9	0	9	32.6260638501
484	486	204	22	182	10.965041318
484	487	1262	82	1180	6.95996264211
484	488	126	3	123	15.5084452332
484	489	197	107	90	14.7956989026
484	490	47	0	47	10.1750466562
484	491	82	33	49	21.3687138481
484	492	8	1	7	23.4759127501
484	493	4	1	3	35.5543945687
484	494	3	0	3	38.6302851084
484	495	2	0	2	42.5186798573
484	496	1	0	1	46.8890342887
484	497	1	0	1	52.4972118654
484	500	2	0	2	42.0716790538
484	501	4	0	4	43.4598795727
484	503	3	1	2	51.7426355523
484	504	1	0	1	42.6245391882
484	505	8	5	3	38.7845403517
484	516	1	0	1	113.299181083
484	553	1	0	1	146.365007975
484	556	4	0	4	140.906620184
484	559	1	0	1	117.539717028
484	560	1	0	1	112.769450393
484	565	2	0	2	155.399396695
484	573	0	0	0	90.2963187901
484	583	2	0	2	144.249864698
484	586	2	0	2	127.818362264
485	1	28	1	27	95.1340897194
485	7	1	0	1	89.8267569537
485	13	1	0	1	88.8022921788
485	15	3	0	3	88.0539837219
485	17	1	0	1	79.3192942288
485	21	1	0	1	86.3999369211
485	25	1	0	1	84.7485880655
485	26	0	0	0	73.5523640634
485	28	0	0	0	98.2592955711
485	30	1	0	1	73.9860679421
485	32	19	1	18	102.837999899
485	33	1	0	1	83.8864431861
485	36	10	0	10	88.656731748
485	37	1	0	1	73.7345000204
485	45	7	0	7	37.95896788
485	46	3	0	3	67.0546231255
485	48	8	0	8	51.7179358305
485	49	2	0	2	68.8705894411
485	50	2	0	2	62.5123659835
485	55	1	0	1	56.6107912589
485	59	6	0	6	42.4387099381
485	65	1	0	1	60.2816672053
485	68	3	0	3	58.2204845989
485	69	1	0	1	49.5413755218
485	70	7	1	6	103.698920247
485	73	29	2	27	96.7974074016
485	74	4	0	4	96.7476572829
485	75	10	1	9	94.6270572835
485	76	1	0	1	102.092931197
485	77	1	0	1	101.241118477
485	78	6	0	6	98.2779787667
485	79	1	0	1	100.230753163
485	81	0	0	0	101.178917638
485	82	2	0	2	100.206837918
485	83	1	0	1	97.7685640433
485	84	7	7	0	96.3994123079
485	85	0	0	0	100.493077319
485	87	3	0	3	93.7684211737
485	88	0	0	0	93.5701472095
485	90	2	0	2	105.949475845
485	92	1	0	1	106.968957777
485	94	1	0	1	118.517120759
485	102	1	0	1	100.951001065
485	103	2	0	2	91.3190886583
485	104	1	0	1	98.9058100958
485	107	1	0	1	90.0387676368
485	110	4	0	4	87.0924763871
485	111	1	0	1	111.593754808
485	112	8	1	7	91.3526851634
485	113	9	1	8	89.3308876538
485	121	0	0	0	89.8543708974
485	124	3	0	3	60.4840679431
485	126	1	0	1	54.328209234
485	127	1	0	1	81.6678276033
485	128	2	0	2	72.3139551731
485	129	1	0	1	81.6093146687
485	131	10	0	10	46.173352017
485	134	1	0	1	77.337929293
485	139	1	0	1	53.0561477324
485	140	1	0	1	83.2089917377
485	142	36	11	25	74.2665371981
485	143	1	0	1	66.1463466182
485	144	3	1	2	77.9506771571
485	145	3	0	3	70.2185052881
485	146	7	0	7	88.5160666596
485	147	5	0	5	62.2653024273
485	149	1	0	1	51.3714086766
485	151	1	0	1	53.1417676143
485	154	1	0	1	75.1001842514
485	177	1	0	1	93.1586471766
485	183	0	0	0	175.086342264
485	188	1	0	1	180.26189499
485	191	1	0	1	199.989265695
485	208	1	0	1	174.681054733
485	214	1	0	1	167.55185919
485	220	1	0	1	195.031715007
485	222	1	0	1	186.971269457
485	229	2	0	2	181.411542051
485	244	1	0	1	213.230399194
485	245	0	0	0	116.282136507
485	262	1	0	1	129.425532176
485	266	1	0	1	150.67680637
485	277	3	0	3	139.016051669
485	282	0	0	0	138.66723219
485	294	1	0	1	152.474667807
485	301	2	0	2	148.945834809
485	303	1	0	1	104.821347104
485	310	0	0	0	145.171591041
485	312	0	0	0	157.872999117
485	319	1	0	1	116.691522285
485	406	3	0	3	45.8402876616
485	408	3	0	3	51.4641650913
485	415	3	1	2	53.6717436805
485	429	1	0	1	46.5339334524
485	431	1	0	1	55.243438291
485	436	1	0	1	55.1288523691
485	463	23	6	17	12.6675342997
485	464	15	1	14	33.5586946496
485	465	46	0	46	28.6127238102
485	466	827	7	820	20.4182324085
485	467	1	0	1	54.6121038535
485	469	219	47	172	33.1301265886
485	470	0	0	0	41.1498041983
485	471	38	1	37	32.6012278904
485	472	4	0	4	38.5809847609
485	474	201	33	168	11.3489299103
485	475	46	1	45	47.3224447759
485	476	4	3	1	45.2548957769
485	477	20	8	12	25.9571990665
485	478	44	2	42	19.8185037763
485	480	27	12	15	30.6909678783
485	481	49	1	48	15.2565103254
485	482	457	0	457	8.32423828205
485	483	237	105	132	7.89936270051
485	484	31	0	31	32.6260638501
485	486	16	0	16	23.7459933221
485	487	25	3	22	25.6877373249
485	488	130	0	130	18.2622758116
485	489	28	0	28	24.021900518
485	490	4	1	3	26.341793566
485	491	51	0	51	21.9295182065
485	492	66	0	66	11.3779964951
485	493	388	134	254	5.76310707517
485	494	4	0	4	37.7617147762
485	495	26	10	16	27.1440820422
485	496	2	0	2	40.9715412564
485	500	2	0	2	33.9205111253
485	501	79	33	46	21.5295770933
485	502	2	0	2	32.57525065
485	503	15	0	15	39.302687681
485	504	2	1	1	38.681822973
485	505	214	13	201	13.4851968713
485	506	1	0	1	38.8411344917
485	573	1	0	1	91.5438189099
485	584	1	0	1	127.109192599
485	586	1	0	1	129.470576476
486	0	1	0	1	75.8568624529
486	1	53	6	47	75.4170707551
486	20	1	1	0	61.1979281436
486	21	1	0	1	66.3385144865
486	24	1	0	1	65.5642182255
486	26	4	0	4	54.3812350229
486	32	5	0	5	86.1418435911
486	33	0	0	0	67.5714818408
486	35	1	0	1	62.9603271966
486	36	6	0	6	73.876521268
486	41	1	0	1	67.0202886176
486	42	1	0	1	78.5733384317
486	43	3	0	3	28.5567669363
486	45	16	1	15	20.7891991957
486	46	2	0	2	45.2731061201
486	47	8	0	8	23.5360609803
486	48	33	3	30	33.8020669793
486	49	1	0	1	50.4907240402
486	50	12	0	12	44.6213901096
486	53	1	0	1	53.7693307998
486	55	5	1	4	36.0629188397
486	56	0	0	0	43.6354037743
486	57	2	0	2	29.3020038608
486	58	1	0	1	43.8953050852
486	59	51	3	48	21.3646033339
486	60	15	6	9	40.643927884
486	61	1	0	1	33.2739319297
486	65	23	0	23	37.8017607683
486	66	1	0	1	47.8372080705
486	68	5	1	4	42.511654442
486	69	3	2	1	35.6519092221
486	70	0	0	0	92.9302315345
486	73	25	1	24	85.5047842383
486	74	4	0	4	86.5288948775
486	75	7	0	7	83.633322724
486	77	1	0	1	89.5483138216
486	78	4	0	4	88.1928771368
486	79	0	0	0	88.4345550714
486	81	3	0	3	89.9704868624
486	82	1	0	1	89.7432360031
486	83	1	0	1	86.8942515346
486	84	5	0	5	85.4371698012
486	85	2	0	2	91.0458853746
486	86	1	0	1	87.2168387696
486	87	3	0	3	83.4422492342
486	89	1	0	1	94.0193961108
486	90	2	0	2	96.9497135644
486	95	2	0	2	81.9952607333
486	96	0	0	0	102.233079218
486	99	2	0	2	70.4737042769
486	102	2	0	2	86.0850979963
486	103	2	0	2	79.7057162307
486	107	1	0	1	82.4416325871
486	112	1	0	1	78.9858911681
486	113	3	0	3	78.7963894662
486	120	1	0	1	87.8719740829
486	124	4	0	4	49.3714242624
486	126	1	0	1	46.9550039643
486	131	8	0	8	37.1799844026
486	132	1	0	1	43.9871370385
486	133	1	0	1	64.3002374469
486	136	1	0	1	56.7331098204
486	141	3	1	2	59.6361161955
486	142	32	4	28	65.2871891219
486	145	2	0	2	58.9724901402
486	147	2	0	2	58.8424925572
486	149	1	1	0	50.4576280129
486	150	0	0	0	53.9694172585
486	151	3	1	2	42.8196666049
486	163	1	0	1	69.7093020078
486	169	1	0	1	107.203730709
486	171	1	0	1	93.8264113054
486	177	1	0	1	88.2868860497
486	183	1	0	1	156.21190113
486	196	1	0	1	186.048941963
486	208	0	0	0	160.817485789
486	212	1	0	1	148.941110573
486	220	0	0	0	176.478951753
486	245	1	0	1	102.169869974
486	247	2	0	2	119.776955525
486	266	1	0	1	132.232659269
486	270	1	0	1	115.06676408
486	277	5	0	5	122.182215546
486	297	1	0	1	143.984852249
486	303	1	0	1	85.3124047579
486	307	0	0	0	94.4266153843
486	309	1	0	1	88.054034585
486	319	2	0	2	115.141324829
486	338	1	0	1	135.542968178
486	379	0	0	0	75.8930037235
486	389	1	0	1	87.2174881604
486	399	1	0	1	52.6016909636
486	408	0	0	0	67.0365129043
486	411	0	0	0	71.2629743886
486	426	1	0	1	83.1777166749
486	463	1	0	1	26.0101295949
486	464	26	0	26	23.942218698
486	465	14	0	14	35.4261312158
486	466	94	12	82	29.2084572841
486	468	2	0	2	40.1525618565
486	469	142	42	100	34.3071653538
486	470	3	0	3	37.9290473554
486	471	37	1	36	19.1350802616
486	472	11	0	11	32.350645846
486	474	7	1	6	22.3783582535
486	475	7	2	5	49.8834054838
486	476	7	0	7	33.3881238212
486	477	6	3	3	26.9842832473
486	478	1	0	1	33.9118317383
486	480	14	2	12	26.1007927692
486	481	107	6	101	8.64404746695
486	482	77	31	46	15.4668001515
486	483	5	0	5	22.6028373071
486	484	347	92	255	10.965041318
486	485	10	3	7	23.7459933221
486	487	1015	820	195	5.59073705638
486	488	170	40	130	11.1716106209
486	489	508	275	233	4.81747296002
486	490	29	0	29	12.7736918282
486	491	57	1	56	20.7042402234
486	492	9	3	6	17.3219377172
486	493	6	0	6	27.7728381595
486	494	2	0	2	40.7328086706
486	495	4	1	3	40.0156679654
486	496	1	0	1	47.8967300046
486	499	1	0	1	42.6960813535
486	501	6	0	6	38.8562482119
486	502	2	0	2	48.0140660327
486	503	2	0	2	50.8445445612
486	505	1	0	1	32.6954733803
486	506	1	0	1	59.4975921994
486	514	1	1	0	151.298587565
486	552	1	0	1	131.291364647
486	553	2	0	2	148.64278714
486	561	1	0	1	120.966444596
486	563	1	0	1	106.924314807
486	565	2	0	2	158.084854748
486	573	2	0	2	94.8884346651
486	586	3	0	3	132.8936014
487	1	39	6	33	71.0494858455
487	13	2	0	2	66.7223251179
487	15	1	0	1	65.0640324486
487	17	1	0	1	55.9551338615
487	20	1	0	1	56.885582267
487	27	1	0	1	50.7925831459
487	28	3	0	3	74.6024720997
487	30	1	0	1	52.4646326453
487	32	6	0	6	81.1178101174
487	34	1	0	1	48.0583005674
487	35	2	0	2	57.8859516969
487	36	4	0	4	68.5648128929
487	37	1	0	1	51.1858332573
487	42	1	0	1	73.37129774
487	43	1	0	1	26.1325368423
487	44	1	0	1	41.6751989738
487	45	17	5	12	15.383472136
487	46	3	1	2	41.662473122
487	47	2	0	2	19.4519449868
487	48	27	8	19	28.7383294739
487	49	2	0	2	45.6665221209
487	50	7	0	7	39.6513095889
487	55	1	0	1	31.8026544191
487	57	4	0	4	23.8484031758
487	59	46	7	39	17.1731130404
487	60	6	0	6	35.634726998
487	61	2	0	2	30.2155086971
487	62	1	0	1	34.9666943459
487	63	1	0	1	23.2632854797
487	65	10	1	9	34.6381170958
487	66	0	0	0	43.2804438314
487	68	6	0	6	37.1752012998
487	69	2	0	2	30.1155781327
487	73	26	1	25	79.9650506835
487	74	3	0	3	80.9562870514
487	75	5	0	5	78.0806752468
487	78	4	0	4	82.6182627151
487	79	0	0	0	82.92048138
487	80	0	0	0	83.6763942547
487	82	2	0	2	84.1789915111
487	83	1	0	1	81.3404498009
487	84	6	2	4	79.88508492
487	85	1	0	1	85.4614351226
487	96	1	0	1	96.6458527739
487	102	1	0	1	80.8100862718
487	107	1	0	1	76.859779444
487	110	1	0	1	69.8011699373
487	111	3	0	3	93.847612324
487	113	5	3	2	73.2259751118
487	117	2	0	2	75.6214717859
487	124	3	0	3	43.7851647935
487	129	1	0	1	63.1097384458
487	131	7	0	7	31.6543715272
487	132	1	0	1	38.936502943
487	133	1	0	1	58.7646193373
487	135	2	1	1	59.2048748053
487	137	1	0	1	71.2573692698
487	140	3	0	3	67.2077608189
487	141	4	0	4	54.7315076655
487	142	19	1	18	59.6979466437
487	145	1	0	1	53.3999261358
487	147	8	0	8	53.5264859868
487	153	1	0	1	48.3553645136
487	154	1	0	1	64.530084562
487	177	0	0	0	82.7819977909
487	183	0	0	0	151.722282685
487	188	1	0	1	157.778687699
487	196	0	0	0	180.904672843
487	202	1	1	0	175.131818223
487	204	1	0	1	141.79323257
487	213	1	0	1	160.633478205
487	220	1	0	1	171.924789081
487	242	0	0	0	189.398228788
487	245	1	0	1	96.8421813851
487	266	1	0	1	127.620003316
487	268	1	0	1	135.41537439
487	276	1	0	1	123.131689861
487	277	4	0	4	117.239132713
487	294	1	0	1	134.734297914
487	307	0	0	0	89.6719142167
487	416	1	0	1	62.5184742542
487	460	0	0	0	57.023739451
487	463	2	0	2	25.156239143
487	464	22	4	18	18.5874403164
487	465	7	3	4	32.1677973256
487	466	89	9	80	26.8757119371
487	468	1	0	1	34.8056303767
487	469	135	9	126	30.0557729909
487	470	3	1	2	32.900039828
487	471	29	2	27	13.5834308987
487	472	5	0	5	27.1129691047
487	474	12	2	10	21.6969736477
487	475	7	0	7	45.3669254781
487	476	14	0	14	27.7978059842
487	477	4	0	4	23.2072745021
487	478	2	0	2	32.3538082763
487	479	2	0	2	19.6663467795
487	480	21	3	18	21.3416848309
487	481	47	16	31	11.9750691403
487	482	53	23	30	17.8931398201
487	483	3	1	2	26.1105804923
487	484	339	19	320	6.95996264211
487	485	9	0	9	25.6877373249
487	486	354	91	263	5.59073705638
487	488	136	60	76	9.29781732016
487	489	238	2	236	10.3552362164
487	490	51	16	35	7.61669886525
487	491	61	12	49	17.249865488
487	492	8	2	6	16.9955527552
487	493	8	0	8	28.7945211366
487	494	2	0	2	36.5198283656
487	495	5	0	5	37.7922411401
487	496	2	0	2	44.1463351686
487	499	1	0	1	39.8912655114
487	500	1	0	1	38.6324586187
487	501	4	1	3	37.7840547177
487	503	9	0	9	47.9211290925
487	505	2	0	2	32.5161261399
487	553	2	0	2	144.612892757
487	560	1	0	1	112.273455983
487	565	1	0	1	153.914408095
487	573	0	0	0	90.058906888
487	586	2	0	2	127.960756757
488	1	42	0	42	76.8953980902
488	2	1	0	1	66.0484173041
488	3	1	0	1	76.1210635144
488	5	3	1	2	69.9174691885
488	13	2	0	2	70.987985932
488	15	2	0	2	69.9957857044
488	21	1	0	1	68.1400387513
488	25	1	0	1	66.81911824
488	26	1	0	1	55.3292268799
488	28	2	0	2	80.0813597791
488	30	0	0	0	56.2810809081
488	32	6	1	5	85.1758741603
488	33	1	0	1	66.2518796841
488	34	1	0	1	51.067017746
488	35	2	0	2	61.9771694323
488	36	7	0	7	71.533902187
488	45	11	0	11	19.7236083551
488	46	6	0	6	49.0360320788
488	48	24	10	14	33.5384027383
488	50	6	0	6	44.4055179317
488	55	1	0	1	38.4036408288
488	57	1	0	1	27.0879153678
488	58	2	0	2	49.1873798155
488	59	17	1	16	24.5078005914
488	60	2	0	2	40.3710183536
488	62	1	0	1	43.9783739219
488	65	6	0	6	42.616265455
488	68	5	1	4	40.5407311585
488	69	4	1	3	32.2520097023
488	70	3	0	3	88.3534563658
488	71	1	0	1	79.9452752156
488	73	30	0	30	81.1606092959
488	74	5	0	5	81.6263878851
488	75	14	1	13	79.1158290584
488	76	1	0	1	86.9932106173
488	78	0	0	0	83.2335033425
488	79	1	0	1	84.3841538345
488	80	0	0	0	84.9225930173
488	81	2	0	2	85.6092233949
488	82	1	0	1	84.9881623883
488	83	1	0	1	82.3355567529
488	84	4	0	4	80.9153675796
488	85	1	0	1	85.7863484653
488	86	1	0	1	81.7411780498
488	87	5	0	5	78.572923669
488	103	4	0	4	75.4962741105
488	109	1	0	1	93.2997027119
488	110	3	0	3	71.1710456329
488	111	2	0	2	95.5945817673
488	112	1	0	1	75.1955417177
488	113	6	0	6	73.9994458283
488	114	1	0	1	72.1078062075
488	115	1	0	1	100.853979879
488	120	1	0	1	84.2103220085
488	124	3	1	2	44.5258966256
488	128	4	3	1	58.8611751085
488	129	2	0	2	65.1000450564
488	131	10	0	10	30.8536799784
488	132	1	0	1	35.0626718167
488	133	2	0	2	60.2133809934
488	136	1	1	0	51.171498386
488	137	2	1	1	70.442112294
488	138	0	0	0	58.0656303125
488	139	1	0	1	40.3272212291
488	140	3	0	3	67.877402032
488	141	1	0	1	50.1321125306
488	142	44	0	44	59.5628212441
488	143	2	0	2	52.0900270651
488	145	1	0	1	54.3535603742
488	147	2	1	1	50.6449463283
488	149	1	0	1	41.2468516444
488	152	0	0	0	45.6329908373
488	164	1	0	1	82.367839068
488	171	1	0	1	87.5930850861
488	175	1	0	1	85.9092063738
488	183	2	0	2	157.017668393
488	188	1	0	1	162.446086286
488	207	1	0	1	153.643635544
488	208	0	0	0	158.175278634
488	229	1	0	1	164.220435546
488	242	1	0	1	194.046066253
488	246	1	0	1	101.842683554
488	262	0	0	0	112.233658003
488	272	1	0	1	136.836569476
488	277	7	0	7	121.399779584
488	282	0	0	0	121.530304743
488	303	1	0	1	86.6085844769
488	305	1	0	1	104.747255967
488	307	0	0	0	94.4963044171
488	319	1	0	1	106.80872113
488	396	1	0	1	49.6702672695
488	408	0	0	0	55.9691903413
488	415	1	0	1	54.5993448727
488	417	1	0	1	59.1295111341
488	431	0	0	0	66.4950171484
488	455	0	0	0	58.205680707
488	464	38	3	35	17.239783454
488	465	27	0	27	24.3307874354
488	466	266	0	266	18.083364442
488	468	1	0	1	32.4558876418
488	469	269	5	264	24.0002999414
488	470	4	1	3	29.0830554345
488	471	97	19	78	14.7844981061
488	472	12	1	11	24.4476295745
488	474	85	29	56	12.4428677599
488	475	14	4	10	39.7422287417
488	476	16	4	12	28.582352333
488	477	32	7	25	16.3069788566
488	478	14	2	12	23.1691974681
488	479	4	0	4	21.2235170439
488	480	60	0	60	17.0439515667
488	481	110	29	81	9.66154781094
488	482	218	33	185	12.0211966959
488	483	15	3	12	21.014939007
488	484	157	0	157	15.5084452332
488	485	43	1	42	18.2622758116
488	486	126	49	77	11.1716106209
488	487	369	157	212	9.29781732016
488	489	160	4	156	14.9913551756
488	490	80	8	72	8.11323893409
488	491	234	98	136	9.94312600897
488	492	119	75	44	8.00195129944
488	493	13	0	13	20.3057444953
488	494	3	0	3	30.2802570094
488	495	10	0	10	28.9498831548
488	497	1	0	1	42.9864111146
488	499	2	0	2	31.5249449184
488	501	6	0	6	28.5032079298
488	502	1	0	1	37.0825522337
488	503	3	0	3	39.6732581974
488	504	3	0	3	33.2303901078
488	505	10	0	10	23.3151507262
488	506	2	0	2	49.5661723434
488	507	0	0	0	163.348471432
488	565	3	0	3	147.325156099
488	573	1	0	1	85.0606727501
488	586	1	0	1	123.204155855
489	1	34	2	32	78.668936676
489	4	1	0	1	71.4306961505
489	5	1	0	1	70.2507500853
489	10	1	0	1	72.5256167051
489	13	1	0	1	75.6091569273
489	15	2	0	2	73.5101895077
489	24	2	1	1	69.0853224942
489	26	0	0	0	57.9166352075
489	32	9	0	9	90.0460147623
489	35	2	1	1	66.9487127257
489	36	3	2	1	78.1215101418
489	43	1	0	1	30.4878394213
489	45	6	1	5	25.2587545302
489	46	2	1	1	47.9587852964
489	48	14	3	11	37.867060321
489	50	2	0	2	48.5479697317
489	51	1	0	1	53.7923438948
489	59	24	0	24	24.8584962355
489	60	1	0	1	44.6242369007
489	61	1	0	1	35.628267104
489	65	10	0	10	40.1787542078
489	68	1	0	1	46.827588168
489	69	4	2	2	40.2387895929
489	70	1	0	1	97.5208386745
489	71	1	0	1	89.9800163288
489	73	14	0	14	90.0711831666
489	74	3	0	3	91.1680407004
489	78	2	0	2	92.8373684006
489	81	1	0	1	94.5340610101
489	84	2	0	2	90.0282981748
489	87	3	0	3	88.0804765502
489	105	0	0	0	94.4758871176
489	112	4	0	4	83.4788628194
489	113	5	0	5	83.4309822725
489	122	0	0	0	106.306299952
489	124	1	0	1	54.0628189366
489	125	1	0	1	57.7634502943
489	126	2	1	1	51.7692770985
489	130	0	0	0	66.2716455129
489	131	5	1	4	41.9893802947
489	132	1	0	1	48.7066985554
489	133	1	0	1	68.8655415966
489	136	1	0	1	61.474992053
489	137	0	0	0	81.6122398876
489	140	1	0	1	77.4407120089
489	142	19	0	19	70.0318826718
489	144	1	0	1	75.4230189043
489	147	3	1	2	63.6388970973
489	172	1	0	1	88.0967470996
489	183	1	0	1	159.502365099
489	186	1	0	1	159.490930781
489	211	1	0	1	172.612801751
489	245	0	0	0	106.418214167
489	262	1	0	1	118.030758672
489	271	1	0	1	145.221171877
489	272	1	0	1	142.170851996
489	277	4	0	4	125.971189308
489	282	0	0	0	127.365785043
489	290	2	1	1	136.809872501
489	301	1	0	1	140.418361152
489	304	1	0	1	85.4571480633
489	399	1	0	1	55.4804771571
489	408	2	0	2	70.1249649471
489	463	1	0	1	28.4899950549
489	464	6	3	3	28.7539648526
489	465	7	0	7	39.2877366263
489	466	66	19	47	32.5926117661
489	468	1	0	1	44.9586035473
489	469	94	14	80	38.7023885299
489	470	2	0	2	42.6467659765
489	471	19	0	19	23.9322144181
489	472	1	0	1	37.1362737235
489	474	13	0	13	24.8548028095
489	475	4	1	3	54.363145643
489	476	4	1	3	38.128753896
489	477	1	0	1	31.1990352471
489	478	3	0	3	36.7174381438
489	479	0	0	0	29.9878863578
489	480	8	0	8	30.7468795816
489	481	93	37	56	9.04292416622
489	482	52	13	39	15.785689763
489	483	2	0	2	21.277747816
489	484	127	39	88	14.7956989026
489	485	13	0	13	24.021900518
489	486	174	147	27	4.81747296002
489	487	359	9	350	10.3552362164
489	488	87	7	80	14.9913551756
489	490	12	2	10	17.5741948538
489	491	28	3	25	24.8498056423
489	492	16	1	15	19.7947916394
489	493	5	1	4	28.7357036128
489	495	3	0	3	43.1953667632
489	496	1	0	1	51.9717182169
489	499	0	0	0	46.2288994183
489	501	6	1	5	41.2482667819
489	503	1	0	1	54.4048312541
489	504	1	0	1	48.1865319848
489	505	2	0	2	34.5159885593
489	552	1	0	1	135.572608084
489	555	1	0	1	119.225151071
489	559	1	0	1	124.642250545
489	565	1	0	1	162.295867356
489	583	1	0	1	154.013788253
489	586	1	0	1	137.53298521
490	0	1	0	1	67.2788171778
490	1	28	12	16	68.7949185429
490	7	1	0	1	63.7724241661
490	26	1	0	1	47.2215072714
490	31	1	0	1	55.759209772
490	32	1	0	1	77.1970904042
490	33	1	0	1	58.2997284856
490	34	1	0	1	43.2712579917
490	35	1	0	1	53.9695729249
490	36	7	0	7	63.7952563982
490	37	1	0	1	47.6654491584
490	43	1	0	1	28.4036585952
490	45	27	0	27	11.6184446255
490	46	2	0	2	41.357818634
490	47	5	0	5	19.3910290893
490	48	30	1	29	25.4255721291
490	50	1	0	1	36.3025330848
490	52	1	1	0	33.9226601511
490	53	1	0	1	52.6435047732
490	55	2	1	1	30.5029186884
490	57	2	1	1	19.1080287557
490	58	1	0	1	42.0074994989
490	59	25	8	17	17.1602361994
490	60	2	0	2	32.2651025421
490	63	1	0	1	23.6136358912
490	65	9	0	9	35.3458217077
490	68	3	0	3	32.6192069176
490	69	6	0	6	24.6175419344
490	70	2	0	2	81.4003254542
490	73	24	3	21	74.0956821819
490	74	2	0	2	74.810340046
490	75	3	0	3	72.1207429488
490	76	1	0	1	80.1633362604
490	78	3	0	3	76.4472663423
490	79	2	0	2	77.2065934051
490	81	1	0	1	78.5592846663
490	82	3	0	3	78.1094405352
490	83	5	0	5	75.3644339373
490	84	4	0	4	73.9255708801
490	85	1	0	1	79.1523117571
490	86	1	0	1	75.2132368707
490	87	5	0	5	71.7356020627
490	92	1	0	1	84.0967149893
490	96	2	0	2	90.2691347994
490	103	4	1	3	68.3646871503
490	110	4	0	4	64.0106262158
490	112	3	0	3	67.9020432556
490	113	7	0	7	67.1190420187
490	117	1	0	1	69.3899664693
490	119	1	0	1	81.0293550597
490	124	2	0	2	37.563629211
490	126	1	0	1	34.3448299134
490	130	1	0	1	48.7912416604
490	131	10	8	2	24.6537901799
490	132	1	0	1	31.330370559
490	133	1	0	1	52.991948869
490	135	1	0	1	51.7919014539
490	137	0	0	0	64.4321515135
490	138	0	0	0	50.5914156393
490	140	1	0	1	61.0345852198
490	142	37	3	34	53.123325724
490	143	1	0	1	46.1126180046
490	144	1	0	1	58.2062804341
490	145	1	0	1	47.3340442458
490	147	4	0	4	46.0688126469
490	149	2	0	2	37.8583258251
490	154	1	0	1	57.3236580162
490	169	0	0	0	95.1681198147
490	172	1	0	1	70.6977538868
490	177	0	0	0	75.6412265356
490	208	1	0	1	150.5993284
490	209	1	0	1	148.491184261
490	220	0	0	0	168.945353217
490	245	1	0	1	91.9148558873
490	259	1	0	1	102.711545448
490	262	1	0	1	104.416079512
490	264	1	0	1	91.8727971374
490	274	1	0	1	107.888004068
490	277	1	0	1	113.421286889
490	307	0	0	0	86.4163877425
490	415	1	0	1	56.0710298937
490	463	1	0	1	22.0416137265
490	464	68	18	50	11.1963011081
490	465	15	0	15	25.7315167847
490	466	175	21	154	21.6928995029
490	467	1	0	1	46.2986360444
490	468	1	0	1	27.3850071025
490	469	276	40	236	22.7416147563
490	470	3	0	3	25.2885288309
490	471	136	105	31	7.09528219786
490	472	18	1	17	19.5834340142
490	474	12	0	12	19.1288545272
490	475	8	1	7	37.8467982133
490	476	37	5	32	21.4596466619
490	477	21	9	12	16.4376484979
490	478	4	1	3	27.9208596507
490	479	6	2	4	13.6284972424
490	480	44	29	15	13.7810938798
490	481	37	4	33	16.0997399817
490	482	42	2	40	19.9654568369
490	483	1	0	1	28.9143106166
490	484	228	51	177	10.1750466562
490	485	0	0	0	26.341793566
490	486	105	5	100	12.7736918282
490	487	357	5	352	7.61669886525
490	488	255	48	207	8.11323893409
490	489	103	14	89	17.5741948538
490	491	217	45	172	11.2148514768
490	492	14	0	14	15.5751145492
490	493	6	2	4	27.9795295093
490	494	3	1	2	29.1914525417
490	495	4	1	3	32.3897398648
490	500	0	0	0	32.0184518034
490	501	5	1	4	33.7847665691
490	502	1	0	1	40.8541289335
490	503	6	0	6	41.6151975652
490	505	1	0	1	29.8755904647
490	536	0	0	0	137.690224693
490	555	1	0	1	102.890094569
490	565	2	1	1	146.491697387
490	567	1	0	1	88.4403093508
490	587	1	0	1	116.307415561
491	0	1	0	1	72.3229809137
491	1	60	8	52	75.6447139817
491	2	1	0	1	63.6924857358
491	5	5	1	4	69.7965980614
491	6	1	0	1	63.2641980071
491	7	3	1	2	69.2483610198
491	8	3	0	3	79.5345121479
491	9	2	0	2	75.4261853376
491	11	1	0	1	76.3629171843
491	13	3	0	3	67.9042502022
491	15	1	0	1	67.7072388481
491	21	1	0	1	67.3534788197
491	22	1	0	1	78.5066448798
491	23	4	0	4	65.507507533
491	24	2	1	1	64.635936893
491	26	1	0	1	54.1416568762
491	28	2	0	2	78.3101720249
491	31	1	0	1	58.6641308581
491	32	2	0	2	81.6556130935
491	34	2	0	2	47.1021397623
491	35	2	0	2	58.8777271376
491	36	12	2	10	67.0477926057
491	39	1	0	1	77.1422997057
491	45	8	0	8	20.1584270336
491	46	5	0	5	50.5906249655
491	47	5	0	5	29.580413636
491	48	26	12	14	32.5140735228
491	49	1	0	1	49.070867485
491	50	9	1	8	42.649572845
491	51	1	0	1	46.4886403509
491	53	1	0	1	62.8170825568
491	55	2	0	2	39.2867206397
491	57	6	2	4	24.9989759229
491	59	13	4	9	27.5096679528
491	60	4	0	4	38.8018717218
491	65	5	3	2	45.3878445536
491	66	1	0	1	48.3232100247
491	68	7	0	7	37.4167929576
491	69	28	1	27	28.4152948414
491	70	4	1	3	81.8150177109
491	71	2	0	2	72.8873763475
491	72	1	0	1	80.6443296121
491	73	74	0	74	74.8774187656
491	74	9	0	9	74.8957567868
491	75	16	0	16	72.7168182552
491	76	1	0	1	80.2504296301
491	78	5	0	5	76.442781534
491	79	2	0	2	78.3019059819
491	80	0	0	0	78.6452716955
491	81	3	0	3	79.26629422
491	82	2	2	0	78.3406097493
491	83	4	0	4	75.8688875212
491	84	6	0	6	74.493012555
491	85	2	0	2	78.7408138628
491	86	5	0	5	74.5653502759
491	87	5	0	5	71.9002623244
491	88	2	0	2	71.7491902572
491	89	3	0	3	84.9610999362
491	90	2	0	2	84.2827816475
491	92	2	1	1	85.0460671815
491	95	3	0	3	73.1111919827
491	99	1	0	1	60.4790962724
491	102	2	0	2	79.291086437
491	103	10	1	9	69.3898561618
491	107	2	0	2	68.5724580057
491	109	1	0	1	86.500791882
491	110	5	0	5	65.1639234964
491	111	2	0	2	89.6644433532
491	112	7	0	7	69.4361684272
491	113	33	0	33	67.4379586062
491	115	1	0	1	94.7578274742
491	119	0	0	0	79.9334100639
491	124	6	0	6	38.578565944
491	125	1	0	1	43.8573185241
491	131	33	10	23	24.2456108966
491	133	2	0	2	54.46796335
491	135	0	0	0	47.655905317
491	137	0	0	0	62.6830590586
491	138	1	0	1	52.9548814735
491	140	3	0	3	61.3105008711
491	141	3	0	3	40.4703563979
491	142	100	11	89	52.4679657918
491	145	2	0	2	48.293300333
491	146	2	0	2	66.7910634142
491	147	14	3	11	41.780070132
491	148	2	1	1	47.9786260908
491	151	1	0	1	31.2296172914
491	152	1	0	1	38.3330278779
491	168	1	0	1	71.7119867704
491	172	2	2	0	67.9573616714
491	177	1	0	1	72.4956984817
491	183	0	0	0	154.488082051
491	187	1	0	1	161.720225692
491	188	1	0	1	159.143164047
491	207	1	0	1	148.598105077
491	208	2	0	2	152.778954423
491	209	1	0	1	151.139382059
491	211	1	0	1	160.534860333
491	225	0	0	0	154.869379934
491	237	1	0	1	143.737370283
491	242	0	0	0	190.637076921
491	243	1	0	1	184.734484384
491	245	0	0	0	94.4577525577
491	246	1	0	1	96.2342266215
491	247	1	0	1	109.571039851
491	277	4	1	3	117.696454638
491	282	0	0	0	116.980302171
491	293	1	0	1	127.063407151
491	303	4	0	4	85.0431883549
491	305	1	0	1	101.402928282
491	307	0	0	0	91.7547603352
491	309	2	0	2	84.5903034455
491	329	1	0	1	97.7171087418
491	338	0	0	0	120.713044224
491	349	1	0	1	108.660187019
491	408	5	0	5	47.7482167328
491	415	2	0	2	45.4011868138
491	427	1	0	1	51.853304323
491	431	1	0	1	60.9112041531
491	463	7	0	7	12.9894065848
491	464	157	0	157	12.2618098223
491	465	62	24	38	14.9194613022
491	466	1640	52	1588	10.599034251
491	468	10	0	10	24.4232458114
491	469	1095	190	905	14.114399798
491	470	17	16	1	20.1417834533
491	471	74	11	63	13.6270053759
491	472	97	1	96	16.7198098861
491	473	3	1	2	23.3270519725
491	474	131	18	113	11.3952785747
491	475	44	10	34	29.8561321224
491	476	45	21	24	23.7241271376
491	477	257	23	234	6.36485470878
491	478	31	0	31	17.1305542462
491	479	15	0	15	18.3460516867
491	480	412	160	252	8.80001549036
491	481	20	7	13	19.114179402
491	482	55	0	55	18.964493487
491	483	10	5	5	27.3141017616
491	484	71	10	61	21.3687138481
491	485	22	1	21	21.9295182065
491	486	30	1	29	20.7042402234
491	487	97	2	95	17.249865488
491	488	170	59	111	9.94312600897
491	489	26	4	22	24.8498056423
491	490	44	1	43	11.2148514768
491	492	38	1	37	10.9355788673
491	493	32	0	32	21.263859562
491	494	31	0	31	20.3418963455
491	495	27	4	23	21.1783296956
491	496	2	1	1	27.192579233
491	499	3	1	2	22.7341351313
491	500	4	2	2	21.4058624558
491	501	39	3	36	23.167298424
491	503	30	0	30	30.6960495456
491	504	6	1	5	23.339390009
491	505	44	6	38	20.6812685837
491	507	1	0	1	154.846809491
491	555	0	0	0	94.4350794937
491	563	1	0	1	86.6294903025
491	565	2	0	2	137.450349645
491	573	0	0	0	75.2128275795
491	581	0	0	0	73.4993711663
492	1	23	0	23	84.1202999676
492	13	1	0	1	77.4723696683
492	19	1	0	1	84.5624920034
492	26	1	0	1	62.5191452366
492	32	3	0	3	91.4763010482
492	34	1	0	1	57.0490295539
492	35	1	0	1	68.4302845134
492	36	3	0	3	77.28603887
492	42	1	0	1	82.8003220044
492	45	3	0	3	27.0610517939
492	46	4	0	4	56.8746715777
492	47	1	0	1	34.7196340819
492	48	10	0	10	40.6510268996
492	50	2	0	2	51.3439780821
492	57	2	0	2	33.7223957061
492	59	5	0	5	32.4346805457
492	65	4	0	4	50.5820473145
492	68	3	0	3	46.8806799107
492	69	3	1	2	38.1668864626
492	70	2	0	2	92.6847038022
492	71	0	0	0	83.8123098901
492	73	15	0	15	85.6969773517
492	74	1	0	1	85.7892986472
492	75	8	1	7	83.5570296363
492	76	1	0	1	91.1478869
492	78	5	0	5	87.3443543974
492	81	2	0	2	90.1006712433
492	82	0	0	0	89.2247195183
492	83	1	0	1	86.7233631726
492	84	1	0	1	85.3387721422
492	87	2	0	2	82.7844403771
492	88	0	0	0	82.6574854129
492	89	1	0	1	95.6316638751
492	92	3	0	3	95.8547005445
492	95	1	0	1	83.7235878434
492	99	1	0	1	71.1891006608
492	103	3	0	3	80.166308813
492	105	0	0	0	92.5115475711
492	108	1	0	1	105.510904452
492	112	2	0	2	80.124576464
492	113	6	0	6	78.302340474
492	116	1	0	1	92.9415686031
492	117	1	0	1	80.2403880106
492	120	1	0	1	89.1444330449
492	124	1	0	1	49.2523921051
492	126	1	0	1	43.5161340308
492	127	2	0	2	70.8197373837
492	128	2	0	2	61.8375160897
492	129	1	0	1	70.307260774
492	131	5	0	5	35.0197187207
492	132	1	0	1	36.4642017672
492	133	1	0	1	65.1282373841
492	140	6	0	6	72.1706144178
492	141	1	0	1	50.2758068382
492	142	41	3	38	63.3875806052
492	144	1	0	1	67.3885592444
492	145	2	0	2	59.0261134731
492	146	0	0	0	77.7218032379
492	147	2	0	2	52.423925616
492	149	0	0	0	42.0394837468
492	151	1	0	1	41.9295039847
492	171	1	0	1	90.7183938404
492	177	0	0	0	83.2426691726
492	183	0	0	0	163.837688254
492	208	0	0	0	163.414320636
492	220	0	0	0	183.741417335
492	242	1	0	1	200.475874661
492	245	0	0	0	104.959630598
492	272	1	0	1	142.758488432
492	276	1	0	1	131.776670585
492	277	0	0	0	127.645665394
492	282	1	0	1	127.30203971
492	293	1	0	1	137.682111501
492	319	1	0	1	107.836996112
492	408	1	1	0	50.408498139
492	416	2	0	2	46.8978942548
492	463	9	0	9	8.72882875124
492	464	26	1	25	22.1935701288
492	465	31	6	25	21.4270646647
492	466	603	122	481	13.6375858906
492	467	1	0	1	47.0112344585
492	468	1	0	1	35.3530158179
492	469	235	0	235	23.7951895421
492	470	1	0	1	30.8898589021
492	471	23	9	14	21.3843796428
492	472	11	5	6	27.6394161341
492	473	1	0	1	33.3274567647
492	474	225	86	139	5.08316843716
492	475	10	1	9	39.087572868
492	476	15	0	15	33.8919499501
492	477	24	0	24	16.0216983895
492	478	33	1	32	16.9405707318
492	480	35	11	24	19.720487647
492	481	93	16	77	11.4368845829
492	482	476	268	208	8.50059631524
492	483	37	6	31	16.3987732395
492	484	39	0	39	23.4759127501
492	485	103	35	68	11.3779964951
492	486	27	4	23	17.3219377172
492	487	83	15	68	16.9955527552
492	488	333	70	263	8.00195129944
492	489	43	1	42	19.7947916394
492	490	20	1	19	15.5751145492
492	491	127	7	120	10.9355788673
492	493	48	9	39	12.4129021381
492	494	7	1	6	29.3411717263
492	495	23	1	22	23.64653166
492	496	3	0	3	34.4520796216
492	499	4	0	4	27.1993444068
492	500	2	0	2	27.7005955778
492	501	31	10	21	21.5633626962
492	503	5	0	5	35.3178881765
492	505	43	9	34	15.568455641
492	566	0	0	0	75.0142932234
493	0	1	0	1	93.5158956197
493	1	25	1	24	96.2917614689
493	7	1	0	1	90.3570567279
493	8	1	0	1	98.2071457715
493	9	1	0	1	96.5982744601
493	12	1	0	1	94.4341710921
493	15	1	0	1	88.7296393586
493	23	2	0	2	86.1588456828
493	28	1	0	1	99.1801683208
493	36	5	0	5	88.2734919492
493	39	1	0	1	98.4052474897
493	41	0	0	0	82.2735196962
493	46	1	0	1	69.2845959799
493	48	6	0	6	52.8409163545
493	49	1	0	1	69.8089323517
493	50	1	0	1	63.3954986603
493	58	1	0	1	69.4720775394
493	59	3	0	3	44.8089021578
493	65	1	0	1	62.9176190877
493	68	2	0	2	58.5506692359
493	70	2	0	2	102.116540335
493	72	1	0	1	101.194360994
493	73	26	1	25	95.4016854034
493	74	5	1	4	95.0827909053
493	75	2	0	2	93.174182795
493	77	1	0	1	99.9124617925
493	78	6	0	6	96.5674435717
493	79	1	0	1	98.9366427714
493	80	0	0	0	99.1538114267
493	81	1	0	1	99.7265527832
493	82	0	0	0	98.5745694769
493	83	3	0	3	96.2587355946
493	84	5	2	3	94.9232236344
493	85	2	0	2	98.6092893187
493	87	2	0	2	92.1561284472
493	88	1	0	1	91.8379243376
493	90	1	0	1	103.918259291
493	92	1	0	1	105.58021339
493	95	1	0	1	94.0645990156
493	96	0	0	0	109.099820175
493	103	2	0	2	90.0544976438
493	105	1	0	1	103.000661579
493	107	2	0	2	87.8089298584
493	112	2	0	2	90.283724027
493	113	12	0	12	87.8125166948
493	121	1	0	1	88.1398296176
493	124	3	0	3	59.5483091411
493	126	2	0	2	52.643204276
493	128	1	0	1	70.0835398817
493	131	8	0	8	45.1606739903
493	133	2	0	2	75.3976415841
493	134	2	0	2	75.9268603925
493	139	1	0	1	50.8208202366
493	140	1	0	1	81.7290132491
493	141	2	0	2	55.3350146122
493	142	45	2	43	72.5510954128
493	143	1	0	1	64.2290398371
493	144	0	0	0	75.7920991742
493	146	6	2	4	86.6192698473
493	147	1	0	1	59.4900041408
493	150	1	0	1	52.7330547333
493	155	1	0	1	103.501905194
493	158	0	0	0	92.7258929611
493	163	0	0	0	68.8850952817
493	164	1	0	1	93.661717572
493	169	0	0	0	113.542658622
493	172	1	0	1	86.2345492949
493	177	0	0	0	90.2938052743
493	181	0	0	0	166.429138146
493	183	1	0	1	175.643128867
493	184	1	0	1	168.125470224
493	192	0	0	0	197.211737553
493	208	0	0	0	173.622822625
493	245	1	0	1	115.507510151
493	262	1	0	1	128.971538137
493	277	2	0	2	138.959652976
493	282	0	0	0	138.147487209
493	303	1	0	1	105.84409831
493	307	1	0	1	112.920667968
493	321	1	0	1	115.058061297
493	345	1	0	1	175.874867564
493	358	1	0	1	147.912503366
493	396	1	0	1	41.8768583597
493	406	2	0	2	40.13638681
493	408	3	1	2	45.7629069821
493	426	1	0	1	55.5713847387
493	427	2	0	2	43.4848203334
493	460	1	0	1	49.2578951074
493	463	36	0	36	9.4247017856
493	464	13	4	9	33.4537118783
493	465	40	4	36	24.8676586648
493	466	697	0	697	17.0272212562
493	467	1	0	1	50.5333867738
493	468	1	0	1	44.303533824
493	469	240	156	84	30.4220382277
493	470	2	0	2	38.9981432999
493	471	27	0	27	33.504607481
493	472	7	1	6	37.2888631182
493	473	1	0	1	39.5786110245
493	474	96	0	96	9.86863113741
493	475	20	1	19	43.644002202
493	476	9	0	9	44.9879793473
493	477	12	4	8	23.9919080523
493	478	42	0	42	14.956812256
493	479	2	0	2	39.1877381364
493	480	16	8	8	29.6241823331
493	481	13	0	13	19.7256042008
493	482	147	19	128	13.0221310395
493	483	86	35	51	13.4258224397
493	484	7	0	7	35.5543945687
493	485	501	16	485	5.76310707517
493	486	4	0	4	27.7728381595
493	487	9	2	7	28.7945211366
493	488	38	0	38	20.3057444953
493	489	8	2	6	28.7357036128
493	490	2	0	2	27.9795295093
493	491	47	1	46	21.263859562
493	492	22	1	21	12.4129021381
493	494	2	1	1	34.35621611
493	495	20	5	15	22.112135691
493	496	5	1	4	36.6040536445
493	500	1	0	1	29.5833006624
493	501	148	11	137	15.9206741065
493	502	2	0	2	27.0035564814
493	503	23	0	23	34.1541487367
493	504	3	0	3	34.7218178326
493	505	499	27	472	7.85116982286
493	506	3	0	3	33.2553877811
493	573	1	0	1	87.1242060835
493	587	1	0	1	124.250730016
494	0	1	0	1	69.5272173667
494	1	23	0	23	76.3673173963
494	5	0	0	0	73.1154465566
494	7	2	0	2	67.5014422531
494	13	3	0	3	65.1925984846
494	15	3	0	3	66.7323983607
494	21	1	0	1	69.5054887973
494	24	1	0	1	65.1566502904
494	26	1	0	1	56.553355542
494	28	1	0	1	77.8159948326
494	29	1	0	1	61.2765529193
494	30	1	0	1	51.1849255313
494	34	1	0	1	44.3844225375
494	36	7	0	7	61.2009799974
494	39	1	0	1	72.0664211822
494	42	1	0	1	67.4750272484
494	45	2	0	2	32.063665536
494	47	1	0	1	42.0717701664
494	48	16	0	16	38.5337290146
494	49	1	0	1	51.1043876754
494	50	6	1	5	45.3539146562
494	55	0	0	0	47.3354422864
494	59	4	1	3	40.6757865295
494	60	5	1	4	42.5196436332
494	65	3	0	3	55.7681271132
494	68	4	0	4	38.2315469658
494	69	3	0	3	30.0842947979
494	70	5	1	4	70.2611376449
494	71	2	0	2	60.3384202341
494	72	2	0	2	69.9713277256
494	73	71	14	57	64.2298071915
494	74	5	0	5	63.1126824542
494	75	7	0	7	61.8730730519
494	76	1	0	1	68.2374895016
494	78	3	0	3	64.445460147
494	79	2	0	2	68.0109899106
494	81	3	1	2	68.291150472
494	82	8	7	1	66.6360218368
494	84	10	2	8	63.5112940275
494	86	1	0	1	61.6434228443
494	87	2	0	2	60.3934180451
494	88	3	0	3	59.738437448
494	90	1	0	1	70.9204457052
494	92	2	0	2	74.2326088437
494	98	1	0	1	60.4292270214
494	102	1	0	1	72.5750660168
494	103	6	0	6	59.4515280177
494	105	1	0	1	73.6208766259
494	107	1	0	1	54.5537099315
494	110	3	1	2	55.7197729471
494	112	4	1	3	60.3653828676
494	113	17	0	17	56.4365231405
494	120	1	0	1	68.9228232804
494	124	5	0	5	32.2952753705
494	126	2	0	2	22.793587964
494	128	1	0	1	37.1289831481
494	130	0	0	0	31.8016529879
494	131	33	0	33	20.6952585686
494	132	6	0	6	11.2808212336
494	134	5	0	5	45.3217342672
494	137	2	0	2	48.6786552046
494	138	1	0	1	46.7683624767
494	139	1	0	1	18.8376022071
494	140	1	0	1	50.6577345222
494	141	11	0	11	21.1618205827
494	142	64	0	64	41.0338749612
494	143	2	0	2	32.4195249904
494	147	19	5	14	25.5829392572
494	148	1	0	1	41.7383195045
494	149	4	1	3	14.1407127504
494	150	1	0	1	18.5913623956
494	151	2	0	2	26.201689712
494	152	2	0	2	28.0846103057
494	153	1	0	1	23.9747282302
494	154	8	0	8	38.6604716268
494	168	1	0	1	56.5562838415
494	170	1	0	1	64.2360170763
494	171	2	0	2	65.1224962861
494	187	1	0	1	155.09280113
494	204	1	0	1	129.062882643
494	208	0	0	0	142.570054093
494	220	0	0	0	169.376258277
494	224	1	0	1	142.468506386
494	240	1	0	1	183.487648963
494	242	1	0	1	184.390256341
494	262	1	0	1	100.386666791
494	277	4	0	4	111.748791007
494	293	1	0	1	117.231357632
494	300	1	0	1	102.440494448
494	307	0	0	0	88.6203882373
494	327	0	0	0	85.5880559539
494	347	0	0	0	85.901975907
494	357	1	0	1	94.3185969377
494	406	2	0	2	31.207002295
494	408	8	0	8	34.6015678424
494	411	1	0	1	35.8650947056
494	414	1	0	1	31.9049746107
494	415	2	0	2	28.7360319014
494	416	1	0	1	37.1465803391
494	417	1	0	1	33.0474543654
494	431	1	0	1	54.3362431773
494	442	2	1	1	52.0669390064
494	460	1	0	1	20.593050653
494	464	18	3	15	21.1555595911
494	465	84	5	79	9.62967690588
494	466	218	0	218	17.4067898346
494	467	2	0	2	17.8388785119
494	468	9	2	7	15.9058549928
494	469	1042	181	861	6.46414803654
494	470	42	2	40	10.2765163048
494	471	11	1	10	26.7219988831
494	472	30	1	29	15.0255075128
494	473	18	6	12	6.01550613725
494	474	5	0	5	26.669486728
494	475	430	290	140	9.74684184681
494	476	15	3	12	24.9962389888
494	477	29	2	27	13.9939791421
494	478	5	2	3	20.8732804194
494	479	3	1	2	26.2973210388
494	480	33	2	31	15.7333998044
494	481	1	0	1	39.2909416908
494	482	3	0	3	37.8355846191
494	484	4	0	4	38.6302851084
494	485	2	0	2	37.7617147762
494	487	5	0	5	36.5198283656
494	488	19	2	17	30.2802570094
494	489	3	0	3	45.0836220375
494	490	1	0	1	29.1914525417
494	491	45	0	45	20.3418963455
494	493	4	0	4	34.35621611
494	495	27	1	26	17.0746835979
494	496	51	12	39	8.91834804513
494	497	6	2	4	13.9509345318
494	499	3	0	3	13.2956990412
494	500	22	1	21	8.57459099232
494	501	7	1	6	24.936965755
494	502	2	0	2	22.6914542751
494	503	79	11	68	17.0206046364
494	504	86	52	34	4.59624336696
494	505	3	0	3	28.956342939
494	573	1	0	1	55.0380358459
494	576	1	0	1	62.2820208518
494	578	1	0	1	41.9312838228
495	0	1	0	1	85.5937833402
495	1	57	1	56	91.3755507532
495	7	2	0	2	83.2537542337
495	13	5	0	5	81.1995102996
495	15	2	2	0	82.2370127279
495	18	1	0	1	81.711364665
495	19	2	0	2	87.8811210916
495	26	2	0	2	70.6588269389
495	27	1	0	1	74.0419247943
495	28	1	0	1	93.2604587759
495	34	1	0	1	60.1056122408
495	35	2	0	2	72.5496248414
495	36	12	0	12	77.8814919658
495	37	1	0	1	68.3196928702
495	43	1	0	1	60.2224234222
495	45	1	0	1	40.2121066264
495	46	2	0	2	69.8666231012
495	48	21	0	21	50.4666371683
495	50	12	1	11	59.0979579304
495	51	1	0	1	61.7556880412
495	57	1	0	1	42.7183750681
495	59	6	0	6	48.2299760904
495	60	2	0	2	55.7256463038
495	62	1	0	1	69.9964011543
495	65	4	0	4	65.5694111613
495	68	2	0	2	52.5422741652
495	69	2	0	2	43.6480051635
495	70	5	0	5	87.2519599012
495	71	1	0	1	77.2442010396
495	72	1	0	1	87.0259741444
495	73	77	1	76	81.2925409853
495	74	6	0	6	80.10150236
495	75	11	1	10	78.9312261965
495	76	1	0	1	85.1833425873
495	77	1	0	1	85.9201887169
495	78	3	0	3	81.4064926012
495	79	3	0	3	85.0807063127
495	80	0	0	0	84.9092690761
495	81	5	0	5	85.332185625
495	82	9	0	9	83.6218965958
495	83	4	0	4	81.7540503859
495	84	7	0	7	80.560270968
495	85	1	0	1	82.8581529476
495	86	3	0	3	78.4821890516
495	87	3	0	3	77.4149545444
495	90	1	0	1	87.6181155947
495	92	1	0	1	91.2738108389
495	95	3	0	3	81.5535549272
495	96	2	0	2	92.5780086894
495	103	5	0	5	76.5252227938
495	106	0	0	0	95.3945031249
495	107	1	0	1	71.2100999454
495	110	1	0	1	72.776916657
495	111	1	0	1	96.4042591395
495	112	3	0	3	77.4140679743
495	113	28	0	28	73.4964705902
495	119	1	0	1	82.7401876668
495	120	1	0	1	85.9952677297
495	124	4	0	4	48.6697737293
495	126	1	0	1	39.5877127372
495	127	1	0	1	64.8892745758
495	128	2	2	0	54.013233336
495	129	3	0	3	69.2479842107
495	130	1	0	1	48.6818193728
495	131	21	0	21	35.5942720551
495	132	1	0	1	28.3269528749
495	136	1	0	1	51.7293789371
495	138	1	0	1	63.3825068775
495	139	1	0	1	35.9009688415
495	140	3	0	3	67.7319095904
495	141	6	1	5	35.6467243664
495	142	79	2	77	58.104876327
495	144	1	0	1	59.7482882164
495	145	1	0	1	57.0323056403
495	146	1	0	1	71.0981353361
495	147	8	0	8	42.1018855902
495	149	3	0	3	30.6443667366
495	151	2	0	2	42.0108790445
495	154	2	0	2	55.0761697106
495	155	1	0	1	85.8185634494
495	156	0	0	0	90.4520336601
495	172	1	0	1	68.3654703267
495	177	1	0	1	71.7911746018
495	183	0	0	0	167.080487077
495	208	1	0	1	159.587837933
495	214	1	0	1	152.114572052
495	224	1	0	1	159.542648971
495	234	1	0	1	159.612480645
495	243	1	0	1	195.634759655
495	245	1	0	1	103.054570764
495	246	1	0	1	103.56051351
495	253	0	0	0	121.298179382
495	256	1	0	1	94.814375063
495	270	1	0	1	126.013780185
495	277	7	0	7	128.614849902
495	282	0	0	0	126.212649135
495	287	1	0	1	134.829529544
495	307	3	0	3	104.888482946
495	309	1	0	1	97.3655849675
495	331	2	0	2	85.5159648063
495	379	0	0	0	38.7953244157
495	394	2	0	2	36.451568353
495	396	5	1	4	21.154071675
495	397	7	0	7	20.6940747087
495	399	1	0	1	13.0151378364
495	401	1	0	1	33.0843554904
495	406	26	1	25	21.8254282324
495	408	64	0	64	27.0238960828
495	409	1	0	1	18.4258471082
495	411	3	0	3	31.5003409474
495	412	1	0	1	30.0568119977
495	415	7	3	4	26.9020439801
495	416	3	1	2	25.2011350007
495	417	2	1	1	31.2883902121
495	426	7	4	3	50.8451370355
495	431	2	0	2	40.5908914046
495	442	2	0	2	39.6294980226
495	453	1	0	1	24.9535036713
495	463	11	0	11	15.6007779563
495	464	28	0	28	29.9459255933
495	465	283	87	196	9.25395810578
495	466	1908	342	1566	10.9174010872
495	468	8	1	7	32.006770318
495	469	1058	0	1058	17.3066998892
495	470	15	3	12	25.9932326775
495	471	16	1	15	33.7088771971
495	472	38	3	35	28.1230275369
495	473	2	0	2	23.0895985863
495	474	35	8	27	18.8908235555
495	475	160	0	160	24.2190517002
495	476	18	5	13	38.3365798566
495	477	22	1	21	17.278852032
495	478	78	32	46	7.35516559391
495	479	2	0	2	36.3983655515
495	480	46	1	45	23.7159844526
495	481	5	1	4	35.08240523
495	482	10	0	10	30.7884791212
495	483	2	0	2	35.0251711024
495	484	17	4	13	42.5186798573
495	485	19	1	18	27.1440820422
495	486	2	0	2	40.0156679654
495	487	7	0	7	37.7922411401
495	488	24	3	21	28.9498831548
495	489	3	0	3	43.1953667632
495	490	2	0	2	32.3897398648
495	491	82	0	82	21.1783296956
495	492	6	0	6	23.64653166
495	493	42	18	24	22.112135691
495	494	50	5	45	17.0746835979
495	496	29	11	18	15.4765255347
495	497	3	0	3	20.4141999919
495	499	206	46	160	5.24467594883
495	500	22	8	14	9.21486365636
495	501	391	380	11	8.34353249959
495	502	127	4	123	8.49234260888
495	503	582	78	504	12.1815107811
495	504	12	0	12	15.1228970092
495	505	102	14	88	14.7624434624
495	506	11	2	9	24.7359357251
495	507	1	0	1	134.412980434
495	540	1	0	1	103.294006291
495	573	1	0	1	65.3364267231
495	581	0	0	0	67.9835192256
496	1	17	0	17	83.9868313715
496	15	1	0	1	74.072126119
496	21	1	0	1	77.4796641578
496	22	1	0	1	89.0590896003
496	34	1	0	1	51.7484386601
496	36	2	0	2	67.2304333969
496	41	1	1	0	63.2558750616
496	46	1	0	1	67.2437908772
496	47	3	0	3	50.9326018416
496	49	2	0	2	59.2822846359
496	50	3	1	2	53.7255950879
496	53	1	0	1	81.3808770448
496	54	1	0	1	46.8613847334
496	57	1	0	1	40.190624295
496	59	3	1	2	49.4891719953
496	62	1	0	1	71.3394345439
496	65	1	0	1	64.6789708143
496	68	1	0	1	46.4721428086
496	70	3	0	3	73.6854179197
496	71	2	1	1	63.4444706443
496	73	73	0	73	68.2346533512
496	74	10	1	9	66.5684858962
496	75	10	0	10	65.8368747133
496	76	0	0	0	71.4586153871
496	78	7	1	6	67.7563275115
496	79	2	0	2	72.1064643971
496	81	2	0	2	72.048881469
496	82	4	1	3	70.0546770774
496	83	1	0	1	68.4623950825
496	84	8	0	8	67.3685141447
496	86	1	0	1	64.503621133
496	87	4	1	3	64.0597641096
496	88	3	0	3	63.1559499429
496	92	1	0	1	77.9596608217
496	95	1	0	1	69.4485652258
496	96	1	0	1	78.1393476929
496	102	2	0	2	78.085474608
496	103	5	0	5	63.9040727838
496	107	1	0	1	56.9387415851
496	112	4	0	4	65.1795681045
496	113	17	1	16	60.4643005192
496	124	2	0	2	39.1955645472
496	127	2	0	2	51.6495116961
496	128	2	0	2	40.4014098838
496	131	11	0	11	29.0174289986
496	132	2	0	2	17.6057670975
496	134	1	0	1	50.14999364
496	135	1	0	1	32.789926542
496	136	1	0	1	40.307864062
496	137	0	0	0	51.271826827
496	139	2	0	2	24.3839736858
496	141	10	3	7	20.4081333474
496	142	49	3	46	45.4210101624
496	145	1	0	1	46.0500408283
496	147	32	1	31	28.0570918813
496	149	5	0	5	17.1778170574
496	150	1	0	1	21.0792073484
496	151	2	0	2	33.8272375779
496	152	1	0	1	33.8646909861
496	154	11	0	11	40.63986784
496	170	1	0	1	63.376307437
496	177	2	0	2	56.6789974619
496	184	1	0	1	149.371714401
496	185	1	0	1	162.801152303
496	190	1	0	1	153.481352319
496	208	1	0	1	145.952763206
496	220	0	0	0	174.867792851
496	230	1	0	1	163.786111805
496	273	1	0	1	118.992488659
496	277	2	0	2	117.118549082
496	286	1	0	1	109.370952179
496	314	1	0	1	112.746536418
496	358	1	0	1	111.393979337
496	375	0	0	0	137.741494744
496	394	1	0	1	27.7042624855
496	396	1	0	1	17.8700876643
496	398	1	0	1	46.2478252396
496	399	1	0	1	19.4237585151
496	406	5	1	4	23.193865246
496	407	1	0	1	17.5336285145
496	408	26	0	26	26.0550625236
496	411	2	0	2	26.9626803269
496	414	4	0	4	25.4508835403
496	415	7	2	5	19.8251492027
496	451	1	0	1	11.1848842325
496	453	1	0	1	16.2622711575
496	455	1	0	1	24.3567995473
496	457	2	0	2	9.09805621696
496	460	5	0	5	13.3914756147
496	463	1	0	1	28.4068560388
496	464	6	0	6	29.9129857594
496	465	35	8	27	13.0285338258
496	466	221	6	215	21.0574179771
496	467	12	1	11	14.1927098812
496	468	4	1	3	23.6784552119
496	469	368	9	359	14.7123864719
496	470	12	4	8	18.6699649634
496	471	5	0	5	35.3344734057
496	472	12	3	9	23.9064017265
496	473	3	1	2	12.6684010982
496	474	5	2	3	30.7815532551
496	475	480	67	413	9.71285243662
496	476	2	1	1	33.6953315036
496	477	11	1	10	20.965851197
496	478	5	2	3	21.767158207
496	479	1	0	1	35.2051218214
496	480	10	0	10	24.1910608643
496	482	1	0	1	42.698125738
496	483	1	0	1	48.6009158165
496	485	1	0	1	40.9715412564
496	486	1	0	1	47.8967300046
496	487	1	0	1	44.1463351686
496	488	4	0	4	36.982029687
496	489	1	0	1	51.9717182169
496	491	18	5	13	27.192579233
496	493	1	0	1	36.6040536445
496	494	57	22	35	8.91834804513
496	495	35	2	33	15.4765255347
496	497	31	7	24	6.0391470777
496	499	18	3	15	10.2765218524
496	500	32	24	8	7.05173441887
496	501	6	1	5	23.7734934312
496	502	9	2	7	17.6689208806
496	503	345	50	295	9.42550597549
496	504	173	8	165	4.38733715178
496	505	15	1	14	29.8689942565
496	506	3	0	3	34.530671415
496	566	1	0	1	40.611411659
496	573	0	0	0	50.5783231456
496	578	1	0	1	37.4064746589
497	1	9	4	5	85.9648199761
497	13	1	0	1	73.3996625179
497	28	1	0	1	86.7853405417
497	36	1	0	1	67.7399888146
497	49	1	0	1	62.0896528349
497	59	0	0	0	54.5377894687
497	65	2	0	2	69.0599044753
497	70	4	0	4	72.119947114
497	71	2	0	2	61.7513561055
497	72	2	0	2	72.5975546397
497	73	70	0	70	67.1299889209
497	74	7	1	6	65.0866381219
497	75	11	0	11	64.7250382546
497	76	2	0	2	69.7698383339
497	78	2	0	2	66.1620620225
497	79	2	0	2	71.0347375065
497	81	1	0	1	70.7325876533
497	82	1	1	0	68.5150417315
497	83	3	1	2	67.1678990251
497	84	6	0	6	66.16475736
497	86	1	0	1	62.6321946061
497	87	3	0	3	62.751867291
497	88	1	0	1	61.6818463955
497	89	1	0	1	78.8943426834
497	92	0	0	0	76.5768629591
497	96	0	0	0	75.7077705319
497	102	2	0	2	78.072101255
497	103	4	0	4	63.1734401034
497	110	1	0	1	60.04371656
497	112	6	0	6	64.7123350584
497	113	8	3	5	59.4567022774
497	120	1	0	1	72.5232215406
497	122	0	0	0	81.0069160267
497	131	2	0	2	32.398891445
497	136	1	0	1	40.8171837545
497	140	1	0	1	54.3538459701
497	141	14	6	8	17.6003220708
497	142	41	2	39	44.913531583
497	143	2	0	2	36.8335330778
497	144	1	0	1	44.5565147609
497	146	1	0	1	55.879213878
497	147	39	0	39	26.8101752572
497	149	6	0	6	17.3591105198
497	151	0	0	0	36.3210723624
497	152	0	0	0	34.7395847949
497	154	8	2	6	38.5716770643
497	177	0	0	0	53.4628598557
497	208	0	0	0	144.079062372
497	245	1	0	1	89.8389122449
497	277	1	0	1	116.816654601
497	278	1	0	1	137.015242381
497	284	1	0	1	121.614835563
497	285	1	0	1	127.859873435
497	293	1	0	1	119.364758495
497	296	1	0	1	109.393892076
497	379	1	0	1	22.3255010296
497	380	1	0	1	24.2065586
497	385	2	0	2	27.9505315916
497	394	2	0	2	22.480134286
497	396	7	2	5	15.79227827
497	397	3	3	0	12.155497718
497	399	2	0	2	21.0254699367
497	406	7	1	6	22.2607118792
497	408	35	1	34	23.8580880625
497	409	1	0	1	23.4808175605
497	410	1	0	1	20.2755889945
497	411	8	0	8	23.2738313568
497	413	2	0	2	36.1368695044
497	415	14	0	14	15.7126802202
497	417	1	0	1	19.672478941
497	425	2	0	2	42.5884489764
497	426	1	0	1	59.5296504509
497	442	1	0	1	43.3950431449
497	451	7	7	0	7.65911229565
497	453	2	0	2	11.8507790538
497	454	2	0	2	13.0971447389
497	457	14	3	11	4.2195256468
497	458	2	0	2	7.85259236634
497	459	0	0	0	17.803493067
497	460	18	7	11	7.36856534904
497	462	1	0	1	13.0421300117
497	464	4	0	4	35.0836439076
497	465	20	3	17	19.0548126337
497	466	128	42	86	27.0097495961
497	467	19	6	13	10.1776226134
497	468	1	0	1	26.6541697216
497	469	176	0	176	20.2167975005
497	470	3	0	3	22.4945061481
497	471	3	0	3	40.6729033034
497	472	4	0	4	28.3523769323
497	473	6	1	5	15.8923356095
497	475	423	359	64	9.91931578114
497	476	2	0	2	37.5595609057
497	477	4	0	4	26.8855769558
497	478	3	0	3	27.1974303866
497	480	4	0	4	29.6452996666
497	482	2	0	2	48.6769129884
497	487	1	0	1	50.0030637933
497	488	2	0	2	42.9864111146
497	491	3	0	3	33.1598337869
497	493	1	0	1	42.1391850868
497	494	30	1	29	13.9509345318
497	495	10	0	10	20.4141999919
497	496	94	46	48	6.0391470777
497	499	10	1	9	15.1978397973
497	500	11	0	11	12.8818059788
497	501	6	0	6	28.4420807846
497	502	3	0	3	20.5442271021
497	503	152	1	151	10.9188623135
497	504	48	2	46	9.92787100896
497	505	2	0	2	35.1176941781
497	566	2	0	2	34.6743408425
497	568	1	0	1	34.8223123807
497	573	0	0	0	44.9990768675
498	78	0	0	0	74.4961738941
498	142	0	0	0	53.4702280221
498	396	1	0	1	7.44786371305
498	397	1	0	1	4.24386083802
498	408	2	0	2	15.6565421593
498	438	1	0	1	42.0761260465
498	453	1	0	1	7.10334489782
498	464	1	0	1	40.0280336171
498	466	1	0	1	27.2788127057
498	469	0	0	0	24.7075757899
498	503	8	0	8	5.79001499173
498	506	1	0	1	28.0612448134
499	1	10	0	10	89.1351830786
499	5	2	0	2	85.3333521438
499	7	5	0	5	80.5744205918
499	22	1	0	1	93.5316359518
499	35	1	0	1	69.8742588281
499	36	9	1	8	74.4966692452
499	39	1	0	1	85.3600370313
499	45	1	0	1	40.3273163803
499	48	3	0	3	49.4281221429
499	49	1	0	1	63.3950534251
499	50	2	0	2	57.3884622918
499	59	6	1	5	48.6610464427
499	60	1	0	1	54.2265201344
499	65	1	0	1	65.4133216587
499	69	2	1	1	41.9081552919
499	70	1	0	1	82.8665979841
499	73	23	0	23	77.0828221952
499	74	4	0	4	75.7203918656
499	75	3	0	3	74.705133015
499	78	4	1	3	76.9845262385
499	81	1	0	1	81.047235744
499	82	1	0	1	79.2324877986
499	83	1	0	1	77.4616826999
499	84	6	1	5	76.3019550698
499	86	3	0	3	73.9370486478
499	87	4	4	0	73.094030677
499	88	2	0	2	72.3203734734
499	89	1	0	1	88.4935657332
499	90	1	0	1	82.960454552
499	92	1	0	1	86.9842283493
499	96	1	0	1	87.8688895571
499	103	3	0	3	72.4611524834
499	107	1	0	1	66.5491787606
499	111	0	0	0	92.1697763761
499	112	2	0	2	73.4859054834
499	113	6	1	5	69.2833683013
499	124	2	0	2	45.531160966
499	125	2	0	2	51.4762916972
499	126	1	0	1	36.0892692467
499	128	1	0	1	49.5563411868
499	129	1	0	1	65.6676848305
499	130	2	0	2	44.2388794373
499	131	5	0	5	33.1986800307
499	137	1	0	1	60.7816764592
499	138	0	0	0	60.059480307
499	140	1	0	1	63.6228722908
499	141	2	0	2	30.5758790837
499	142	40	0	40	53.9734534476
499	146	1	0	1	66.6491997163
499	147	8	0	8	37.460941059
499	149	2	1	1	26.1012206493
499	153	1	0	1	36.8024005846
499	154	3	0	3	50.33395146
499	163	1	0	1	44.9597283342
499	164	1	0	1	71.8722705084
499	172	1	0	1	63.4834029768
499	177	1	1	0	66.7971995392
499	236	1	0	1	148.917601032
499	277	2	0	2	125.011976467
499	293	1	0	1	130.016232662
499	345	1	0	1	156.65239587
499	388	1	0	1	36.8223403761
499	392	1	0	1	38.0770767667
499	396	3	0	3	18.2106403445
499	397	2	0	2	16.9799915908
499	399	3	0	3	13.1073288196
499	401	2	1	1	31.4399416071
499	406	6	1	5	20.5054571429
499	408	25	9	16	25.1309229248
499	409	1	0	1	18.1999210378
499	410	1	0	1	23.9798244193
499	411	2	0	2	28.6301328398
499	415	2	0	2	23.1790663467
499	416	2	0	2	25.2328467039
499	417	1	0	1	27.6837982284
499	451	2	0	2	15.8804804465
499	460	3	1	2	22.1857686154
499	463	3	1	2	19.8230699645
499	464	6	0	6	29.5814674767
499	465	84	30	54	8.3320285029
499	466	486	3	483	13.6747742918
499	467	1	0	1	24.4382100573
499	468	5	0	5	28.9834770804
499	469	416	120	296	15.287311613
499	470	11	0	11	23.0816963113
499	471	5	3	2	34.0313958046
499	472	16	1	15	26.2748388526
499	473	2	0	2	19.1733569171
499	474	12	7	5	22.7924358975
499	475	64	0	64	19.3222829736
499	476	4	0	4	36.6220783895
499	477	13	10	3	17.6569671755
499	478	12	4	8	12.1377615598
499	480	12	1	11	23.283629904
499	482	2	0	2	34.8592248728
499	483	1	0	1	39.7249036626
499	484	5	1	4	43.9693529537
499	485	4	0	4	31.899100716
499	488	6	1	5	31.5249449184
499	489	3	0	3	46.2288994183
499	490	1	0	1	33.801755178
499	491	23	5	18	22.7341351313
499	492	2	0	2	27.1993444068
499	493	24	0	24	27.0837928146
499	494	28	9	19	13.2956990412
499	495	342	241	101	5.24467594883
499	496	31	6	25	10.2765218524
499	497	5	1	4	15.1978397973
499	500	28	22	6	4.75514334115
499	501	43	12	31	13.4975913025
499	502	37	29	8	9.5058303066
499	503	381	18	363	8.17699094413
499	504	17	4	13	10.4728049164
499	505	15	5	10	19.9243538705
499	506	6	0	6	27.0115801042
500	1	16	0	16	84.6963911656
500	5	1	0	1	81.1213389292
500	7	1	0	1	75.993649063
500	19	1	0	1	80.2362986505
500	27	1	0	1	68.3503416039
500	29	2	0	2	68.8404202424
500	33	1	0	1	68.0349420264
500	35	1	0	1	65.3019804471
500	36	2	0	2	69.765460465
500	39	2	0	2	80.636601774
500	46	2	0	2	65.4964989069
500	48	3	0	3	45.6551641916
500	59	1	0	1	45.88921244
500	69	1	0	1	37.7847865659
500	70	4	0	4	78.2129940224
500	71	1	0	1	68.1463913517
500	73	34	2	32	72.3770131001
500	74	3	0	3	71.0642415604
500	75	5	0	5	70.0028552134
500	76	2	0	2	76.1072356683
500	78	3	0	3	72.3437931688
500	79	1	0	1	76.1928950315
500	80	0	0	0	75.9615334962
500	81	2	0	2	76.3612767093
500	82	3	0	3	74.5798432051
500	83	2	0	2	72.7773347873
500	84	3	0	3	71.6080554032
500	87	2	0	2	68.4175027339
500	95	1	0	1	72.9266101257
500	96	1	0	1	83.3844284015
500	102	1	0	1	81.0914780739
500	103	3	1	2	67.7274932463
500	112	1	0	1	68.7374053369
500	113	7	0	7	64.5771421226
500	116	1	0	1	77.3536112605
500	124	0	0	0	40.8578628866
500	126	1	0	1	31.3586695186
500	128	1	0	1	44.9235275017
500	131	6	0	6	28.8103601902
500	132	1	0	1	19.7546724037
500	134	1	0	1	53.6708801964
500	136	2	0	2	43.2304990684
500	141	2	0	2	26.5532296327
500	142	49	1	48	49.247397131
500	143	1	0	1	40.6519986167
500	144	1	0	1	50.6404029988
500	146	1	0	1	62.0175336573
500	147	5	0	5	32.9210302755
500	149	1	0	1	21.4952004653
500	154	5	1	4	45.8709691155
500	171	1	0	1	72.2717639287
500	177	1	0	1	62.6098013769
500	183	1	0	1	159.03092845
500	188	1	0	1	161.917472286
500	209	1	0	1	149.856099766
500	217	0	0	0	175.522685932
500	219	2	0	2	182.611908753
500	220	0	0	0	177.910835536
500	245	0	0	0	94.3524883461
500	247	0	0	0	105.854381114
500	266	1	0	1	134.441526201
500	277	1	0	1	120.259042062
500	292	1	0	1	131.822070734
500	305	1	0	1	105.207795703
500	338	1	0	1	110.502088386
500	372	1	0	1	145.340404264
500	391	1	0	1	31.0885276659
500	392	1	0	1	36.7307954164
500	396	6	0	6	20.2079771201
500	397	2	1	1	18.1540345919
500	401	1	0	1	34.1968328786
500	406	10	3	7	23.7411726176
500	407	1	0	1	18.2131659933
500	408	13	3	10	27.8208303656
500	411	3	0	3	30.3535922972
500	414	2	0	2	23.4976148146
500	415	5	0	5	24.0596285349
500	416	1	0	1	29.1308866381
500	438	1	0	1	53.4131419168
500	453	1	0	1	21.0519331807
500	460	1	0	1	20.2293953237
500	464	16	0	16	26.4541168914
500	465	129	11	118	6.54825325626
500	466	331	0	331	14.1515860061
500	467	1	0	1	21.0166283305
500	468	3	0	3	24.3774610434
500	469	655	0	655	11.4425072391
500	470	8	0	8	18.5507661759
500	471	14	2	12	31.3417265878
500	472	13	3	10	22.2295403223
500	473	3	1	2	14.4190037195
500	474	13	3	10	23.8373590736
500	475	121	3	118	15.025380085
500	476	2	0	2	32.5444548394
500	477	20	5	15	15.580862744
500	478	5	0	5	14.8340303
500	479	2	0	2	32.4127169144
500	480	15	0	15	20.2657412667
500	482	3	1	2	35.8277524149
500	483	2	0	2	41.5634099522
500	484	3	0	3	42.0716790538
500	485	4	0	4	33.9205111253
500	487	5	1	4	38.6324586187
500	488	4	0	4	30.8790063651
500	489	1	0	1	45.832255181
500	491	30	0	30	21.4058624558
500	493	2	0	2	29.5833006624
500	494	65	51	14	8.57459099232
500	495	51	9	42	9.21486365636
500	496	53	35	18	7.05173441887
500	497	4	0	4	12.8818059788
500	499	36	7	29	4.75514334115
500	501	23	6	17	17.5146883335
500	502	9	2	7	14.1230111531
500	503	245	202	43	9.92904170323
500	504	72	25	47	5.91048070498
500	505	7	1	6	23.0123089575
500	539	1	0	1	90.8410165088
500	573	1	0	1	57.6297323225
501	1	30	0	30	96.9899820063
501	3	1	0	1	91.5885451565
501	5	1	0	1	91.9926478579
501	6	1	0	1	85.9673408397
501	7	1	0	1	89.4329374231
501	13	2	0	2	87.5817687873
501	24	1	0	1	85.7875911707
501	34	1	0	1	66.4201660442
501	36	7	0	7	84.873008907
501	37	2	0	2	74.0919793713
501	43	1	0	1	62.1833688148
501	48	4	0	4	54.8752755474
501	50	7	0	7	64.253244211
501	53	1	0	1	85.9842815965
501	55	1	0	1	62.2235190626
501	59	2	0	2	50.6249334102
501	62	1	0	1	71.7517884476
501	65	1	0	1	68.5549932519
501	68	1	0	1	58.1178486706
501	70	0	0	0	95.1923911973
501	71	0	0	0	85.2703224034
501	72	1	0	1	94.8473906969
501	73	29	3	26	89.0885304315
501	74	6	0	6	88.0451752127
501	75	6	1	5	86.7447304919
501	78	3	0	3	89.3821408355
501	79	0	0	0	92.8406687661
501	80	0	0	0	92.7390265371
501	81	1	0	1	93.1892418971
501	82	2	0	2	91.5689495468
501	83	2	0	2	89.6214473074
501	84	2	0	2	88.3997332967
501	85	0	0	0	90.9259560916
501	86	2	0	2	86.5558823281
501	87	6	0	6	85.3116563203
501	90	1	0	1	95.7671756432
501	92	1	0	1	99.1289478608
501	95	1	0	1	89.0374408779
501	98	1	0	1	85.2480478386
501	103	6	0	6	84.1971185051
501	110	2	0	2	80.3550291493
501	111	1	0	1	104.205796097
501	112	5	0	5	84.9570297492
501	113	18	1	17	81.3065001294
501	122	0	0	0	104.403134671
501	124	3	0	3	55.5509485817
501	128	2	0	2	62.0507794236
501	130	1	0	1	56.7198871434
501	131	7	0	7	41.8765484987
501	134	6	0	6	69.9979240912
501	136	1	0	1	59.1793048699
501	137	0	0	0	73.5284874496
501	140	2	0	2	75.4610145394
501	141	0	0	0	43.9902512573
501	142	29	0	29	65.8757810996
501	144	0	0	0	67.8027470009
501	147	3	0	3	50.2814029551
501	153	0	0	0	48.898704633
501	154	2	0	2	63.2984420746
501	172	1	0	1	76.6533782929
501	183	0	0	0	173.862820145
501	188	1	0	1	177.447183278
501	190	1	0	1	169.855926734
501	208	1	0	1	167.481505077
501	222	0	0	0	185.801426033
501	245	1	0	1	110.587787099
501	246	1	0	1	111.297490139
501	247	1	1	0	122.959994952
501	253	3	0	3	129.081457218
501	261	1	0	1	112.509978915
501	262	0	0	0	124.773154294
501	277	4	0	4	135.751297907
501	281	0	0	0	129.948555007
501	282	0	0	0	133.685276974
501	293	1	0	1	142.095555701
501	303	3	1	2	106.006366838
501	308	1	0	1	118.1922466
501	319	1	0	1	100.53358572
501	320	3	0	3	96.869148043
501	323	0	0	0	90.4100358617
501	331	2	0	2	93.8328266917
501	394	1	1	0	42.074650941
501	396	2	0	2	25.9892748232
501	397	2	0	2	26.5530532162
501	399	6	1	5	15.0868292006
501	404	1	0	1	40.5927006369
501	406	10	2	8	24.3952288452
501	408	27	0	27	30.0023606829
501	411	2	0	2	35.6778284696
501	414	7	1	6	18.0685520809
501	415	3	0	3	32.4858788381
501	416	4	0	4	25.4234338131
501	426	2	0	2	46.7121034383
501	427	2	0	2	29.8621979747
501	438	1	0	1	50.0622636886
501	463	8	1	7	12.8465995841
501	464	11	0	11	34.0369587936
501	465	48	12	36	15.9773004943
501	466	861	317	544	12.9068612646
501	468	2	0	2	38.9758545738
501	469	332	97	235	23.9101494111
501	470	2	0	2	32.9902788763
501	471	11	2	9	36.7003672674
501	472	9	4	5	34.0283537596
501	474	35	1	34	16.4852311521
501	475	16	0	16	32.5386085233
501	476	13	0	13	43.8088252035
501	477	11	1	10	21.3980005057
501	478	102	18	84	6.10019904352
501	479	1	0	1	40.5483164068
501	480	13	5	8	28.2373019262
501	482	24	0	24	26.9782094873
501	483	6	1	5	29.3367573161
501	484	9	0	9	43.4598795727
501	485	43	6	37	21.5295770933
501	486	1	0	1	38.8562482119
501	487	5	0	5	37.7840547177
501	488	30	0	30	28.5032079298
501	489	3	0	3	41.2482667819
501	490	5	0	5	33.7847665691
501	491	37	0	37	23.167298424
501	492	6	0	6	21.5633626962
501	493	119	3	116	15.9206741065
501	494	14	0	14	24.936965755
501	495	181	110	71	8.34353249959
501	496	3	2	1	23.7734934312
501	499	15	0	15	13.4975913025
501	500	5	0	5	17.5146883335
501	502	58	0	58	11.0867571677
501	503	127	82	45	19.0176185468
501	504	5	1	4	23.4012711494
501	505	346	42	304	8.07008143221
501	506	0	0	0	21.2348939743
501	573	0	0	0	73.0963826721
501	585	0	0	0	101.381653148
502	1	16	1	15	98.6246525369
502	7	2	0	2	90.0759543424
502	13	1	0	1	87.8384818763
502	15	1	0	1	89.2127252465
502	21	1	0	1	91.3944630097
502	23	1	0	1	88.8093958705
502	28	1	0	1	100.282275045
502	32	1	0	1	99.9000539526
502	36	3	0	3	83.8371600561
502	41	1	0	1	79.3423450388
502	45	2	0	2	48.6283254392
502	48	4	0	4	58.504592082
502	50	3	0	3	66.7511632342
502	52	1	0	1	56.5400764849
502	57	1	0	1	50.792909246
502	59	1	0	1	56.7014642071
502	65	2	0	2	73.9481638915
502	68	4	0	4	59.9812731329
502	69	1	0	1	51.263946701
502	70	3	0	3	91.3371550416
502	71	1	0	1	81.110358846
502	72	1	0	1	91.4383064044
502	73	31	1	30	85.7966550214
502	74	4	0	4	84.2131201874
502	75	7	0	7	83.4044231766
502	76	2	0	2	89.1224170825
502	78	3	0	3	85.4136320945
502	79	1	0	1	89.6530745205
502	80	1	0	1	89.3102890134
502	81	1	0	1	89.6599731871
502	82	1	0	1	87.7049499387
502	83	1	0	1	86.0721603718
502	84	6	0	6	84.9583552749
502	85	1	0	1	86.5458874286
502	86	4	0	4	82.172005613
502	87	5	0	5	81.6768244299
502	88	1	0	1	80.8017418063
502	92	1	0	1	95.5799053461
502	96	1	0	1	95.7377829313
502	103	3	0	3	81.3420680949
502	110	1	0	1	77.8108249807
502	112	3	0	3	82.4898687424
502	113	10	0	10	78.010493275
502	124	2	0	2	54.9808691566
502	128	1	0	1	58.0317778405
502	131	8	2	6	42.6856823672
502	133	1	1	0	69.031116152
502	134	2	0	2	67.4203424195
502	135	1	0	1	50.4235450098
502	136	1	0	1	57.1791515821
502	138	0	0	0	69.4381016341
502	139	1	0	1	41.1411772589
502	140	2	0	2	72.4782306981
502	141	3	1	2	37.7356522139
502	142	36	1	35	62.8345451998
502	143	2	1	1	54.3039843501
502	145	1	0	1	62.7390832039
502	146	1	0	1	75.0658183796
502	147	7	1	6	45.7188107113
502	149	1	0	1	34.6638799296
502	154	1	0	1	58.2793133546
502	156	1	0	1	93.1238917171
502	163	1	0	1	52.1959103928
502	166	1	0	1	91.7419409454
502	172	2	0	2	70.9892618679
502	175	1	0	1	80.7379088024
502	177	2	0	2	73.9067778541
502	183	0	0	0	173.095485974
502	190	1	0	1	169.830346379
502	208	0	0	0	163.619684449
502	220	0	0	0	191.901548
502	240	1	0	1	205.349899425
502	255	1	0	1	115.971378004
502	260	1	0	1	105.42306355
502	277	6	0	6	134.207889269
502	281	1	0	1	127.756763525
502	282	1	0	1	131.253262591
502	302	1	0	1	131.460952317
502	303	1	0	1	107.144467303
502	307	1	0	1	111.310627529
502	309	2	0	2	103.725811603
502	331	1	0	1	86.3528688796
502	338	1	0	1	120.868548065
502	367	1	0	1	103.150295796
502	389	1	0	1	41.0895210417
502	392	1	0	1	39.7230828083
502	396	18	4	14	14.9242598177
502	397	4	0	4	15.8013730413
502	399	24	11	13	4.60162227538
502	401	2	0	2	25.0677882264
502	403	1	1	0	15.0363067238
502	406	37	11	26	13.8225165699
502	408	119	44	75	19.2979815644
502	409	7	0	7	9.98629554191
502	410	1	0	1	19.8080430289
502	411	5	2	3	24.6421384856
502	412	2	0	2	21.5679052789
502	414	23	7	16	9.9478035035
502	415	9	0	9	21.5291616694
502	416	6	2	4	16.7090261552
502	417	2	0	2	25.5004145174
502	421	1	0	1	21.641138476
502	426	3	0	3	43.3904123844
502	432	1	0	1	32.8146182431
502	441	1	0	1	36.4961256083
502	442	1	0	1	31.2274844246
502	447	1	0	1	26.6266661432
502	451	1	0	1	17.3324842176
502	453	1	0	1	20.6654363032
502	457	2	1	1	19.5185159812
502	460	1	1	0	26.0422216329
502	462	1	0	1	30.3994909155
502	463	2	0	2	22.6183315823
502	464	5	0	5	38.2126990578
502	465	37	1	36	17.028248646
502	466	458	194	264	19.2541258514
502	467	1	0	1	30.6821775748
502	468	1	0	1	38.4739224538
502	469	326	150	176	24.63098277
502	470	2	0	2	32.5861708691
502	471	4	0	4	42.1522389682
502	472	7	1	6	35.6292217936
502	473	1	0	1	28.4313255084
502	474	4	1	3	26.1753435771
502	475	74	2	72	27.3659124222
502	476	6	0	6	45.9609067811
502	477	7	0	7	25.6757680975
502	478	21	18	3	14.2256326509
502	480	11	0	11	31.9321491612
502	481	1	0	1	42.4931804017
502	482	4	0	4	37.5356207954
502	483	2	0	2	40.4099385883
502	484	9	2	7	50.9624031781
502	485	10	2	8	32.57525065
502	486	2	0	2	48.0140660327
502	487	4	0	4	46.0774117136
502	488	5	1	4	37.0825522337
502	489	1	0	1	50.9322479899
502	490	1	0	1	40.8541289335
502	491	12	2	10	29.6510044772
502	492	1	0	1	31.1656299999
502	493	19	0	19	27.0035564814
502	494	5	2	3	22.6914542751
502	495	221	143	78	8.49234260888
502	496	31	0	31	17.6689208806
502	497	4	0	4	20.5442271021
502	499	63	2	61	9.5058303066
502	500	21	10	11	14.1230111531
502	501	198	87	111	11.0867571677
502	503	657	87	570	9.73920650722
502	504	7	0	7	19.3391652006
502	505	56	30	26	19.1525542697
502	506	32	2	30	17.5336162409
503	0	1	0	1	85.7339598613
503	1	40	2	38	93.1560479077
503	5	3	0	3	90.1195863905
503	11	2	0	2	98.5063603853
503	13	3	0	3	81.4724689188
503	15	1	0	1	83.3380862927
503	18	1	0	1	81.43037501
503	23	1	0	1	83.608374237
503	27	2	0	2	77.5196876601
503	29	4	0	4	78.2468820849
503	34	4	1	3	60.9887645528
503	35	4	0	4	73.3461569431
503	36	10	0	10	76.6551607442
503	42	1	0	1	83.009948024
503	48	9	0	9	55.2829306242
503	49	1	0	1	68.1087326687
503	50	5	0	5	62.3740168308
503	51	1	0	1	64.071391287
503	55	1	0	1	63.9244051266
503	58	1	0	1	78.4727521971
503	59	5	1	4	55.8140019026
503	62	1	0	1	77.8145742943
503	65	1	0	1	71.9972089011
503	68	2	0	2	55.2420662579
503	69	3	0	3	47.0709291672
503	70	6	0	6	82.5866548404
503	71	4	0	4	72.2708136479
503	73	128	6	122	77.3342747305
503	74	19	0	19	75.5040627505
503	75	29	5	24	74.9314499331
503	76	3	0	3	80.294854593
503	78	7	0	7	76.6379924625
503	79	0	0	0	81.2219898748
503	80	0	0	0	80.7642746977
503	81	1	0	1	81.0649326042
503	82	5	0	5	78.9656023302
503	83	6	0	6	77.4847249253
503	84	8	2	6	76.4279293779
503	85	3	0	3	77.5908575974
503	86	9	1	8	73.2329495391
503	87	5	0	5	73.0719212523
503	88	3	0	3	72.0916491373
503	89	2	0	2	89.0069618716
503	90	2	0	2	81.8167323276
503	92	2	0	2	86.9507878201
503	94	1	0	1	96.2578664981
503	95	2	0	2	78.7590028846
503	98	2	0	2	71.3024942185
503	99	2	0	2	66.1894365804
503	102	2	0	2	87.4735165256
503	103	24	9	15	73.1279857147
503	107	1	1	0	65.5214558014
503	110	7	0	7	69.78962181
503	112	5	0	5	74.4759433542
503	113	44	2	42	69.5924133501
503	124	5	1	4	48.5308968735
503	126	1	0	1	38.6468366133
503	131	11	0	11	37.7062928708
503	132	1	0	1	26.929559872
503	133	2	0	2	61.6133836699
503	134	3	0	3	59.4773686804
503	139	1	0	1	33.8083684978
503	140	1	0	1	64.2634798901
503	141	11	0	11	28.3914309298
503	142	81	8	73	54.6842140875
503	143	1	0	1	46.3173243613
503	144	1	0	1	54.9199535446
503	146	2	0	2	66.3113740389
503	147	17	1	16	37.0067240001
503	149	7	0	7	26.4821621485
503	154	17	1	16	49.2151982074
503	155	2	1	1	78.891871507
503	163	1	0	1	42.779228706
503	164	1	0	1	70.4400144855
503	166	1	0	1	82.1186533669
503	168	1	0	1	66.3058820306
503	169	1	0	1	90.1341000925
503	171	1	0	1	74.9828125651
503	172	4	0	4	61.6253212356
503	177	1	0	1	64.380393938
503	183	0	0	0	165.712826147
503	188	3	0	3	167.967000879
503	191	0	0	0	185.593952523
503	208	0	0	0	154.71634002
503	209	1	0	1	154.402863239
503	211	1	0	1	162.453179419
503	220	0	0	0	184.226168413
503	225	1	0	1	159.490319564
503	236	1	0	1	149.672819648
503	244	0	0	0	198.697736048
503	247	1	0	1	109.742462441
503	253	2	0	2	117.044799978
503	257	1	0	1	100.480926622
503	264	1	0	1	105.416646485
503	270	1	0	1	125.294953474
503	272	1	0	1	138.833705928
503	277	3	0	3	126.471218304
503	303	2	0	2	101.247799246
503	306	1	0	1	107.05414234
503	307	1	0	1	104.540850903
503	319	4	0	4	82.5053152286
503	321	1	0	1	85.9704138653
503	338	1	0	1	111.157682856
503	345	1	0	1	155.785807909
503	357	1	0	1	99.4554852596
503	375	1	0	1	145.911154176
503	379	1	0	1	26.6140090445
503	382	0	0	0	42.0260737273
503	383	1	0	1	37.7406359601
503	387	1	0	1	35.1207953428
503	394	2	1	1	24.416912736
503	396	41	24	17	10.3263987878
503	397	16	2	14	8.80302513836
503	399	18	5	13	10.2726114977
503	400	3	1	2	21.1467143252
503	401	4	1	3	24.2957286049
503	404	2	0	2	27.0663297423
503	405	1	0	1	23.2998946973
503	406	86	10	76	14.1871628976
503	407	15	7	8	8.51423182633
503	408	313	110	203	17.9200089911
503	409	3	0	3	13.6736069582
503	410	1	1	0	16.1242794096
503	411	23	0	23	20.6314223776
503	412	2	1	1	24.3552364331
503	413	1	0	1	31.4991626824
503	414	10	2	8	16.1178543874
503	415	58	2	56	15.0082235934
503	416	15	3	12	20.3359587189
503	417	6	0	6	19.5073523356
503	421	2	0	2	28.3675911827
503	426	10	1	9	49.9384050225
503	427	4	0	4	27.0869060356
503	431	0	0	0	37.7861549459
503	433	1	0	1	55.6165493633
503	435	0	0	0	32.2878342934
503	436	1	0	1	47.9759182482
503	438	1	0	1	43.8065001757
503	441	1	0	1	38.3247475853
503	442	7	2	5	35.1631097834
503	444	2	0	2	35.5357520426
503	450	1	0	1	28.1871822213
503	451	9	0	9	8.30357294236
503	453	12	1	11	12.7834660222
503	457	14	9	5	9.86388313439
503	458	2	1	1	12.9355656266
503	459	1	0	1	20.8077873464
503	460	26	0	26	16.3825168337
503	462	1	0	1	21.0415932614
503	463	2	1	1	27.6710710659
503	464	18	1	17	36.377730704
503	465	94	35	59	15.8848862595
503	466	658	142	516	21.8464622388
503	467	6	0	6	21.096280236
503	468	2	0	2	32.68365475
503	469	743	310	433	21.2488510328
503	470	10	1	9	27.2783371009
503	471	26	1	25	41.2505702679
503	472	22	0	22	31.7388702806
503	473	8	0	8	21.8205574736
503	474	12	0	12	30.799040853
503	475	381	9	372	18.8729653171
503	476	11	0	11	41.9248397623
503	477	21	0	21	25.2472052125
503	478	21	0	21	19.5366582161
503	479	1	0	1	42.2781020391
503	480	20	4	16	30.1942063824
503	481	1	0	1	46.7075418732
503	482	4	0	4	42.8195107112
503	483	4	1	3	47.1923072581
503	484	8	0	8	51.7426355523
503	485	11	0	11	39.302687681
503	486	1	0	1	50.8445445612
503	487	10	0	10	47.9211290925
503	488	12	0	12	39.6732581974
503	490	2	0	2	41.6151975652
503	491	17	1	16	30.6960495456
503	492	3	0	3	35.3178881765
503	493	19	3	16	34.1541487367
503	494	68	1	67	17.0206046364
503	495	233	9	224	12.1815107811
503	496	161	105	56	9.42550597549
503	497	19	0	19	10.9188623135
503	498	1	0	1	5.79001499173
503	499	132	50	82	8.17699094413
503	500	57	2	55	9.92904170323
503	501	114	16	98	19.0176185468
503	502	106	3	103	9.73920650722
503	504	41	6	35	12.659793231
503	505	49	0	49	26.5556998719
503	506	17	1	16	25.3876200368
503	520	1	0	1	45.7518756477
503	524	1	0	1	63.1372089233
503	552	1	0	1	83.7467519969
503	555	1	0	1	68.8100047924
503	573	6	1	5	54.2501266481
503	578	1	0	1	41.4513430734
504	0	2	0	2	73.3126945295
504	1	6	1	5	80.5149383135
504	13	2	1	1	69.0158407966
504	15	1	0	1	70.7508066955
504	24	1	0	1	69.3334326856
504	29	1	0	1	65.7968327448
504	34	1	0	1	48.3929275188
504	36	3	0	3	64.6010454928
504	48	3	0	3	43.1223208615
504	50	5	0	5	49.8024898356
504	53	1	0	1	77.1160470871
504	59	1	0	1	45.1024266918
504	60	1	0	1	47.0324528037
504	65	1	0	1	60.3528694933
504	68	4	0	4	42.6228545163
504	73	37	0	37	66.6422114991
504	74	2	0	2	65.2488921258
504	75	9	0	9	64.2605899479
504	76	0	0	0	70.2658885185
504	78	5	1	4	66.511722206
504	79	1	0	1	70.4748652639
504	81	1	0	1	70.5876290537
504	82	3	0	3	68.7603959008
504	83	1	0	1	67.0012297559
504	84	3	0	3	65.8488486008
504	85	1	0	1	67.8565129209
504	86	1	0	1	63.4773235898
504	87	0	0	0	62.6293596827
504	88	1	0	1	61.848255715
504	103	4	1	3	62.0772905281
504	110	4	0	4	58.4967906733
504	112	1	0	1	63.1717494518
504	113	2	0	2	58.8443379498
504	116	1	0	1	71.4880613728
504	124	2	0	2	36.0576118609
504	128	1	0	1	39.083624942
504	131	6	0	6	25.0987810394
504	132	3	1	2	14.5481067753
504	133	1	0	1	49.7217765224
504	137	0	0	0	50.3401872442
504	140	1	0	1	53.2252753979
504	141	5	1	4	20.8341062796
504	142	20	1	19	43.57475884
504	144	1	0	1	44.7854072382
504	147	12	0	12	27.0236592568
504	149	3	0	3	15.6303262207
504	154	5	0	5	39.9610901909
504	177	0	0	0	56.7528602159
504	181	1	0	1	143.228325211
504	183	2	0	2	153.827955474
504	196	1	0	1	172.534688499
504	272	1	0	1	127.762813778
504	277	0	0	0	114.873079423
504	307	1	0	1	92.2679985284
504	379	1	0	1	32.2305758722
504	396	1	0	1	21.940347587
504	397	2	1	1	19.0679067849
504	406	1	0	1	26.8042313802
504	408	4	0	4	30.051777376
504	410	1	0	1	27.420388787
504	415	4	0	4	24.2026091173
504	431	0	0	0	50.2846558235
504	460	1	0	1	17.0200723076
504	463	1	0	1	26.0156487136
504	464	10	0	10	25.5290148174
504	465	53	2	51	10.107504334
504	466	170	16	154	18.3532185728
504	467	1	0	1	15.9385111434
504	468	6	0	6	20.0273908725
504	469	478	21	457	10.3756164932
504	470	12	1	11	14.6765197088
504	471	2	0	2	30.974276308
504	472	12	2	10	19.621743222
504	473	3	2	1	9.28055364858
504	474	3	1	2	28.0247145196
504	475	214	0	214	9.18823543779
504	476	5	0	5	29.5540416646
504	477	12	2	10	17.0178362873
504	478	5	0	5	20.3275556202
504	480	11	0	11	19.8521328979
504	481	1	0	1	41.8362096315
504	482	3	0	3	39.7004602599
504	483	2	0	2	46.1104537767
504	484	3	0	3	42.6245391882
504	485	1	0	1	38.681822973
504	486	3	0	3	44.0019191145
504	487	0	0	0	40.0814881235
504	488	9	0	9	33.2303901078
504	489	2	0	2	48.1865319848
504	490	1	0	1	32.9444469535
504	491	28	0	28	23.339390009
504	492	1	0	1	31.3085964964
504	493	2	1	1	34.7218178326
504	494	101	40	61	4.59624336696
504	495	29	0	29	15.1228970092
504	496	105	51	54	4.38733715178
504	497	8	5	3	9.92787100896
504	499	7	1	6	10.4728049164
504	500	41	14	27	5.91048070498
504	501	10	1	9	23.4012711494
504	502	3	1	2	19.3391652006
504	503	121	35	86	12.659793231
504	505	1	0	1	28.5503380877
504	567	0	0	0	56.9603226852
504	573	1	0	1	53.0826458705
505	0	9	1	8	92.3640015207
505	1	42	3	39	96.240655927
505	2	1	0	1	84.0449713149
505	3	1	0	1	92.3252095621
505	5	0	0	0	90.4753651797
505	7	3	0	3	89.4818588054
505	8	1	0	1	99.938665803
505	11	1	0	1	96.918983155
505	12	1	0	1	95.1879538939
505	13	1	0	1	87.9308845857
505	14	1	0	1	84.3626695836
505	15	0	0	0	88.0635186711
505	19	1	0	1	94.896569987
505	21	1	0	1	88.0171656925
505	23	2	0	2	86.1118928965
505	26	1	0	1	74.7859385276
505	27	1	0	1	77.353250748
505	32	2	0	2	101.34907345
505	34	2	0	2	66.8733347563
505	35	2	0	2	78.9645001076
505	36	3	0	3	86.1806483552
505	42	2	0	2	92.1104856114
505	45	3	0	3	40.5141447037
505	46	1	0	1	70.9375424165
505	47	1	0	1	49.2535158653
505	48	10	0	10	53.1950416219
505	49	1	0	1	69.6656862263
505	50	3	0	3	63.2539468484
505	54	1	0	1	61.4460322278
505	59	4	1	3	47.0346534397
505	60	1	0	1	59.4459383052
505	65	4	1	3	65.2111247404
505	68	5	0	5	57.7243512014
505	69	3	2	1	48.6261118149
505	70	2	0	2	98.3805561301
505	71	3	0	3	88.7451738845
505	73	47	1	46	91.9366576304
505	74	8	0	8	91.2730405396
505	75	6	0	6	89.6467115956
505	76	3	0	3	96.5123528282
505	78	4	0	4	92.6922512472
505	79	0	0	0	95.5858258912
505	81	2	0	2	96.1678392317
505	82	5	0	5	94.7902380037
505	83	1	0	1	92.6423263124
505	84	7	0	7	91.3567184557
505	85	2	0	2	94.5045766449
505	87	5	1	4	88.4285227022
505	88	3	0	3	87.9580900263
505	89	2	0	2	102.727523765
505	90	4	0	4	99.6063946426
505	95	3	0	3	91.2094245422
505	96	1	0	1	104.710388501
505	99	2	0	2	78.3313915934
505	100	1	0	1	92.7229520565
505	102	1	0	1	98.2215287431
505	103	10	1	9	86.7883533562
505	107	1	0	1	83.3176674541
505	110	1	0	1	82.7708581195
505	111	2	0	2	107.003305406
505	112	5	1	4	87.2716937737
505	113	22	7	15	84.2300133433
505	120	4	0	4	96.1353310366
505	121	0	0	0	84.3025278911
505	122	0	0	0	107.629614621
505	124	1	0	1	56.9937764331
505	126	1	0	1	49.1890209057
505	128	0	0	0	65.7059661677
505	130	1	0	1	60.426045535
505	131	16	1	15	42.772735827
505	133	2	0	2	72.6158564222
505	134	1	0	1	72.5656610243
505	137	1	0	1	77.4075170452
505	138	1	0	1	71.7742491222
505	139	1	0	1	46.6597467138
505	140	2	0	2	78.2347852131
505	141	3	0	3	49.3790299398
505	142	56	1	55	68.8199374781
505	144	5	2	3	71.4632799791
505	147	8	0	8	54.5090421178
505	148	0	0	0	66.6789702316
505	151	1	0	1	49.766527346
505	152	1	0	1	54.9784535684
505	154	1	0	1	67.5845270412
505	163	0	0	0	63.3347371782
505	164	1	0	1	89.0139944785
505	171	1	0	1	94.0276637122
505	172	0	0	0	81.2076112111
505	188	2	0	2	178.706957501
505	208	2	0	2	170.373790824
505	211	1	0	1	178.156234581
505	220	0	0	0	194.068741466
505	221	1	0	1	187.81339568
505	228	1	0	1	182.457381201
505	229	1	0	1	178.296235107
505	242	1	0	1	210.072552485
505	244	1	0	1	211.031553442
505	245	3	0	3	112.763413429
505	247	1	0	1	126.256359455
505	277	12	0	12	137.089797833
505	282	0	0	0	135.667180877
505	287	1	0	1	143.984875821
505	294	1	0	1	147.374025071
505	301	1	0	1	144.223695253
505	302	1	0	1	137.365898946
505	305	1	1	0	121.104844211
505	307	1	0	1	111.827382644
505	358	1	0	1	140.788415619
505	366	1	0	1	114.174889349
505	385	1	0	1	60.3543881782
505	406	4	0	4	32.3619631032
505	408	9	3	6	37.9837117459
505	414	1	0	1	25.5440164345
505	415	10	0	10	40.465484573
505	416	3	0	3	32.8109853208
505	417	1	0	1	44.5832403657
505	427	1	0	1	36.5700853279
505	431	1	0	1	43.7433918528
505	438	2	0	2	56.8467711106
505	442	2	0	2	44.7198988897
505	444	1	0	1	38.6088171987
505	460	1	0	1	42.0626779527
505	463	27	0	27	7.87558757713
505	464	19	2	17	32.7226235242
505	465	71	6	65	19.3356873813
505	466	1482	15	1467	12.8099504434
505	467	3	0	3	44.0086457164
505	468	2	0	2	40.9321420009
505	469	326	59	267	26.1623293805
505	470	1	0	1	35.211136192
505	471	25	1	24	34.1365728321
505	472	16	2	14	34.7538674466
505	473	1	0	1	34.6141545825
505	474	102	1	101	10.8964451435
505	475	23	4	19	37.6912286267
505	476	18	0	18	43.6237519921
505	477	17	0	17	21.2452341371
505	478	94	50	44	8.22283299629
505	479	2	0	2	38.9942424569
505	480	18	0	18	27.7653478733
505	481	12	0	12	25.5321814363
505	482	86	5	81	19.5016548318
505	483	36	4	32	21.2679720696
505	484	15	0	15	38.7845403517
505	485	189	136	53	13.4851968713
505	486	3	0	3	32.6954733803
505	487	12	1	11	32.5161261399
505	488	31	2	29	23.3151507262
505	489	8	0	8	34.5159885593
505	490	2	0	2	29.8755904647
505	491	99	2	97	20.6812685837
505	492	11	4	7	15.568455641
505	493	877	740	137	7.85116982286
505	494	16	4	12	28.956342939
505	495	55	3	52	14.7624434624
505	496	2	0	2	29.8689942565
505	499	10	2	8	19.9243538705
505	500	3	0	3	23.0123089575
505	501	680	325	355	8.07008143221
505	502	14	0	14	19.1525542697
505	503	49	35	14	26.5556998719
505	504	3	1	2	28.5503380877
505	506	5	0	5	26.8680062697
505	573	1	0	1	80.0864981055
505	582	0	0	0	124.06339163
505	587	2	0	2	117.450747829
506	0	1	0	1	109.717585505
506	1	2	0	2	115.989013269
506	7	1	0	1	107.576967086
506	21	1	0	1	108.602671829
506	34	1	0	1	84.4122089862
506	36	0	0	0	101.323399769
506	50	1	0	1	83.8307410352
506	59	1	0	1	71.7686444327
506	70	2	0	2	107.966269096
506	73	7	0	7	102.70680392
506	74	1	0	1	100.889168531
506	78	1	0	1	102.015194758
506	84	2	0	2	101.809586977
506	89	1	0	1	114.353083576
506	103	1	0	1	98.4330927271
506	110	1	0	1	95.0123798603
506	111	1	0	1	117.643946291
506	113	1	0	1	94.9542216317
506	128	1	0	1	74.8074543247
506	141	1	0	1	53.5674744337
506	142	7	1	6	79.9513753427
506	147	2	0	2	62.3934834378
506	177	0	0	0	89.0365564732
506	205	1	0	1	166.720600061
506	242	1	0	1	223.846854221
506	277	1	0	1	151.563003667
506	284	1	0	1	157.153075515
506	285	1	0	1	162.901590299
506	338	0	0	0	134.660535468
506	349	1	0	1	121.426437485
506	379	1	0	1	41.9192475915
506	381	2	0	2	50.4851367227
506	396	5	0	5	23.3606390739
506	397	2	0	2	26.5313942576
506	398	1	0	1	33.1299318914
506	399	4	0	4	15.1343941461
506	400	1	0	1	17.2557186581
506	401	3	1	2	22.569734593
506	403	8	0	8	5.25363526073
506	404	1	0	1	29.2237119062
506	405	1	0	1	17.4617754329
506	406	40	7	33	16.7994668589
506	407	4	0	4	19.7561596793
506	408	95	19	76	20.6631121614
506	409	17	4	13	13.0466669019
506	411	6	0	6	27.7435171483
506	412	7	4	3	14.0998126389
506	413	1	0	1	27.4596173408
506	414	84	3	81	9.53598446704
506	415	9	2	7	29.5471541525
506	416	7	2	5	11.2339020563
506	417	6	0	6	31.5465864279
506	418	1	0	1	32.5295668626
506	421	40	25	15	5.37736575942
506	425	3	0	3	15.0535252602
506	426	22	0	22	26.1092600177
506	427	11	6	5	10.9050079072
506	429	2	1	1	14.470907792
506	431	1	0	1	16.9374125656
506	432	1	0	1	15.3383425667
506	433	1	0	1	38.1754946278
506	442	17	0	17	18.0999110779
506	444	16	0	16	12.245235517
506	447	16	1	15	9.16245720176
506	448	4	2	2	9.74275540163
506	453	1	0	1	30.9834763695
506	460	1	0	1	39.5601028731
506	465	3	2	1	33.9477124
506	466	7	0	7	33.7478220954
506	467	1	0	1	45.9875817472
506	469	11	1	10	41.8691205251
506	470	1	0	1	50.0825029759
506	472	1	0	1	52.8011704801
506	475	2	0	2	44.1854871302
506	476	1	0	1	63.0584948047
506	478	1	0	1	27.1448533437
506	480	1	0	1	48.2935096638
506	482	1	0	1	46.080179411
506	483	1	0	1	45.5518284525
506	493	1	0	1	33.2553877811
506	495	5	0	5	24.7359357251
506	496	2	0	2	34.530671415
506	497	1	0	1	35.9683047945
506	499	3	1	2	27.0115801042
506	500	0	0	0	31.6565902794
506	501	3	0	3	21.2348939743
506	502	11	0	11	17.5336162409
506	503	25	7	18	25.3876200368
506	505	4	0	4	26.8680062697
506	531	1	0	1	98.3447276497
506	554	0	0	0	72.4841344384
506	571	1	0	1	65.126362702
506	573	4	0	4	74.1798442647
506	581	0	0	0	81.3565478635
507	1	2	1	1	202.3359556
507	11	1	0	1	213.371938618
507	12	1	0	1	207.741208945
507	64	1	0	1	200.454625054
507	70	0	0	0	166.916716557
507	73	26	0	26	167.080026721
507	74	4	0	4	162.739688051
507	75	1	0	1	165.29841111
507	76	0	0	0	164.235643214
507	78	4	0	4	162.573585548
507	79	3	0	3	170.179633424
507	81	1	0	1	168.015711887
507	82	1	0	1	164.630050868
507	83	2	0	2	165.653636705
507	84	3	0	3	165.639385073
507	85	2	0	2	160.487967958
507	86	1	0	1	157.986226905
507	87	1	0	1	162.462657379
507	88	1	0	1	160.487790245
507	89	1	0	1	177.085142836
507	90	1	0	1	159.932943186
507	109	1	0	1	165.683161306
507	110	0	0	0	166.331648247
507	112	1	0	1	169.766688194
507	113	3	0	3	162.285970803
507	119	1	0	1	156.085259737
507	142	0	0	0	154.929543095
507	154	1	0	1	142.678832087
507	155	2	0	2	151.104534542
507	159	1	0	1	141.091649898
507	167	1	0	1	128.443018691
507	168	1	0	1	147.238722052
507	171	1	0	1	151.795457848
507	172	2	0	2	143.894527673
507	173	1	0	1	131.544155355
507	177	7	1	6	141.154530382
507	183	4	0	4	252.163643335
507	208	1	0	1	219.147695135
507	236	1	0	1	227.326322416
507	277	1	0	1	213.872804863
507	309	1	0	1	197.400604249
507	310	0	0	0	179.551805296
507	319	1	0	1	127.699138857
507	320	4	0	4	121.241820686
507	323	1	0	1	127.116333153
507	329	1	0	1	146.101200339
507	338	1	0	1	156.190961061
507	341	1	0	1	168.492499146
507	345	0	0	0	216.087207545
507	356	1	0	1	125.935226646
507	361	1	0	1	134.288295252
507	375	0	0	0	199.680723651
507	385	0	0	0	101.254523348
507	392	0	0	0	106.211578861
507	394	1	0	1	102.306898841
507	397	1	0	1	115.730755852
507	401	1	0	1	101.453437001
507	406	1	0	1	112.712211734
507	408	23	2	21	107.390496443
507	411	2	0	2	103.573810371
507	415	1	0	1	110.006148898
507	417	2	0	2	105.566008126
507	424	1	0	1	92.6675481546
507	426	0	0	0	106.634208428
507	439	1	0	1	83.2784245242
507	441	0	0	0	92.8655312472
507	442	3	0	3	101.328054985
507	453	1	0	1	113.44567218
507	454	1	0	1	118.900438033
507	475	1	0	1	133.079573157
507	476	1	0	1	161.829316554
507	493	1	0	1	151.47521393
507	496	1	0	1	129.705949251
507	502	1	0	1	126.52115257
507	508	31	10	21	8.24699993651
507	509	137	46	91	11.2239126937
507	510	10	0	10	15.9135325132
507	511	117	68	49	6.83334146276
507	512	32	7	25	37.9446985007
507	514	2	0	2	23.5067962866
507	515	1	0	1	52.2100127677
507	517	3	0	3	31.8055722593
507	519	1	0	1	43.331715646
507	521	0	0	0	71.1480311984
507	523	1	0	1	56.2767343384
507	524	14	0	14	67.5873787272
507	528	1	0	1	68.914433956
507	529	1	0	1	44.083381363
507	530	1	0	1	53.1133298519
507	533	7	2	5	22.159624657
507	535	19	3	16	32.456818943
507	536	0	0	0	53.7982722634
507	537	3	2	1	51.5881066436
507	538	1	0	1	60.3383371896
507	540	62	15	47	40.2453472185
507	541	7	0	7	29.3776490697
507	542	40	2	38	13.3679608493
507	543	6	0	6	37.4777517375
507	544	2	0	2	24.6537920385
507	545	4	0	4	14.2964951415
507	546	7	1	6	10.5641041723
507	547	7	1	6	22.2949886819
507	548	70	0	70	19.7130550742
507	549	49	10	39	14.3500157326
507	550	3	0	3	27.2270117053
507	552	1	0	1	76.1298217897
507	554	2	0	2	81.7092801819
507	555	1	0	1	88.231543396
507	556	0	0	0	72.6009067153
507	561	2	0	2	69.8037533489
507	563	1	0	1	94.5968027533
507	566	1	0	1	104.441414708
507	569	0	0	0	112.412092684
507	573	22	1	21	109.33686545
507	578	1	0	1	113.420758969
507	579	1	0	1	119.229798723
507	581	0	0	0	124.688167048
507	585	3	0	3	105.170086855
508	17	1	0	1	180.926693436
508	71	1	0	1	151.041359776
508	73	2	0	2	159.259278628
508	75	2	0	2	157.452206438
508	78	1	0	1	154.810567934
508	82	0	0	0	156.888982293
508	84	1	0	1	157.821491733
508	87	0	0	0	154.619406892
508	88	0	0	0	152.652789252
508	171	0	0	0	144.162193609
508	172	0	0	0	136.050075138
508	177	3	0	3	133.401880315
508	319	2	0	2	120.661106058
508	353	0	0	0	152.76754105
508	378	1	0	1	194.593205731
508	398	1	1	0	79.3007330627
508	408	6	0	6	99.3030140162
508	431	1	0	1	97.1547396889
508	440	1	0	1	73.7753131811
508	441	0	0	0	85.1393483853
508	442	1	0	1	93.7004060192
508	507	328	0	328	8.24699993651
508	509	15	5	10	19.0290868595
508	510	5	1	4	7.66692586917
508	511	13	2	11	15.0441618913
508	512	14	0	14	30.0562985241
508	524	1	0	1	59.4766084603
508	525	1	0	1	52.0294426856
508	530	1	0	1	48.8912985119
508	535	4	0	4	26.0581825473
508	536	0	0	0	48.0404911036
508	537	2	0	2	43.9198877039
508	540	8	0	8	32.8009438625
508	541	1	0	1	26.4553716604
508	542	4	2	2	14.0084848908
508	544	1	0	1	26.0221748479
508	547	3	0	3	20.7183340856
508	548	16	0	16	23.5220638134
508	549	18	3	15	10.1519149879
508	550	1	0	1	30.5690027402
508	554	0	0	0	73.872139578
508	561	0	0	0	62.1800075497
508	566	1	0	1	96.3705037985
508	569	0	0	0	104.830714286
508	570	1	0	1	105.339592291
508	571	0	0	0	90.5226737936
508	572	0	0	0	100.7499149
508	573	2	0	2	101.530419532
508	581	0	0	0	116.941983878
509	1	2	1	1	211.584923847
509	12	1	0	1	217.232572387
509	70	1	0	1	174.979770093
509	73	9	0	9	175.480908516
509	74	0	0	0	171.070473231
509	76	0	0	0	172.329522757
509	78	1	0	1	170.827460677
509	79	1	0	1	178.474023845
509	82	2	0	2	172.824236153
509	85	0	0	0	168.598169164
509	87	0	0	0	170.930996162
509	88	0	0	0	168.936214968
509	103	1	0	1	175.5027642
509	111	1	0	1	184.168270666
509	112	1	0	1	178.463256
509	113	2	0	2	170.956740224
509	142	1	0	1	164.169295639
509	163	1	0	1	143.973558249
509	166	1	0	1	153.477044293
509	177	0	0	0	149.417194083
509	184	1	0	1	254.826125599
509	214	1	0	1	217.940520935
509	293	1	0	1	209.208934271
509	319	1	0	1	134.422323583
509	320	2	0	2	128.121310357
509	338	0	0	0	161.777111687
509	349	1	0	1	152.962647167
509	375	0	0	0	204.900451547
509	385	0	0	0	111.141936894
509	396	1	0	1	124.731933189
509	398	1	0	1	98.3252753214
509	399	2	0	2	132.968172771
509	408	6	0	6	118.316231131
509	411	0	0	0	114.346295625
509	417	1	0	1	116.184481377
509	422	1	0	1	113.760449379
509	426	2	0	2	117.793746322
509	441	1	0	1	104.048356991
509	442	5	1	4	112.535100761
509	454	1	0	1	128.959086861
509	496	2	0	2	140.27804987
509	507	435	18	417	11.2239126937
509	508	3	0	3	19.0290868595
509	510	1	0	1	26.5447561623
509	511	189	51	138	5.08016134408
509	512	1	0	1	49.0441696381
509	513	1	0	1	55.1201113054
509	515	1	0	1	63.3434633781
509	521	0	0	0	81.7932376089
509	524	2	0	2	77.0969731676
509	528	1	1	0	79.8510145249
509	529	2	0	2	49.2017366895
509	530	1	0	1	56.1504259518
509	535	2	0	2	39.4266811059
509	536	0	0	0	59.0546933126
509	537	1	0	1	60.0995233729
509	540	6	1	5	48.5285207011
509	541	0	0	0	32.1255607641
509	542	10	5	5	15.6445399028
509	544	1	0	1	22.3698801014
509	545	17	1	16	6.94792755098
509	546	7	0	7	8.71216747529
509	547	7	4	3	24.4167601135
509	548	74	19	55	14.7713675289
509	549	4	0	4	21.2074015873
509	550	2	0	2	21.6065456093
509	554	0	0	0	90.3664189012
509	561	1	0	1	78.0390971887
509	562	1	0	1	87.0363357912
509	563	1	0	1	102.7046069
509	566	1	0	1	113.698357378
509	573	4	0	4	117.812251444
509	581	1	0	1	132.969816643
510	78	1	0	1	147.680518559
510	177	0	0	0	126.291455854
510	408	0	0	0	91.7868961938
510	438	1	0	1	74.203422219
510	507	34	8	26	15.9135325132
510	508	4	0	4	7.66692586917
510	509	2	0	2	26.5447561623
510	511	3	0	3	22.7049947193
510	512	18	0	18	22.9046408231
510	513	1	0	1	28.5964971721
510	514	6	1	5	7.59912659143
510	519	1	0	1	27.6546851278
510	524	1	0	1	51.9994641587
510	527	1	0	1	36.2301162977
510	535	2	0	2	21.3759081803
510	537	1	0	1	37.0667371609
510	539	0	0	0	52.7008347689
510	540	3	0	3	26.3777922931
510	541	4	0	4	25.9960116033
510	542	2	0	2	18.3670862695
510	547	2	0	2	22.1964553242
510	548	2	0	2	28.8519814701
510	549	4	0	4	11.4713165789
510	561	0	0	0	55.3030981321
510	573	1	0	1	94.3799281256
510	585	1	0	1	92.3519274833
511	64	1	0	1	207.181797716
511	73	2	0	2	173.246571052
511	78	0	0	0	168.679946221
511	81	1	0	1	174.104686293
511	82	0	0	0	170.712618742
511	83	1	0	1	171.791533323
511	84	1	0	1	171.803273093
511	87	2	0	2	168.654893069
511	92	1	0	1	177.674616541
511	164	1	0	1	157.341602438
511	168	2	0	2	153.369686313
511	172	1	0	1	150.094166502
511	177	1	0	1	147.258292906
511	183	1	0	1	257.8028865
511	310	0	0	0	184.686584477
511	338	0	0	0	161.083665615
511	341	1	0	1	173.286517124
511	345	1	0	1	220.941595702
511	408	2	0	2	114.215756712
511	411	0	0	0	110.407013906
511	442	3	0	3	107.985195323
511	444	1	0	1	117.00202573
511	507	324	2	322	6.83334146276
511	508	5	0	5	15.0441618913
511	509	120	31	89	5.08016134408
511	510	2	0	2	22.7049947193
511	512	6	0	6	44.7340936521
511	513	2	0	2	51.2608230466
511	517	1	0	1	38.4620176759
511	524	1	0	1	74.1247012465
511	529	2	0	2	48.5541691933
511	535	2	0	2	37.7959963607
511	536	0	0	0	58.3868209774
511	537	1	0	1	57.7200849523
511	540	7	0	7	46.2471648445
511	541	1	0	1	32.4111369616
511	542	6	0	6	15.5610080612
511	543	1	0	1	39.9359370322
511	544	1	0	1	24.6306314873
511	545	2	0	2	10.6559208559
511	546	0	0	0	9.7234972818
511	547	2	0	2	24.8180853047
511	548	11	3	8	17.896601708
511	549	10	0	10	19.3392324403
511	561	0	0	0	75.849282935
511	565	1	0	1	69.4997638581
511	573	2	0	2	115.513655051
511	580	0	0	0	124.366849917
511	581	0	0	0	130.7935532
512	5	1	0	1	169.158990749
512	13	1	0	1	154.407232915
512	70	1	0	1	137.884591836
512	71	1	0	1	128.857553327
512	73	8	0	8	136.863205669
512	74	1	0	1	132.835282711
512	75	1	0	1	134.857610462
512	76	0	0	0	135.140272594
512	78	2	0	2	132.942462331
512	82	0	0	0	135.174866182
512	84	0	0	0	135.464512142
512	85	1	0	1	131.400747863
512	87	4	0	4	132.080198496
512	88	1	0	1	130.206294878
512	103	1	0	1	135.775997905
512	107	1	0	1	121.052874128
512	113	3	2	1	131.199908327
512	130	1	0	1	112.020854345
512	142	2	0	2	121.977338439
512	153	1	0	1	110.79527601
512	165	1	0	1	106.360284133
512	166	1	0	1	120.37429595
512	168	1	0	1	117.638988939
512	175	1	0	1	118.360140076
512	177	4	0	4	111.916043553
512	183	1	0	1	225.341222088
512	190	1	0	1	226.343897602
512	277	0	0	0	185.936485443
512	319	3	0	3	104.647667209
512	338	0	0	0	136.275376623
512	345	1	0	1	195.279114087
512	348	1	0	1	143.259934468
512	356	2	0	2	109.734955578
512	383	1	0	1	49.1496547775
512	385	1	0	1	66.8682033263
512	389	1	0	1	52.1546240634
512	396	1	0	1	76.3789219552
512	403	1	0	1	78.4228219922
512	406	1	0	1	74.8586064273
512	408	20	1	19	69.6022701659
512	411	4	0	4	66.1309968819
512	415	2	0	2	72.8769574734
512	416	1	0	1	73.3754893635
512	424	3	2	1	59.2153780216
512	426	1	0	1	70.9819600074
512	427	1	0	1	70.4502974451
512	430	2	0	2	32.5383267627
512	437	1	0	1	39.7927638338
512	438	0	0	0	51.3062917105
512	441	0	0	0	55.120549654
512	442	0	0	0	63.7610657983
512	445	1	0	1	38.908393466
512	503	2	0	2	86.6953406517
512	507	102	18	84	37.9446985007
512	508	5	0	5	30.0562985241
512	509	7	0	7	49.0441696381
512	510	25	1	24	22.9046408231
512	511	9	0	9	44.7340936521
512	513	21	6	15	9.78666017797
512	514	14	1	13	16.1144830464
512	515	59	1	58	14.3259981686
512	516	7	0	7	30.6605000201
512	517	56	0	56	14.3145287575
512	518	9	1	8	22.3884523588
512	519	34	15	19	16.7319295895
512	520	3	0	3	43.0266170856
512	521	0	0	0	34.4508380495
512	523	8	2	6	20.1157789024
512	524	53	5	48	36.7715126052
512	526	1	0	1	28.5055113793
512	527	8	2	6	21.5181467995
512	528	3	0	3	31.2048664355
512	529	5	2	3	41.0368095451
512	530	3	0	3	53.8948248003
512	532	2	0	2	40.6190992843
512	533	3	0	3	26.8123708189
512	534	4	0	4	37.6553254254
512	535	25	8	17	29.7838452163
512	536	3	0	3	46.278107126
512	537	14	0	14	29.8211055342
512	538	1	0	1	38.8527006621
512	539	1	0	1	47.6208121733
512	540	77	8	69	25.4635611589
512	541	3	0	3	42.2366902903
512	542	3	0	3	40.6251030712
512	548	7	0	7	51.2690173303
512	549	8	1	7	32.8927406027
512	550	1	0	1	57.0261023336
512	551	1	0	1	75.7101515911
512	552	0	0	0	58.4114135269
512	553	1	0	1	54.091029684
512	554	3	0	3	53.5918591854
512	555	2	0	2	63.8819719289
512	561	3	0	3	45.0947770321
512	566	1	0	1	72.4554866601
512	569	2	0	2	85.4203856066
512	573	17	0	17	80.28944321
512	581	0	0	0	95.8305918283
512	585	1	0	1	84.8230449027
512	586	1	0	1	85.4735471075
513	1	1	0	1	159.943311896
513	73	4	0	4	127.305783593
513	75	1	0	1	125.322296127
513	78	0	0	0	123.324322236
513	85	2	0	2	121.737310116
513	87	1	0	1	122.535185175
513	92	1	0	1	133.13277061
513	144	1	0	1	108.183236736
513	155	1	0	1	114.014142433
513	177	1	0	1	102.242369119
513	257	1	0	1	153.6051689
513	319	2	0	2	94.9344998735
513	344	0	0	0	125.052414268
513	406	1	0	1	68.8198711383
513	408	6	0	6	63.374003275
513	411	2	0	2	59.2297637064
513	433	1	0	1	49.6800572901
513	438	0	0	0	48.1041202921
513	441	0	0	0	51.1629656834
513	442	1	0	1	60.1141805629
513	507	22	1	21	44.4365493068
513	510	2	0	2	28.5964971721
513	511	2	0	2	51.2608230466
513	512	246	47	199	9.78666017797
513	514	1	0	1	21.0242898285
513	515	30	0	30	12.6733914335
513	516	3	0	3	29.6829011167
513	517	5	1	4	14.6139066799
513	518	3	0	3	23.7592599062
513	519	21	0	21	9.46360379376
513	523	4	0	4	11.8402635312
513	524	10	2	8	27.0068574744
513	525	3	0	3	22.0725905426
513	526	1	0	1	19.5788992483
513	527	3	0	3	11.8596281932
513	529	4	0	4	36.8815726176
513	534	1	0	1	30.6601584928
513	535	5	1	4	28.0806015037
513	537	4	1	3	21.650017158
513	540	27	9	18	20.6297647803
513	543	1	1	0	47.6436518577
513	548	0	0	0	54.9757440018
513	549	2	0	2	36.5643847754
513	552	1	0	1	49.6258134765
513	554	1	0	1	43.8060631347
513	561	0	0	0	35.5848517841
513	573	3	1	2	70.5569716041
513	579	1	0	1	82.5924039295
513	581	1	0	1	86.1113503384
514	35	1	0	1	159.289369949
514	73	4	0	4	145.105546731
514	78	0	0	0	140.796686344
514	83	1	0	1	143.771081365
514	87	0	0	0	140.41750146
514	110	1	0	1	143.858569032
514	141	0	0	0	107.543244723
514	177	0	0	0	119.442995354
514	309	1	0	1	175.043198883
514	319	1	0	1	108.407910525
514	338	0	0	0	138.551919141
514	396	1	0	1	90.6422176873
514	406	1	0	1	89.7040635449
514	408	5	0	5	84.3019810243
514	411	2	0	2	80.2519537996
514	424	2	0	2	74.8633156677
514	435	1	0	1	77.6610463407
514	441	0	0	0	70.9308745211
514	507	51	0	51	23.5067962866
514	508	2	0	2	15.2629291302
514	509	2	0	2	34.0958279396
514	510	17	0	17	7.59912659143
514	511	1	0	1	30.303938781
514	512	58	4	54	16.1144830464
514	513	2	1	1	21.0242898285
514	515	0	0	0	30.2105925385
514	517	5	1	4	9.07268147883
514	518	1	0	1	38.3086322601
514	519	4	0	4	20.416104506
514	524	2	0	2	44.7435771568
514	528	1	0	1	45.8921126893
514	529	2	0	2	32.384842932
514	530	0	0	0	44.7003737829
514	533	2	0	2	11.9390029663
514	535	6	0	6	19.0873717753
514	540	5	0	5	21.0986311947
514	542	2	0	2	24.5155920262
514	543	1	0	1	35.6250429763
514	546	2	0	2	28.8090388278
514	548	4	0	4	35.1610409701
514	549	7	3	4	16.790708916
514	550	1	0	1	40.9607728211
514	553	1	0	1	48.758631605
514	554	0	0	0	59.8815859926
514	563	1	0	1	73.4467636724
514	573	3	0	3	87.5094766421
514	581	2	0	2	103.031277654
515	1	1	0	1	157.809562582
515	48	1	0	1	126.486629623
515	70	1	0	1	129.372093157
515	71	0	0	0	119.921563244
515	73	17	0	17	127.717142256
515	74	4	0	4	123.902682293
515	75	1	0	1	125.607524172
515	78	0	0	0	124.158778598
515	84	1	0	1	126.355476659
515	85	1	0	1	122.931244847
515	87	2	0	2	122.890809722
515	88	1	0	1	121.093120549
515	89	1	0	1	138.915283586
515	95	1	0	1	132.804877064
515	112	1	0	1	128.74080323
515	140	1	0	1	118.753016605
515	142	0	0	0	111.39692363
515	171	1	0	1	115.507654054
515	177	0	0	0	103.633240658
515	305	1	0	1	167.070924069
515	319	1	0	1	99.8383720791
515	338	0	0	0	132.331493122
515	385	0	0	0	56.1610246612
515	396	1	0	1	62.7585369873
515	398	6	2	4	35.182648902
515	400	1	0	1	54.4012966231
515	405	0	0	0	52.7319482844
515	406	6	0	6	60.8610512009
515	407	1	0	1	65.4780513514
515	408	22	9	13	55.7130955265
515	411	4	0	4	52.6815762114
515	413	1	0	1	42.3490360231
515	414	2	0	2	66.4362206193
515	415	1	0	1	59.7074390333
515	420	1	0	1	36.7801016537
515	423	2	0	2	47.675433178
515	425	1	0	1	52.7492157638
515	430	3	2	1	18.2127396041
515	433	3	1	2	37.2755345664
515	436	1	0	1	63.0766894372
515	437	0	0	0	29.8179141885
515	438	0	0	0	37.0781858519
515	441	0	0	0	40.8007418057
515	442	4	0	4	49.4805832351
515	444	0	0	0	58.9623179637
515	445	3	0	3	24.9420217061
515	446	1	0	1	23.8675436393
515	469	1	0	1	93.8702643848
515	475	1	0	1	84.2883368186
515	507	19	0	19	52.2100127677
515	509	1	0	1	63.3434633781
515	510	3	0	3	37.2099292749
515	512	174	15	159	14.3259981686
515	513	5	3	2	12.6733914335
515	514	5	1	4	30.2105925385
515	516	24	8	16	17.2380491874
515	517	11	1	10	26.1479960624
515	518	13	2	11	11.3533319571
515	519	6	1	5	21.8455485307
515	520	2	0	2	31.3548914779
515	521	3	0	3	22.7309444756
515	522	2	0	2	27.6940198359
515	523	27	1	26	12.0195782119
515	524	24	2	22	31.2785624651
515	525	2	0	2	29.3888535715
515	526	2	0	2	19.8415175505
515	527	2	0	2	20.6303506354
515	528	4	1	3	17.8383033521
515	529	1	0	1	49.4941336639
515	533	2	0	2	39.9694210748
515	535	6	0	6	40.5748691808
515	536	1	0	1	52.3932775853
515	537	8	1	7	32.5725047263
515	539	1	1	0	48.875878613
515	540	5	0	5	33.2536754128
515	548	1	0	1	65.3175448386
515	552	1	0	1	58.6438347442
515	553	1	0	1	59.1004581496
515	554	0	0	0	48.2132929132
515	558	1	0	1	44.3193582926
515	563	0	0	0	62.399995559
515	566	1	0	1	63.3659795668
515	573	4	0	4	72.8645135387
515	581	1	0	1	88.082150029
516	23	1	0	1	143.449040003
516	70	3	0	3	128.614675932
516	71	1	0	1	118.647526558
516	73	17	0	17	125.982203257
516	74	1	0	1	122.569052805
516	78	1	0	1	123.057327488
516	83	1	0	1	125.254983209
516	84	2	0	2	124.70075538
516	85	0	0	0	122.33964464
516	86	1	0	1	118.632693634
516	87	1	0	1	121.159606005
516	89	1	0	1	137.590419012
516	103	1	0	1	123.67812887
516	110	1	0	1	121.66121569
516	116	1	0	1	125.818634962
516	142	2	1	1	107.455673296
516	155	1	0	1	117.43319571
516	164	1	0	1	113.160432769
516	168	1	0	1	108.563802471
516	172	1	0	1	104.069151115
516	177	1	0	1	103.700264865
516	319	3	0	3	104.736752564
516	323	1	0	1	98.7827660485
516	338	1	0	1	137.686677915
516	381	2	0	2	42.3091207208
516	382	5	2	3	24.0884437535
516	385	1	0	1	53.9801324911
516	389	0	0	0	35.5416615768
516	391	1	0	1	57.9019464389
516	395	1	0	1	42.4858410865
516	396	5	0	5	52.6927892629
516	397	2	0	2	55.5763470498
516	398	11	0	11	24.1520914783
516	400	1	0	1	42.2796271764
516	401	5	0	5	38.4308199107
516	403	1	0	1	50.1423923195
516	404	1	0	1	36.9008153852
516	406	6	0	6	49.2328177911
516	407	1	0	1	54.4823782229
516	408	118	4	114	44.807366201
516	410	3	0	3	47.1821879982
516	411	4	2	2	43.7254761179
516	413	3	1	2	31.2689234025
516	414	1	0	1	53.3181623897
516	415	1	0	1	51.3179968033
516	416	2	1	1	45.9815994293
516	417	4	0	4	47.7821098045
516	419	1	0	1	34.8378433004
516	420	1	0	1	21.7926299191
516	421	1	0	1	47.0681083951
516	422	1	0	1	35.5823097787
516	423	4	1	3	32.6101161301
516	424	8	0	8	30.5364250988
516	425	1	0	1	37.3810500494
516	426	5	1	4	40.4186895524
516	427	4	0	4	41.7875412198
516	429	1	0	1	49.7274787355
516	430	103	7	96	8.3372002326
516	433	66	21	45	20.0396604585
516	434	1	0	1	36.247381482
516	437	16	0	16	16.5576460279
516	438	24	7	17	21.646386798
516	439	45	11	34	16.0581331725
516	440	10	2	8	15.9627494521
516	441	3	0	3	26.3397501578
516	442	18	0	18	34.1832229251
516	443	7	0	7	26.2268454114
516	444	2	0	2	42.989122777
516	445	34	21	13	8.749497355
516	446	4	1	3	16.4566337982
516	458	0	0	0	59.8422902359
516	462	1	0	1	61.5256472211
516	507	9	0	9	67.4377893853
516	508	1	0	1	60.0334262944
516	510	1	0	1	53.3160861872
516	512	39	1	38	30.6605000201
516	513	1	0	1	29.6829011167
516	514	1	0	1	46.7734249053
516	515	15	1	14	17.2380491874
516	517	3	0	3	43.3662837615
516	518	80	17	63	9.60471666959
516	519	1	0	1	38.3513330807
516	520	4	2	2	30.1902617254
516	521	6	1	5	23.9245311434
516	522	0	0	0	32.7544441231
516	523	4	1	3	23.9288922045
516	524	12	0	12	39.8311061499
516	525	1	0	1	41.1672360795
516	528	9	2	7	16.4315333922
516	535	1	0	1	57.7389796193
516	537	1	1	0	47.2867268532
516	540	5	1	4	49.9123889017
516	548	1	0	1	81.9136192619
516	549	1	0	1	63.5522968891
516	554	3	0	3	54.7979960617
516	573	8	0	8	75.1948525127
516	581	0	0	0	89.3686248055
517	1	1	0	1	170.633067632
517	70	1	0	1	136.311874069
517	71	1	0	1	127.89567169
517	73	2	0	2	136.078709932
517	74	0	0	0	131.826019429
517	76	0	0	0	133.600189193
517	78	0	0	0	131.749028283
517	81	2	0	2	137.231193765
517	82	2	0	2	133.870747069
517	84	1	0	1	134.647540285
517	85	0	0	0	129.843607743
517	87	1	0	1	131.39894186
517	95	1	0	1	142.198207016
517	113	1	0	1	131.02065171
517	142	1	0	1	123.251831639
517	172	1	0	1	112.842748197
517	175	2	0	2	116.343214606
517	177	1	0	1	110.387219604
517	183	0	0	0	222.635662065
517	319	1	0	1	99.494128946
517	408	3	0	3	77.5942407219
517	410	1	0	1	77.8347722994
517	411	0	0	0	73.1217889262
517	441	1	0	1	65.7661694429
517	442	0	0	0	74.7021770709
517	507	52	1	51	31.8055722593
517	509	4	0	4	41.8146391471
517	510	5	1	4	16.1148295103
517	511	5	0	5	38.4620176759
517	512	259	30	229	14.3145287575
517	513	8	1	7	14.6139066799
517	514	5	3	2	9.07268147883
517	515	6	0	6	26.1479960624
517	516	1	0	1	43.3662837615
517	519	14	0	14	11.5472068264
517	521	1	0	1	40.4437143836
517	523	2	1	1	25.8197205966
517	524	6	2	4	35.8848833378
517	526	1	0	1	32.2684655552
517	527	1	0	1	20.1925073703
517	529	14	0	14	27.3118332291
517	533	6	4	2	14.1334488891
517	535	44	11	33	15.4770447161
517	536	4	0	4	33.7588931808
517	537	8	0	8	21.9316724898
517	540	86	5	81	13.2504311908
517	541	2	0	2	28.3749428305
517	542	7	0	7	30.0721832789
517	543	1	0	1	34.641025203
517	544	1	0	1	38.0689564279
517	546	1	0	1	35.507004327
517	548	3	0	3	40.4584092119
517	549	5	0	5	22.1824023264
517	554	1	0	1	50.8177563216
517	555	1	0	1	58.9021375545
517	561	1	0	1	39.8582261003
517	573	7	1	6	78.4555012478
517	581	0	0	0	93.9693799545
517	585	1	0	1	78.1370718735
518	1	1	0	1	160.115479146
518	70	0	0	0	134.588969878
518	73	4	1	3	132.36172848
518	76	1	0	1	131.854227426
518	105	1	0	1	144.71573822
518	112	0	0	0	132.779011312
518	172	3	0	3	110.006807628
518	177	1	0	1	109.246241568
518	319	0	0	0	107.941628357
518	341	0	0	0	153.357726628
518	385	1	0	1	60.1745625779
518	392	2	0	2	64.3867032362
518	396	1	0	1	61.6231486163
518	398	6	2	4	33.0288717093
518	401	1	0	1	47.534768949
518	402	1	0	1	39.8532739806
518	406	6	0	6	58.5061856113
518	408	40	4	36	53.8977117075
518	410	1	1	0	56.0024877987
518	411	0	0	0	52.2775204521
518	415	1	0	1	59.7656169513
518	417	1	1	0	55.9900709777
518	420	1	0	1	25.6463433844
518	423	10	1	9	36.4641776257
518	424	3	0	3	36.9102180053
518	425	1	0	1	46.9478374923
518	426	1	0	1	48.8541141593
518	427	1	0	1	51.3888806917
518	430	25	0	25	15.638781122
518	433	14	0	14	28.1328938626
518	437	10	0	10	18.5094974295
518	438	5	1	4	31.2430312577
518	439	4	0	4	25.1234473656
518	440	3	1	2	25.2989698468
518	441	3	0	3	35.9274928966
518	442	4	0	4	43.7636003614
518	443	1	0	1	33.5835343514
518	444	2	0	2	52.4204298609
518	445	4	0	4	18.3453961206
518	446	3	0	3	12.986882401
518	447	1	0	1	59.3496407861
518	507	7	3	4	58.1567882197
518	509	1	0	1	69.3746956461
518	510	2	0	2	44.4713989333
518	512	85	0	85	22.3884523588
518	513	5	0	5	23.7592599062
518	514	2	0	2	38.3086322601
518	515	48	0	48	11.3533319571
518	516	120	11	109	9.60471666959
518	517	4	2	2	36.0398222455
518	519	3	0	3	33.104540277
518	520	2	1	1	35.4172958636
518	521	3	0	3	27.6842351399
518	523	8	0	8	21.9581405956
518	524	8	0	8	40.4610221921
518	525	3	0	3	39.8581627158
518	528	8	3	5	20.6920312225
518	537	1	0	1	43.8613664232
518	540	5	0	5	44.3843797428
518	548	1	0	1	73.2556211771
518	549	1	0	1	55.075811593
518	554	0	0	0	56.7803599185
518	561	0	0	0	53.0137291252
518	567	1	0	1	68.3741351667
518	573	1	0	1	79.5546851464
519	1	1	0	1	159.087653767
519	36	1	0	1	135.156367711
519	70	0	0	0	125.111743513
519	73	5	0	5	124.734317852
519	78	0	0	0	120.470863786
519	82	0	0	0	122.615059895
519	84	1	0	1	123.307249978
519	99	1	0	1	122.767846853
519	103	1	0	1	124.170427138
519	142	1	0	1	111.710384148
519	158	1	0	1	95.784726882
519	163	1	0	1	91.4491782668
519	166	1	0	1	106.11694183
519	177	0	0	0	99.1502463425
519	319	0	0	0	89.4063282336
519	332	0	0	0	130.866095499
519	338	0	0	0	120.46776734
519	366	1	0	1	86.1873236348
519	375	0	0	0	164.28025485
519	408	7	0	7	67.6482160815
519	409	1	0	1	77.8480165082
519	411	0	0	0	62.7586476769
519	441	0	0	0	57.7428512891
519	475	1	0	1	90.3455784288
519	507	12	0	12	43.331715646
519	508	1	0	1	35.1715688466
519	509	3	0	3	53.1628673893
519	510	2	0	2	27.6546851278
519	512	102	18	84	16.7319295895
519	513	4	3	1	9.46360379376
519	514	3	1	2	20.416104506
519	515	5	2	3	21.8455485307
519	516	1	0	1	38.3513330807
519	517	8	0	8	11.5472068264
519	518	2	1	1	33.104540277
519	523	2	0	2	16.6900141209
519	524	9	0	9	24.3513350049
519	525	1	0	1	17.3163361089
519	527	10	3	7	8.74110099548
519	529	5	0	5	27.7089704201
519	530	2	0	2	40.0919369561
519	533	1	0	1	24.0870824201
519	535	5	0	5	20.4889198807
519	537	13	5	8	13.0989756968
519	540	41	14	27	11.5656922376
519	548	1	0	1	50.5681393412
519	549	1	0	1	32.8816157056
519	554	1	0	1	39.6809141665
519	555	1	0	1	48.5913087654
519	561	4	0	4	29.5012212101
519	573	4	0	4	67.2211525748
520	1	5	0	5	126.474544727
520	19	1	1	0	116.961748593
520	36	2	0	2	104.24821498
520	41	1	0	1	102.887444898
520	71	1	0	1	89.4281337741
520	73	25	0	25	97.0309676585
520	74	3	0	3	93.3903176199
520	75	4	0	4	94.8589146667
520	76	0	0	0	96.43721122
520	77	1	0	1	100.920933296
520	78	6	0	6	93.7626027136
520	79	0	0	0	100.687586884
520	81	5	0	5	99.2164022774
520	82	4	0	4	96.1121021728
520	84	8	0	8	95.7010159638
520	85	1	0	1	92.8112049736
520	87	4	0	4	92.1949709411
520	88	0	0	0	90.4598202411
520	90	1	0	1	94.377365497
520	107	1	0	1	81.4999693638
520	110	1	0	1	93.5607652162
520	113	3	0	3	90.6867891763
520	119	1	0	1	89.5822216961
520	131	1	0	1	77.1507079673
520	155	1	0	1	87.3796508487
520	158	1	0	1	71.8650417979
520	159	1	1	0	78.1398051568
520	163	1	0	1	60.3524868182
520	168	2	0	2	78.9606090291
520	172	3	1	2	74.5908674923
520	177	2	0	2	73.8753927174
520	183	1	0	1	187.255565479
520	187	0	0	0	185.707245287
520	220	1	0	1	203.376659405
520	257	1	0	1	123.28714183
520	277	3	0	3	147.343870169
520	310	0	0	0	125.254416788
520	319	4	0	4	75.0193815508
520	324	1	0	1	82.8913403323
520	325	1	0	1	68.1739065054
520	329	1	0	1	89.2347032375
520	338	0	0	0	107.974890634
520	360	1	0	1	83.9804153666
520	373	1	0	1	137.587855413
520	379	2	0	2	24.7765510952
520	381	17	7	10	12.2728019258
520	382	45	1	44	10.7243772627
520	383	22	8	14	9.75191475025
520	385	14	2	12	24.964732855
520	386	1	0	1	21.2537411011
520	388	4	0	4	18.472836825
520	389	16	1	15	9.48224021013
520	391	1	0	1	31.1677264785
520	392	2	0	2	29.4560533947
520	393	3	0	3	14.3330789548
520	394	1	0	1	23.0006631647
520	395	3	0	3	14.8617933073
520	396	6	0	6	35.8431078878
520	397	2	0	2	37.0151899909
520	398	22	0	22	18.5587906265
520	400	3	1	2	32.2080526858
520	401	9	4	5	26.6309889136
520	402	13	1	12	14.9469630085
520	404	9	0	9	20.4901763056
520	405	2	0	2	31.5143874311
520	406	18	0	18	36.6392814728
520	407	3	0	3	39.6583662712
520	408	220	60	160	31.0146257266
520	409	0	0	0	41.523162795
520	410	5	0	5	30.3199768759
520	411	43	0	43	25.4852683481
520	412	4	0	4	34.781212314
520	413	13	1	12	21.6786580818
520	414	2	0	2	44.4020644401
520	415	9	2	7	31.0110533384
520	417	4	0	4	26.4911394523
520	418	1	0	1	20.3956678724
520	419	1	0	1	27.8016772054
520	425	2	0	2	39.2489638581
520	426	1	0	1	52.9404659961
520	427	4	1	3	38.7369835996
520	430	7	0	7	21.906518533
520	431	1	0	1	42.2599647062
520	433	2	0	2	40.0085388025
520	437	1	0	1	46.01037939
520	438	4	0	4	29.5595795437
520	440	2	0	2	22.6205334576
520	441	2	0	2	28.633734446
520	442	7	2	5	36.6124860605
520	444	1	0	1	46.3797068181
520	445	3	1	2	28.1003853213
520	451	2	0	2	39.4535759178
520	455	1	0	1	44.892677608
520	460	3	0	3	40.227037428
520	466	2	0	2	67.4626190293
520	475	2	0	2	53.9258254275
520	503	1	0	1	45.7518756477
520	507	10	3	7	79.3142201899
520	512	18	0	18	43.0266170856
520	515	5	0	5	31.3548914779
520	516	6	0	6	30.1902617254
520	517	1	0	1	48.169007119
520	519	2	0	2	37.4483318584
520	521	41	18	23	8.67433514584
520	522	53	4	49	11.0954664723
520	523	12	0	12	23.1664368361
520	524	288	45	243	19.725012198
520	525	8	1	7	26.5667751785
520	526	11	5	6	15.9241517263
520	527	3	0	3	29.0269524798
520	528	17	7	10	14.7291422602
520	529	3	0	3	58.940535451
520	534	1	0	1	46.1343808097
520	536	2	0	2	56.2664012371
520	537	6	0	6	37.3051562464
520	539	1	0	1	43.4444675336
520	540	13	2	11	46.3451894619
520	543	1	0	1	74.2102274454
520	548	2	0	2	88.0150072701
520	549	1	0	1	70.201119518
520	552	2	0	2	48.3684824827
520	554	13	1	12	27.8908223942
520	555	4	0	4	40.6609494866
520	557	1	0	1	24.886178119
520	558	13	2	11	17.0442797346
520	561	9	3	6	32.0655328006
520	562	51	0	51	13.8115709177
520	563	4	0	4	39.0698714498
520	564	1	0	1	50.569401506
520	566	4	1	3	33.5680340308
520	567	3	0	3	35.1829646248
520	569	0	0	0	52.5892367997
520	571	0	0	0	31.5954293254
520	573	41	4	37	45.0303427215
520	577	1	0	1	62.2407960766
520	579	1	0	1	58.8677178332
520	581	1	1	0	59.228659422
520	585	2	0	2	62.0320661498
521	39	1	0	1	122.918401642
521	71	1	0	1	97.5814878212
521	73	11	0	11	105.275898719
521	74	0	0	0	101.55449928
521	77	2	0	2	109.096149495
521	78	1	0	1	101.875351703
521	79	1	0	1	108.894088786
521	81	2	0	2	107.351624003
521	82	2	0	2	104.206408565
521	87	0	0	0	100.442286023
521	88	1	0	1	98.6773736417
521	103	1	0	1	103.571111929
521	146	1	0	1	93.5004724675
521	155	1	0	1	94.8919319293
521	167	1	0	1	66.0840104503
521	168	1	0	1	86.9328665856
521	177	1	0	1	81.6910152683
521	245	1	0	1	127.429135477
521	264	1	0	1	137.307543999
521	277	1	0	1	155.420721556
521	320	1	0	1	74.3434887342
521	375	0	0	0	156.331952793
521	379	1	0	1	33.4314766341
521	381	2	0	2	20.3877858831
521	382	5	0	5	13.0891589743
521	385	2	0	2	33.4496160076
521	387	1	0	1	26.8133659023
521	389	1	0	1	17.7247660722
521	396	5	0	5	43.1087299645
521	398	2	0	2	20.6001098217
521	399	1	0	1	52.2913238297
521	401	3	0	3	32.1450078401
521	404	5	0	5	26.8216403739
521	405	1	0	1	36.5479620502
521	406	3	0	3	42.9422351651
521	408	42	2	40	37.3632076761
521	409	2	0	2	47.5884969913
521	410	3	1	2	37.3981080176
521	411	6	1	5	32.6782667495
521	417	2	0	2	34.41797829
521	423	1	0	1	54.7867608842
521	430	3	1	2	16.2243775313
521	437	1	0	1	40.3744643511
521	441	2	0	2	30.0401691215
521	442	1	0	1	38.8354650731
521	444	0	0	0	48.9269800181
521	448	1	0	1	46.3423685376
521	507	2	0	2	71.1480311984
521	512	3	0	3	34.4508380495
521	515	4	0	4	22.7309444756
521	516	7	0	7	23.9245311434
521	517	1	0	1	40.4437143836
521	520	58	15	43	8.67433514584
521	522	27	13	14	9.45982298059
521	523	6	4	2	14.8720768635
521	524	105	0	105	18.0581204987
521	525	3	0	3	22.7379945636
521	526	10	3	7	9.11116980711
521	528	10	0	10	7.49739418503
521	537	2	0	2	32.4947918921
521	538	1	0	1	34.1335827681
521	540	5	0	5	40.1543137952
521	543	1	0	1	68.5441814317
521	549	1	0	1	62.6072632803
521	554	2	0	2	31.0870900344
521	555	1	0	1	44.0143355325
521	558	4	0	4	23.1368706205
521	561	2	0	2	31.7121062558
521	562	3	1	2	16.9825823631
521	566	1	0	1	41.2826388049
521	573	10	0	10	51.9091705882
521	581	0	0	0	66.6228309432
521	586	1	0	1	70.4489045522
522	1	1	0	1	132.603888837
522	34	1	0	1	102.041156963
522	65	2	0	2	123.037716391
522	70	1	0	1	101.930351915
522	73	15	1	14	100.576499643
522	74	5	0	5	96.6418496683
522	75	3	0	3	98.5277038703
522	76	1	0	1	99.1809799434
522	78	1	0	1	96.8257714076
522	81	1	0	1	102.336903034
522	82	4	1	3	99.0997816939
522	84	1	0	1	99.1923000217
522	110	1	0	1	98.1416028291
522	113	1	0	1	94.7632905366
522	116	1	0	1	98.6813006371
522	163	0	0	0	65.3345003073
522	166	1	0	1	86.1612429297
522	167	0	0	0	61.1364279179
522	168	2	0	2	81.6256695931
522	172	2	0	2	77.5663270679
522	175	1	0	1	82.7931839343
522	177	6	0	6	76.0870345776
522	179	1	0	1	102.573664202
522	183	1	0	1	189.783089234
522	262	1	0	1	136.714703683
522	319	3	0	3	72.8826394164
522	377	0	0	0	132.970480973
522	381	4	2	2	17.5852545209
522	382	2	0	2	20.4859967357
522	383	3	0	3	20.7946764285
522	385	2	0	2	30.6691113508
522	388	1	0	1	27.8665763264
522	389	1	0	1	19.8580110846
522	390	1	0	1	39.0776378512
522	391	1	0	1	38.6641531751
522	395	1	0	1	23.4042434037
522	396	3	0	3	46.4828327308
522	402	1	0	1	26.0192584619
522	405	1	0	1	42.5765063246
522	406	2	0	2	47.6582210313
522	407	1	0	1	50.4598957305
522	408	31	0	31	42.042144632
522	411	14	0	14	36.2625280472
522	413	3	0	3	32.5334921287
522	414	1	0	1	55.4896226442
522	415	4	0	4	41.1905006612
522	418	1	0	1	31.0153154444
522	424	1	0	1	59.290589029
522	426	1	1	0	62.1286547801
522	430	1	0	1	25.4667997943
522	441	2	0	2	38.3697232389
522	442	1	0	1	46.8336327301
522	445	1	0	1	33.5637381301
522	507	10	0	10	70.7602954249
522	512	17	0	17	36.5159025556
522	514	1	0	1	47.339965225
522	515	1	0	1	27.6940198359
522	516	4	0	4	32.7544441231
522	517	3	0	3	39.0730379014
522	518	1	0	1	35.0595028115
522	519	4	2	2	27.8092535516
522	520	78	4	74	11.0954664723
522	521	17	4	13	9.45982298059
522	523	27	0	27	16.670736576
522	524	373	120	253	9.05333112949
522	525	13	0	13	15.4720559541
522	526	27	2	25	8.11499299251
522	527	2	1	1	19.0971932545
522	528	6	0	6	16.51523132
522	529	1	0	1	47.8737347949
522	530	1	0	1	57.0795588033
522	534	1	0	1	35.0476703805
522	535	1	0	1	46.3121239624
522	536	2	0	2	45.240110179
522	537	17	4	13	26.2693164917
522	538	1	0	1	25.9655714841
522	539	1	0	1	33.1509104163
522	540	11	0	11	35.7426363929
522	541	1	0	1	60.9407286731
522	548	0	0	0	78.0799760348
522	551	0	0	0	44.6173473551
522	554	11	2	9	22.0611629818
522	555	2	0	2	34.8794836163
522	557	0	0	0	22.2180587471
522	558	4	0	4	16.7551271467
522	561	22	0	22	22.4248370108
522	562	7	0	7	8.85537828589
522	563	1	0	1	35.5505153893
522	569	1	0	1	51.5331085659
522	571	2	0	2	31.9756746651
522	573	36	9	27	45.172684881
522	581	2	0	2	60.4085920932
522	585	1	0	1	57.0145005824
522	586	1	0	1	61.1162185437
523	1	1	0	1	148.831437836
523	36	1	1	0	125.90461787
523	71	1	0	1	109.325793877
523	73	16	1	15	117.247190213
523	74	1	0	1	113.308930264
523	75	2	0	2	115.196795072
523	76	1	0	1	115.815762041
523	78	2	0	2	113.485000454
523	80	0	0	0	119.246579109
523	81	1	0	1	118.997322521
523	84	2	0	2	115.863013731
523	85	1	0	1	112.096556018
523	86	1	0	1	108.893088798
523	88	2	0	2	110.59824215
523	112	3	0	3	118.648768799
523	158	0	0	0	89.9443786968
523	166	1	0	1	102.240680051
523	172	2	0	2	94.2289685711
523	177	3	0	3	92.6856014451
523	224	1	0	1	185.812215026
523	237	1	0	1	178.683952422
523	332	1	0	1	131.575526453
523	363	0	0	0	100.750554077
523	375	0	0	0	163.680209153
523	385	0	0	0	46.7590275466
523	394	1	0	1	46.1470620852
523	396	1	0	1	57.8609373004
523	401	1	0	1	46.2093079432
523	406	3	1	2	57.2781575444
523	408	12	0	12	51.7776192243
523	411	2	0	2	47.4486498515
523	415	2	0	2	53.7363520917
523	416	2	0	2	56.9825680095
523	417	1	1	0	49.2895913091
523	433	1	0	1	42.743767443
523	438	1	0	1	38.7192952282
523	441	1	0	1	41.0593386753
523	442	0	0	0	50.0996900883
523	507	5	2	3	56.2767343384
523	510	1	0	1	40.4275319229
523	512	37	10	27	20.1157789024
523	513	5	1	4	11.8402635312
523	514	1	0	1	32.8443650663
523	515	27	0	27	12.0195782119
523	516	7	0	7	23.9288922045
523	517	2	0	2	25.8197205966
523	518	1	0	1	21.9581405956
523	519	10	4	6	16.6900141209
523	520	3	1	2	23.1664368361
523	521	8	2	6	14.8720768635
523	522	9	0	9	16.670736576
523	524	70	6	64	19.2671896938
523	525	3	0	3	17.9122403376
523	526	11	1	10	8.55631051461
523	527	28	1	27	11.0951852784
523	528	7	3	4	14.2181435074
523	529	2	0	2	43.2199684815
523	535	1	0	1	37.1789080313
523	536	0	0	0	44.1610514945
523	537	18	0	18	23.4251606969
523	540	19	1	18	27.7836703038
523	542	1	1	0	55.8917938108
523	548	0	0	0	66.2468530683
523	554	1	0	1	36.2587589896
523	555	1	0	1	48.0708787723
523	561	3	1	2	31.1247299361
523	562	3	1	2	25.2296192652
523	569	1	0	1	67.3735815808
523	573	11	6	5	61.4950566691
523	581	0	0	0	76.8748529926
524	36	0	0	0	110.813000688
524	50	1	0	1	112.22403672
524	70	6	0	6	101.347838931
524	71	3	0	3	92.5593562486
524	73	100	5	95	100.666467124
524	74	8	0	8	96.520364348
524	75	10	0	10	98.7404808607
524	76	4	0	4	98.6112788836
524	78	12	0	12	96.544631322
524	81	6	0	6	102.053643765
524	82	13	1	12	98.7341401741
524	83	3	0	3	99.4125849386
524	84	9	0	9	99.2488351006
524	85	1	0	1	94.8610508767
524	86	2	0	2	91.9305469015
524	87	9	0	9	95.9324290749
524	88	2	0	2	94.0147356435
524	92	1	0	1	106.241286863
524	95	1	0	1	106.566499476
524	103	1	0	1	99.9426703386
524	106	1	0	1	117.307405918
524	113	4	0	4	95.3586863991
524	131	1	0	1	90.2151313284
524	142	2	0	2	87.3694764912
524	144	1	0	1	82.2898509963
524	154	1	0	1	75.1848407133
524	155	2	0	2	87.0073346695
524	156	1	0	1	91.4831861488
524	158	1	0	1	72.2341748304
524	159	1	0	1	77.109896185
524	165	1	0	1	69.8001033899
524	166	2	0	2	83.6742499711
524	168	6	0	6	81.1871945159
524	169	1	0	1	97.6212639068
524	171	1	0	1	86.7746558504
524	172	8	0	8	77.4436677856
524	177	25	3	22	75.355468171
524	183	1	0	1	188.600237588
524	277	1	0	1	149.280133885
524	280	1	0	1	156.565356603
524	281	0	0	0	140.015958962
524	310	1	0	1	121.150235869
524	319	12	3	9	68.7291338895
524	320	1	0	1	61.9790413108
524	321	1	1	0	76.9604891161
524	323	1	0	1	64.8798239581
524	327	1	0	1	71.5498773193
524	329	2	0	2	85.4063188224
524	332	0	0	0	112.311826291
524	338	0	0	0	101.082512866
524	346	1	1	0	181.138801234
524	349	3	0	3	89.2464262957
524	353	1	0	1	100.718257828
524	356	3	1	2	77.2117122301
524	357	1	0	1	85.7787214102
524	358	1	0	1	75.0735607786
524	366	1	0	1	67.3976030983
524	375	0	0	0	144.47191157
524	379	3	0	3	38.2885118362
524	381	3	1	2	22.6561450939
524	382	2	0	2	29.5248995736
524	383	3	1	2	29.4709600737
524	385	3	1	2	34.3771300865
524	387	2	0	2	29.5378467591
524	388	1	0	1	34.4789833947
524	389	3	0	3	27.5832785374
524	391	1	0	1	43.3055088305
524	392	2	0	2	39.3070452497
524	394	1	0	1	38.8612110532
524	396	2	0	2	53.8991496658
524	398	2	0	2	37.5167068561
524	399	1	0	1	64.6732575388
524	400	1	0	1	51.7775700847
524	401	2	0	2	46.2234493155
524	402	2	0	2	34.6294731009
524	404	2	0	2	39.857356429
524	406	6	3	3	55.7119793969
524	407	7	0	7	58.0801132981
524	408	70	5	65	50.1455296291
524	410	2	0	2	48.7858763481
524	411	15	0	15	43.9746011458
524	412	1	0	1	54.4990782436
524	414	2	0	2	63.774132252
524	415	4	0	4	48.1323028686
524	416	1	0	1	57.8495451335
524	417	2	0	2	43.6691837633
524	421	1	0	1	65.3888259209
524	427	1	0	1	58.4480777499
524	433	1	0	1	55.3743058854
524	436	1	0	1	74.9982802342
524	438	3	0	3	47.2617168461
524	441	0	0	0	47.4224674298
524	442	1	0	1	55.8722057833
524	445	1	0	1	41.7627352138
524	453	1	0	1	50.7173200855
524	455	1	0	1	54.2922958257
524	460	0	0	0	54.1658702578
524	471	2	0	2	101.205210119
524	475	1	0	1	67.5940795565
524	503	1	0	1	63.1372089233
524	507	58	0	58	67.5873787272
524	509	1	0	1	77.0969731676
524	510	1	0	1	51.9994641587
524	511	1	0	1	74.1247012465
524	512	55	1	54	36.7715126052
524	515	2	0	2	31.2785624651
524	516	1	0	1	39.8311061499
524	517	4	0	4	35.8848833378
524	518	1	0	1	40.4610221921
524	519	15	1	14	24.3513350049
524	520	56	0	56	19.725012198
524	521	31	7	24	18.0581204987
524	522	54	6	48	9.05333112949
524	523	35	6	29	19.2671896938
524	525	55	30	25	8.15494916075
524	526	17	1	16	12.433153847
524	527	19	6	13	16.0464061621
524	528	5	0	5	24.3554326956
524	529	10	1	9	40.1272274715
524	530	2	0	2	48.5720998697
524	531	1	0	1	30.1917879353
524	532	1	0	1	46.1142527704
524	533	2	0	2	47.2038792076
524	534	6	1	5	26.7969501753
524	535	7	0	7	40.3589909909
524	536	9	0	9	36.6513277761
524	537	49	5	44	19.059859305
524	538	6	1	5	17.1114340033
524	539	10	0	10	24.1023638965
524	540	75	0	75	29.8027390613
524	546	1	0	1	69.9252968453
524	548	1	0	1	72.838229359
524	551	1	0	1	39.8492092307
524	552	8	0	8	30.7314809732
524	554	48	0	48	17.1006879673
524	555	15	3	12	28.8510553707
524	556	1	0	1	40.1985997917
524	557	2	0	2	20.3025202501
524	558	8	1	7	18.2045367527
524	559	1	0	1	24.4050452856
524	560	1	0	1	38.2376235707
524	561	163	47	116	13.7214255609
524	562	38	1	37	10.2057883526
524	563	5	0	5	31.4199951105
524	565	2	0	2	50.301817852
524	566	7	3	4	36.9296967323
524	567	7	0	7	31.0270537765
524	568	1	0	1	52.7063751429
524	571	2	0	2	31.4184085996
524	572	1	0	1	49.4592998143
524	573	171	9	162	43.5754739391
524	576	0	0	0	63.3254991925
524	577	1	0	1	57.7160187016
524	578	1	0	1	45.9223000907
524	579	1	0	1	55.6546006015
524	581	7	0	7	59.1454612269
524	585	5	0	5	50.9315315071
524	586	1	0	1	54.0093651977
525	1	1	0	1	142.336416393
525	70	3	0	3	107.795528185
525	73	30	0	30	107.459277093
525	74	4	0	4	103.222357852
525	75	2	0	2	105.597474893
525	76	0	0	0	105.074995139
525	78	5	0	5	103.166154426
525	79	1	0	1	110.688492249
525	82	3	0	3	105.304920891
525	83	2	0	2	106.127964824
525	84	3	0	3	106.0296525
525	85	1	0	1	101.318335134
525	87	2	0	2	102.773337383
525	89	1	0	1	117.831984203
525	103	1	0	1	106.977430587
525	109	1	0	1	107.057798849
525	110	1	0	1	106.340023034
525	127	0	0	0	95.7665237987
525	165	1	0	1	76.3012731687
525	166	1	0	1	89.0332058482
525	168	1	0	1	87.7899258817
525	169	1	0	1	103.182046177
525	171	1	0	1	92.9832063582
525	172	4	0	4	84.2211141373
525	174	1	0	1	73.0694520858
525	177	6	0	6	81.8362334291
525	178	2	0	2	66.8570986051
525	284	1	0	1	153.635908258
525	319	1	0	1	72.9130571817
525	338	0	0	0	104.62088909
525	339	1	0	1	111.752523793
525	349	1	0	1	93.2665564564
525	356	1	0	1	78.9910866712
525	382	0	0	0	35.3869491742
525	383	1	0	1	36.2369997856
525	385	4	1	3	42.4866475394
525	387	1	0	1	37.6898858431
525	389	2	0	2	35.1012644361
525	395	1	0	1	37.6837368888
525	401	1	0	1	53.1864931794
525	404	1	0	1	47.0262282232
525	406	1	0	1	63.0853063061
525	407	6	0	6	65.7211284543
525	408	11	1	10	57.4781706395
525	409	1	0	1	68.0211444635
525	411	1	0	1	51.5486427818
525	417	1	0	1	51.5342365445
525	426	1	0	1	75.6970352959
525	441	0	0	0	52.7765876085
525	442	1	0	1	61.53096306
525	503	0	0	0	71.034811493
525	507	25	3	22	60.0477709592
525	509	1	0	1	69.3080801837
525	512	16	10	6	31.7389954687
525	515	1	0	1	29.3888535715
525	517	1	0	1	28.6293011424
525	519	9	0	9	17.3163361089
525	520	5	1	4	26.5667751785
525	521	2	0	2	22.7379945636
525	522	8	0	8	15.4720559541
525	523	10	0	10	17.9122403376
525	524	334	113	221	8.15494916075
525	526	4	1	3	14.5457731926
525	527	8	2	6	10.2247179028
525	528	0	0	0	27.4738465491
525	529	6	0	6	32.4492999273
525	530	2	1	1	41.7297880323
525	534	6	2	4	19.6267226503
525	535	3	0	3	32.2078828823
525	536	8	0	8	29.9967695705
525	537	63	0	63	11.0162465718
525	538	4	1	3	11.6946960396
525	539	4	0	4	20.4294472463
525	540	57	1	56	21.6662086904
525	541	2	0	2	46.3794010539
525	542	1	0	1	55.5478964093
525	543	0	0	0	48.0875353847
525	548	3	0	3	64.725234175
525	549	1	0	1	48.3504973491
525	552	5	2	3	29.3813764528
525	553	1	0	1	34.0218680586
525	554	13	1	12	22.3932487855
525	555	4	0	4	32.1509249832
525	556	1	0	1	36.7087300506
525	558	1	0	1	26.1849312091
525	561	92	78	14	13.6991494572
525	562	5	1	4	18.356907827
525	563	3	1	2	36.4029326482
525	566	1	0	1	44.4237889991
525	569	1	0	1	54.1997308656
525	570	1	0	1	56.0127684268
525	571	0	0	0	38.495427789
525	573	51	6	45	49.905535533
525	578	0	0	0	53.3896464521
525	581	5	1	4	65.4592474703
525	585	0	0	0	53.4201388705
526	1	1	0	1	140.474180746
526	48	1	0	1	111.903930906
526	73	7	0	7	108.691037933
526	74	2	0	2	104.756086892
526	76	1	0	1	107.281314924
526	78	2	0	2	104.936988152
526	79	1	0	1	112.182653572
526	81	1	0	1	110.448630787
526	85	0	0	0	103.565231075
526	86	1	0	1	100.346786899
526	87	1	0	1	103.885558277
526	92	1	0	1	114.972210143
526	96	1	0	1	106.7988311
526	107	1	0	1	92.9153622345
526	111	1	0	1	120.078604116
526	116	1	0	1	106.767642605
526	119	1	0	1	99.8700769422
526	168	1	0	1	89.7283058742
526	172	2	0	2	85.6788595295
526	177	3	0	3	84.169444601
526	385	0	0	0	38.4216804226
526	395	2	0	2	30.1451401473
526	396	1	0	1	51.6135478575
526	401	1	0	1	41.1754782962
526	406	1	0	1	51.8405816698
526	408	14	1	13	46.2338319389
526	411	4	0	4	41.1967651864
526	413	1	0	1	35.03948668
526	415	1	0	1	46.9330261781
526	416	1	0	1	52.4687351171
526	426	1	0	1	61.2312905586
526	430	1	0	1	21.4610312512
526	435	1	0	1	44.0188516127
526	439	1	0	1	38.2192409279
526	442	1	0	1	47.6616717203
526	507	2	0	2	63.6102269702
526	510	1	0	1	47.6967611584
526	512	4	0	4	28.5055113793
526	515	1	0	1	19.8415175505
526	516	4	1	3	27.509298006
526	517	2	0	2	32.2684655552
526	518	2	0	2	28.1746427573
526	519	1	0	1	21.5683271374
526	520	9	0	9	15.9241517263
526	521	6	0	6	9.11116980711
526	522	33	7	26	8.11499299251
526	523	43	7	36	8.55631051461
526	524	88	28	60	12.433153847
526	525	4	0	4	14.5457731926
526	527	3	0	3	13.386322147
526	528	2	0	2	12.9308355493
526	535	1	0	1	41.3390182722
526	536	1	0	1	44.0035144215
526	537	4	0	4	23.5589412363
526	538	1	0	1	26.2292217709
526	540	6	0	6	31.0757721799
526	549	1	0	1	54.2769683457
526	554	2	0	2	28.6761961607
526	561	3	0	3	25.7527235625
526	562	6	3	3	16.764448303
526	563	1	0	1	42.6984042177
526	564	0	0	0	49.3325915434
526	573	14	2	12	53.1046900762
526	581	0	0	0	68.4221128661
527	12	1	0	1	155.796298962
527	71	1	0	1	108.589295561
527	73	3	0	3	116.705742429
527	74	1	0	1	112.547044621
527	77	1	0	1	120.019006127
527	78	2	0	2	112.556130378
527	81	2	0	2	118.062090798
527	82	1	0	1	114.734557912
527	83	1	0	1	115.441798798
527	87	1	0	1	111.975494358
527	113	1	0	1	111.400362916
527	157	1	0	1	86.5040556045
527	166	0	0	0	99.0615908478
527	171	1	0	1	102.649891089
527	177	2	0	2	91.3245378944
527	183	1	0	1	204.368179148
527	280	1	0	1	172.415993696
527	310	1	0	1	135.807391515
527	319	3	0	3	83.1296516991
527	348	0	0	0	121.868648685
527	382	1	1	0	35.437851244
527	389	0	0	0	38.4131457519
527	396	1	0	1	64.8575509975
527	402	1	0	1	42.9651176058
527	406	2	0	2	65.2231025128
527	408	6	1	5	59.6132222989
527	411	1	0	1	54.4678462019
527	415	1	0	1	59.9518731467
527	417	1	0	1	55.4164744469
527	441	0	0	0	51.216355911
527	442	0	0	0	60.234225506
527	444	0	0	0	70.3287440958
527	460	1	0	1	67.951338886
527	475	0	0	0	81.620508502
527	507	14	0	14	51.9968656263
527	509	2	0	2	61.9001975079
527	510	2	1	1	36.2301162977
527	511	1	0	1	58.6485071125
527	512	61	10	51	21.5181467995
527	513	5	0	5	11.8596281932
527	515	9	0	9	20.6303506354
527	516	0	0	0	34.895726251
527	517	3	2	1	20.1925073703
527	518	1	0	1	31.7521777149
527	519	60	6	54	8.74110099548
527	520	1	0	1	29.0269524798
527	522	2	0	2	19.0971932545
527	523	25	12	13	11.0951852784
527	524	75	3	72	16.0464061621
527	525	7	0	7	10.2247179028
527	526	2	0	2	13.386322147
527	528	1	0	1	24.373743254
527	529	2	0	2	32.4204581876
527	534	1	0	1	22.5168233572
527	535	10	0	10	27.9527049774
527	536	1	0	1	33.0705782275
527	537	22	1	21	12.3929969832
527	539	0	0	0	28.294976022
527	540	42	33	9	17.7533496838
527	548	1	0	1	59.0776607101
527	549	2	0	2	41.5757212016
527	554	0	0	0	32.2820108046
527	555	1	0	1	42.3753358311
527	558	1	0	1	33.7957379883
527	561	7	0	7	23.7476129755
527	566	1	0	1	52.8825065396
527	568	1	0	1	68.7289100327
527	573	8	4	4	59.4664633791
528	1	1	0	1	140.438748937
528	46	1	0	1	128.405050017
528	70	2	0	2	113.900905404
528	73	6	0	6	111.733809877
528	74	1	0	1	108.112243326
528	78	0	0	0	108.490141639
528	81	2	0	2	113.941718968
528	82	2	0	2	110.840599517
528	84	1	0	1	110.408585101
528	85	0	0	0	107.536902645
528	113	2	0	2	105.335771625
528	148	2	0	2	102.941432445
528	166	1	0	1	100.275254602
528	171	1	0	1	100.626045518
528	172	1	0	1	89.3197158712
528	175	1	0	1	95.5924661581
528	177	2	0	2	88.5654125173
528	183	1	0	1	201.984434216
528	319	1	0	1	88.3787592788
528	349	1	0	1	108.775717694
528	381	1	0	1	26.982286111
528	382	17	0	17	13.4800141217
528	385	3	0	3	39.5885358625
528	389	0	0	0	22.2513928123
528	391	1	0	1	45.0604104696
528	396	4	0	4	45.1771568491
528	397	2	0	2	47.2553780511
528	398	7	1	6	18.9480189393
528	401	7	2	5	32.600765228
528	404	2	0	2	28.4411606599
528	405	3	1	2	36.3137497945
528	406	7	0	7	43.8275504959
528	407	1	0	1	48.1342093903
528	408	114	7	107	38.476340652
528	409	2	0	2	48.0876602547
528	410	3	0	3	39.3765042198
528	411	7	0	7	34.969605447
528	413	4	1	3	25.6064481869
528	414	1	0	1	50.1158671813
528	415	2	0	2	41.8929534983
528	417	3	2	1	37.6762938908
528	418	1	0	1	30.9537422594
528	425	1	0	1	39.1356552182
528	427	2	0	2	41.1101862927
528	430	20	2	18	8.97634879852
528	433	2	0	2	31.2046455842
528	435	3	0	3	32.9102820356
528	437	1	0	1	32.913538417
528	438	4	0	4	24.9889038126
528	439	3	0	3	25.2993994636
528	440	4	2	2	16.3930973953
528	441	3	1	2	26.9202741791
528	442	5	0	5	35.9595811097
528	443	2	0	2	37.9932285109
528	445	4	1	3	17.4373279196
528	446	1	0	1	32.051848706
528	475	1	0	1	66.4754857968
528	507	6	1	5	68.914433956
528	512	11	3	8	31.2048664355
528	515	11	1	10	17.8383033521
528	516	28	0	28	16.4315333922
528	517	1	0	1	39.6531767524
528	518	4	1	3	20.6920312225
528	519	0	0	0	30.897673867
528	520	32	5	27	14.7291422602
528	521	16	0	16	7.49739418503
528	522	5	2	3	16.51523132
528	523	12	1	11	14.2181435074
528	524	37	9	28	24.3554326956
528	525	3	1	2	27.4738465491
528	526	7	0	7	12.9308355493
528	527	1	0	1	24.373743254
528	537	3	1	2	35.9133926892
528	540	2	1	1	41.8057928128
528	548	0	0	0	80.0957984321
528	554	0	0	0	38.4562948898
528	561	0	0	0	38.0595712629
528	563	0	0	0	51.4453895885
528	573	6	0	6	59.2004996215
528	581	1	0	1	73.7369689244
528	585	2	0	2	73.4284442511
529	70	2	0	2	127.822463588
529	73	14	1	13	129.087450038
529	74	2	0	2	124.541240783
529	75	2	0	2	127.576294044
529	76	0	0	0	125.254226177
529	78	2	0	2	124.117545567
529	82	1	0	1	125.962862788
529	84	2	0	2	127.638463614
529	85	2	0	2	121.584632722
529	86	1	0	1	119.66226598
529	87	1	0	1	124.750457022
529	88	1	0	1	122.7223289
529	155	1	0	1	111.00319759
529	164	1	0	1	112.74794831
529	166	2	0	2	105.165651038
529	168	1	0	1	109.170096665
529	171	0	0	0	112.458847288
529	177	3	0	3	102.937794131
529	247	1	0	1	140.308945203
529	277	0	0	0	173.253388603
529	319	3	0	3	85.5929303465
529	327	1	0	1	85.2611161632
529	338	2	0	2	112.600604191
529	347	1	0	1	115.559625828
529	364	0	0	0	84.7996839873
529	375	0	0	0	155.856833829
529	385	0	0	0	72.8377646
529	392	0	0	0	77.5166623133
529	401	1	0	1	85.4850760782
529	406	1	0	1	95.5255384407
529	407	1	0	1	98.1440645938
529	408	4	0	4	89.9132773501
529	411	2	0	2	83.9860239183
529	415	1	0	1	88.24656598
529	419	0	0	0	85.9398783805
529	421	1	0	1	103.498767741
529	442	1	0	1	92.5221537674
529	447	0	0	0	109.049984286
529	493	5	0	5	135.550895103
529	507	101	6	95	44.083381363
529	508	1	0	1	38.6292500901
529	509	5	1	4	49.2017366895
529	510	1	0	1	34.6630761716
529	511	2	0	2	48.5541691933
529	512	25	1	24	41.0368095451
529	514	5	1	4	32.384842932
529	515	1	0	1	49.4941336639
529	516	1	0	1	66.018026024
529	517	5	0	5	27.3118332291
529	519	7	3	4	27.7089704201
529	524	23	2	21	40.1272274715
529	525	3	1	2	32.4492999273
529	527	1	0	1	32.4204581876
529	528	1	0	1	56.7816241436
529	530	50	2	48	12.8623569096
529	531	2	0	2	21.094649173
529	532	10	4	6	7.94590240921
529	533	3	0	3	23.5053891441
529	534	36	5	31	13.8147719175
529	535	76	3	73	13.4234081816
529	536	58	32	26	9.85606664015
529	537	39	2	37	21.6603826205
529	538	1	0	1	24.6663090897
529	539	1	0	1	25.2436751246
529	540	384	210	174	16.2518477056
529	541	8	0	8	18.1736982758
529	542	6	2	4	33.5571998053
529	543	15	0	15	16.4133230145
529	547	2	0	2	25.3581566548
529	548	15	1	14	39.2298983498
529	549	10	0	10	29.734757814
529	552	5	0	5	33.8882482383
529	553	11	0	11	17.9163151046
529	554	3	0	3	47.0503697869
529	555	5	1	4	49.0194590521
529	556	1	0	1	28.5603739331
529	559	1	0	1	40.8164166888
529	561	5	1	4	34.1410105932
529	565	3	0	3	23.7083153696
529	566	1	0	1	71.6472147596
529	573	23	6	17	72.5168305286
529	577	0	0	0	79.5611671815
529	579	0	0	0	79.8197190882
529	581	0	0	0	86.7733630718
530	70	2	0	2	126.871753526
530	73	13	1	12	128.879096762
530	74	2	0	2	124.255319649
530	76	0	0	0	124.416588623
530	78	2	0	2	123.662791884
530	79	1	0	1	131.300292778
530	84	1	0	1	127.443048118
530	87	1	0	1	124.781066706
530	88	1	0	1	122.746511735
530	96	1	0	1	118.736579925
530	103	1	0	1	130.141038135
530	107	1	0	1	114.271681816
530	113	0	0	0	125.839764238
530	118	1	0	1	119.145897643
530	140	0	0	0	125.960802128
530	142	1	0	1	122.662817325
530	144	1	0	1	116.246169379
530	146	0	0	0	119.735372621
530	155	2	0	2	109.504191053
530	164	1	0	1	112.421873676
530	177	2	1	1	102.985467526
530	287	1	0	1	169.251547457
530	320	1	0	1	76.9703850179
530	325	1	0	1	72.1034795484
530	329	1	0	1	101.111772661
530	338	0	0	0	107.000605502
530	342	1	0	1	110.751123607
530	356	1	0	1	75.3950948994
530	364	2	0	2	79.7695757946
530	385	0	0	0	78.7974443388
530	408	5	0	5	98.6973502061
530	411	0	0	0	92.3937978259
530	413	1	0	1	89.5508691139
530	427	1	0	1	106.579063438
530	431	1	0	1	108.24960172
530	441	0	0	0	94.1767533614
530	475	1	0	1	112.042088508
530	507	29	0	29	53.1133298519
530	508	1	0	1	48.8912985119
530	509	1	0	1	56.1504259518
530	512	8	3	5	53.8948248003
530	515	6	1	5	61.9373101773
530	517	1	0	1	40.1373990285
530	519	2	0	2	40.0919369561
530	522	1	0	1	57.0795588033
530	523	2	0	2	54.8104286019
530	524	7	0	7	48.5720998697
530	527	1	0	1	43.7656517454
530	529	65	9	56	12.8623569096
530	531	2	0	2	22.0827865149
530	532	3	1	2	16.280718016
530	533	1	0	1	34.7062065588
530	534	12	0	12	22.1305724885
530	535	19	0	19	25.6224043576
530	536	69	24	45	11.9532637087
530	537	12	0	12	31.9204745379
530	539	3	0	3	28.2863866363
530	540	121	0	121	28.8785734672
530	541	4	0	4	24.1173492888
530	542	3	0	3	40.9653997912
530	543	17	2	15	17.6176347674
530	544	3	0	3	35.7845934636
530	546	1	0	1	47.4984105983
530	547	2	0	2	31.7908204639
530	548	3	0	3	43.820072471
530	549	4	0	4	39.1572503049
530	552	3	0	3	33.2703946036
530	553	13	0	13	13.6837233511
530	554	0	0	0	51.631012739
530	555	2	0	2	50.3256954184
530	556	5	0	5	23.6855254802
530	561	1	0	1	39.5184075954
530	563	1	0	1	58.6449033038
530	565	25	6	19	12.9835668094
530	566	2	0	2	75.74266719
530	569	0	0	0	73.7494831849
530	573	11	1	10	74.3252757312
530	581	3	0	3	87.3956208551
530	586	1	0	1	53.7332527118
531	1	4	0	4	147.387204543
531	36	1	0	1	121.990491249
531	73	12	0	12	108.323158869
531	74	1	0	1	103.747950892
531	76	0	0	0	104.317586401
531	78	1	0	1	103.274843069
531	81	2	0	2	108.478141455
531	82	0	0	0	105.077136853
531	84	2	0	2	106.876689786
531	85	2	0	2	100.668026359
531	86	1	0	1	98.8580786512
531	87	1	0	1	104.060819242
531	95	1	0	1	115.441562878
531	112	1	0	1	112.312360509
531	113	1	0	1	104.831463141
531	122	1	0	1	110.417735739
531	124	1	0	1	110.458508034
531	142	1	0	1	100.937462977
531	146	1	0	1	98.6998067985
531	155	1	0	1	89.9460157597
531	168	1	0	1	88.4603947673
531	169	2	0	2	98.4130876752
531	177	0	0	0	82.2221519545
531	319	1	0	1	64.5911471329
531	323	1	0	1	65.4353445877
531	349	1	0	1	83.1516213847
531	408	1	0	1	79.1095943249
531	439	1	0	1	78.2870806559
531	507	4	0	4	63.7365220842
531	512	1	0	1	49.7023188458
531	519	1	0	1	33.0598081998
531	524	8	1	7	30.1917879353
531	525	1	0	1	25.5466932704
531	529	8	0	8	21.094649173
531	530	3	0	3	22.0827865149
531	534	5	0	5	12.6174000465
531	535	1	0	1	31.3154384519
531	536	17	2	15	11.8597615937
531	537	8	1	7	20.3028268488
531	538	2	0	2	13.8527954216
531	539	17	5	12	6.62476716597
531	540	19	1	18	26.2641268392
531	542	1	0	1	54.2910873521
531	543	1	0	1	36.2318139344
531	547	1	0	1	46.4093317258
531	548	1	0	1	60.3234329467
531	552	10	4	6	12.797252118
531	553	24	12	12	9.74211949736
531	554	2	0	2	29.7740199821
531	555	2	1	1	28.652958924
531	556	15	2	13	11.9130970361
531	559	3	0	3	20.7185075717
531	561	5	1	4	18.5038569888
531	563	1	0	1	36.8122230647
531	565	2	0	2	20.2451529841
531	566	1	0	1	53.6745449424
531	573	11	1	10	52.5834347508
531	576	1	0	1	66.8132701099
531	581	0	0	0	66.2466324599
531	585	2	0	2	41.6329238112
532	36	1	0	1	150.085771231
532	73	1	0	1	136.985264189
532	75	1	0	1	135.46100378
532	76	1	0	1	133.185331148
532	78	0	0	0	132.03169688
532	83	1	0	1	135.335428703
532	84	1	0	1	135.535936252
532	87	0	0	0	132.633053214
532	117	0	0	0	131.094618917
532	166	1	0	1	113.100763166
532	177	0	0	0	110.8300577
532	245	1	0	1	155.209492675
532	253	1	0	1	160.081458243
532	319	0	0	0	93.4771952395
532	338	1	0	1	120.16183548
532	385	1	0	1	79.5856574853
532	392	1	0	1	84.3449613912
532	408	1	0	1	95.1722912065
532	411	0	0	0	89.5115599729
532	426	0	0	0	107.643570476
532	473	1	0	1	120.827294057
532	507	25	2	23	37.3034495957
532	509	2	0	2	41.6355767689
532	512	5	2	3	40.6190992843
532	517	2	0	2	26.321152011
532	520	1	0	1	64.1691348701
532	526	1	0	1	49.3988960205
532	527	1	0	1	36.2460499926
532	529	52	5	47	7.94590240921
532	530	6	1	5	16.280718016
532	533	1	0	1	18.541412111
532	534	1	0	1	20.9635260722
532	535	15	0	15	10.8479030723
532	536	4	1	3	17.5879755847
532	537	3	1	2	27.114247784
532	538	1	0	1	31.7239813135
532	540	40	4	36	18.6308446995
532	541	1	0	1	10.2280008222
532	542	4	0	4	26.0277358078
532	543	7	2	5	10.0504410144
532	547	1	0	1	17.5182737162
532	548	1	0	1	31.2904606419
532	549	4	0	4	23.103438214
532	552	0	0	0	41.8224855909
532	553	1	0	1	25.1041827478
532	554	0	0	0	54.4064491357
532	561	2	0	2	41.4538636617
532	565	1	0	1	28.8993271244
532	573	5	0	5	80.2687433002
533	50	1	0	1	159.421615365
533	72	1	0	1	148.081690527
533	73	2	0	2	145.372716736
533	74	1	0	1	140.986661922
533	75	2	0	2	143.639514683
533	78	2	0	2	140.774549456
533	79	2	0	2	148.406209715
533	82	1	0	1	142.798079007
533	84	1	0	1	143.92793285
533	87	0	0	0	140.800096258
533	103	1	0	1	145.327754076
533	142	0	0	0	134.009534672
533	177	1	0	1	119.354373739
533	320	1	0	1	99.0839811892
533	338	0	0	0	134.302462302
533	408	4	0	4	91.4436196274
533	411	0	0	0	86.7544987894
533	425	1	0	1	92.0831803724
533	441	1	0	1	79.8958865193
533	442	0	0	0	88.8235980013
533	454	1	0	1	99.4777485831
533	471	1	0	1	147.135187573
533	476	1	1	0	142.883449778
533	507	140	22	118	22.159624657
533	508	2	0	2	15.4575691067
533	509	12	0	12	30.2019842991
533	510	7	0	7	11.3530494468
533	511	10	1	9	27.9312457697
533	512	28	0	28	26.8123708189
533	513	1	0	1	28.7471004484
533	514	6	0	6	11.9390029663
533	515	2	1	1	39.9694210748
533	516	2	0	2	57.0664749692
533	517	9	1	8	14.1334488891
533	519	1	0	1	24.0870824201
533	524	2	0	2	47.2038792076
533	528	1	0	1	53.7314946448
533	529	7	0	7	23.5053891441
533	530	2	0	2	34.7062065588
533	534	4	0	4	30.0733200917
533	535	48	6	42	10.6039192119
533	536	0	0	0	32.6827793514
533	537	9	0	9	29.9043566822
533	540	50	0	50	18.3558686253
533	541	6	2	4	16.0578103784
533	542	17	0	17	16.5119152041
533	543	3	1	2	23.8156313754
533	547	6	0	6	15.0113111283
533	548	19	1	18	26.5445097618
533	549	40	11	29	9.08100024099
533	550	2	0	2	31.1065238492
533	554	1	0	1	60.171411748
533	556	1	0	1	51.3803660157
533	561	1	0	1	47.9408180127
533	573	2	0	2	87.6637211628
533	575	1	0	1	82.0237112068
533	581	1	0	1	102.89315331
533	585	1	0	1	83.0949524249
534	70	2	0	2	115.956663423
534	71	1	0	1	108.538904156
534	73	14	0	14	116.809743309
534	74	1	0	1	112.322721365
534	75	1	0	1	115.20488901
534	76	1	0	1	113.335526903
534	78	3	0	3	111.991156066
534	82	3	1	2	113.921155822
534	85	0	0	0	109.624700402
534	87	2	0	2	112.368029405
534	88	0	0	0	110.351427136
534	103	2	0	2	117.214425238
534	113	4	0	4	112.726605817
534	119	1	0	1	105.013596822
534	142	1	0	1	107.396943164
534	163	1	0	1	87.650201807
534	164	1	0	1	100.608083038
534	165	1	0	1	85.3452657535
534	168	2	0	2	96.8583712025
534	172	2	0	2	93.9593975618
534	177	2	0	2	90.6556986246
534	228	1	0	1	182.988194828
534	307	1	0	1	154.228534905
534	319	3	0	3	75.5000347598
534	323	1	0	1	75.2877073884
534	325	1	0	1	65.1856525673
534	338	0	0	0	104.430400123
534	341	1	0	1	116.888374984
534	349	1	0	1	94.6551230916
534	357	1	0	1	89.4493918692
534	373	2	0	2	133.928133601
534	385	1	0	1	59.0263897838
534	395	1	0	1	56.2023935586
534	396	1	0	1	80.6501334369
534	408	6	0	6	76.9009029587
534	411	0	0	0	70.7712927533
534	424	2	0	2	87.7654397531
534	441	0	0	0	72.0978656588
534	443	0	0	0	82.9215096418
534	460	0	0	0	79.6345810984
534	475	1	0	1	92.6075485365
534	507	51	0	51	52.2043498334
534	509	2	0	2	59.2425747415
534	512	18	1	17	37.6553254254
534	515	2	0	2	42.2975222398
534	519	7	0	7	21.3581358578
534	520	0	0	0	46.1343808097
534	522	1	0	1	35.0476703805
534	523	2	0	2	33.5815221973
534	524	19	4	15	26.7969501753
534	525	3	0	3	19.6267226503
534	526	1	0	1	33.3840329625
534	527	4	1	3	22.5168233572
534	529	60	6	54	13.8147719175
534	530	13	1	12	22.1305724885
534	531	1	0	1	12.6174000465
534	532	1	0	1	20.9635260722
534	535	22	8	14	19.8810788094
534	536	43	13	30	10.6673378373
534	537	88	1	87	10.1672263066
534	538	11	1	10	10.8564678904
534	539	6	0	6	13.5174206144
534	540	241	3	238	13.6494049688
534	541	2	0	2	30.7231661274
534	542	2	1	1	43.9232203632
534	543	1	0	1	30.2004765741
534	545	1	0	1	55.480332481
534	548	4	0	4	51.2260730165
534	549	7	0	7	38.3371544206
534	552	4	0	4	24.0783888392
534	553	10	1	9	16.8392141215
534	554	4	0	4	33.4429464871
534	555	5	0	5	36.7887906903
534	559	2	0	2	28.5755181172
534	561	6	1	5	20.4904470282
534	563	2	0	2	44.0475538937
534	565	2	0	2	27.1204785637
534	567	1	0	1	47.5196240821
534	571	1	1	0	51.1429016452
534	573	19	1	18	59.6230107345
534	585	2	0	2	53.0447790276
535	71	0	0	0	127.948956561
535	73	3	0	3	136.216589146
535	74	3	0	3	131.774188072
535	76	0	0	0	132.945760892
535	78	2	0	2	131.497612727
535	82	1	0	1	133.47088471
535	84	0	0	0	134.768128893
535	85	1	0	1	129.220260514
535	86	1	0	1	126.952736011
535	87	3	0	3	131.708898771
535	88	1	0	1	129.704116455
535	112	1	0	1	139.395717844
535	121	1	0	1	128.967461807
535	130	1	0	1	117.224843304
535	155	1	0	1	119.354109118
535	166	1	0	1	114.121916168
535	168	1	0	1	116.277167667
535	177	1	0	1	110.106677963
535	222	0	0	0	230.082036878
535	319	1	0	1	95.3393123737
535	320	0	0	0	88.9373422192
535	322	2	0	2	90.5720573029
535	338	0	0	0	123.786700863
535	345	1	0	1	183.687242276
535	349	1	0	1	114.324475222
535	356	2	0	2	93.8344156911
535	375	0	0	0	167.353250282
535	385	2	0	2	74.6609004098
535	403	1	0	1	99.4593681051
535	408	7	0	7	87.559020567
535	411	1	0	1	82.3032761056
535	425	0	0	0	90.470644626
535	430	1	0	1	56.6785616265
535	438	1	0	1	75.6590819625
535	441	0	0	0	78.2266938468
535	442	0	0	0	87.2633577706
535	443	1	0	1	83.9265881375
535	444	1	0	1	97.2552400212
535	455	1	0	1	94.1940889056
535	475	0	0	0	107.950845497
535	507	149	0	149	32.456818943
535	508	1	0	1	26.0581825473
535	509	8	2	6	39.4266811059
535	510	3	1	2	21.3759081803
535	511	5	0	5	37.7959963607
535	512	50	8	42	29.7838452163
535	513	1	0	1	28.0806015037
535	514	5	0	5	19.0873717753
535	515	1	0	1	40.5748691808
535	516	0	0	0	57.7389796193
535	517	16	1	15	15.4770447161
535	519	5	0	5	20.4889198807
535	520	0	0	0	56.8184438241
535	523	1	0	1	37.1789080313
535	524	7	0	7	40.3589909909
535	525	2	0	2	32.2078828823
535	527	4	0	4	27.9527049774
535	529	43	3	40	13.4234081816
535	530	4	0	4	25.6224043576
535	532	2	2	0	10.8479030723
535	533	20	4	16	10.6039192119
535	534	10	1	9	19.8810788094
535	536	12	0	12	22.1660719128
535	537	18	7	11	21.7158946398
535	538	1	0	1	29.0442079126
535	540	267	7	260	10.6070010964
535	541	7	0	7	14.8650826091
535	542	8	0	8	24.3386676402
535	543	11	5	6	19.576109014
535	544	1	0	1	27.6503431033
535	546	0	0	0	31.2345494743
535	547	3	0	3	18.748516148
535	548	19	0	19	32.6891040525
535	549	19	5	14	18.4576748543
535	550	1	0	1	35.3001412964
535	552	1	0	1	43.6777206029
535	554	2	0	2	51.5643377351
535	561	2	0	2	38.9110069646
535	563	1	0	1	63.3873529017
535	573	9	1	8	78.6832510564
535	575	1	0	1	72.5221367361
535	577	1	0	1	87.9801102827
535	581	1	0	1	93.6864560024
536	70	0	0	0	118.677034147
536	71	1	0	1	111.946168236
536	72	1	0	1	122.078469346
536	73	13	1	12	120.179704428
536	74	1	0	1	115.602065163
536	78	6	0	6	115.122130851
536	81	1	0	1	120.314818832
536	84	1	0	1	118.733483882
536	85	0	0	0	112.497803103
536	86	1	0	1	110.711276128
536	87	1	0	1	115.920532608
536	88	3	0	3	113.887626676
536	90	1	0	1	110.906783513
536	95	0	0	0	127.301017446
536	109	1	0	1	116.548994414
536	147	1	0	1	101.516424763
536	157	1	0	1	92.3107859558
536	166	1	0	1	95.6693578886
536	168	1	0	1	100.320007502
536	177	2	0	2	94.0817592942
536	190	1	0	1	204.100146299
536	270	1	0	1	171.582313001
536	277	1	0	1	163.744260865
536	293	1	0	1	150.416810101
536	310	0	0	0	126.586502974
536	319	0	0	0	75.9205205625
536	320	1	0	1	69.8686408023
536	325	2	0	2	65.4098803951
536	330	0	0	0	68.2014205928
536	347	1	0	1	105.875809762
536	351	1	0	1	99.1497863828
536	363	0	0	0	66.6417653382
536	373	1	0	1	131.583907063
536	375	1	0	1	146.022607781
536	379	1	0	1	72.8338202531
536	395	1	0	1	65.4486264388
536	408	5	0	5	86.7569211438
536	411	1	0	1	80.4411335428
536	442	0	0	0	91.4864434431
536	445	1	0	1	73.0148512767
536	460	0	0	0	87.9230872869
536	475	0	0	0	100.51199813
536	495	0	0	0	110.895890913
536	507	36	1	35	53.7982722634
536	509	4	0	4	59.0546933126
536	511	1	0	1	58.3868209774
536	512	10	0	10	46.278107126
536	517	3	0	3	33.7588931808
536	519	1	0	1	30.86054714
536	524	10	2	8	36.6513277761
536	525	1	0	1	29.9967695705
536	527	2	0	2	33.0705782275
536	529	101	44	57	9.85606664015
536	530	68	11	57	11.9532637087
536	532	2	1	1	17.5879755847
536	533	1	0	1	32.6827793514
536	534	29	2	27	10.6673378373
536	535	29	1	28	22.1660719128
536	537	26	0	26	20.8037979225
536	538	0	0	0	19.6967864777
536	540	140	21	119	20.8795011302
536	541	5	1	4	27.7296667026
536	542	1	0	1	43.4104308493
536	543	2	0	2	24.3732958215
536	547	1	0	1	35.103709464
536	548	3	0	3	48.7864794642
536	549	0	0	0	39.4532954741
536	552	7	0	7	24.4672987837
536	553	31	24	7	8.54884078809
536	554	3	0	3	40.2518522253
536	555	3	0	3	40.4434815529
536	556	9	0	9	18.8070077267
536	561	9	0	9	27.8163895047
536	563	0	0	0	48.5022271604
536	565	13	11	2	17.0935809964
536	566	2	0	2	64.6503919154
536	569	1	0	1	64.6202468575
536	573	13	0	13	64.2942022763
536	581	4	1	3	78.0944947708
536	583	0	0	0	49.1102250554
536	586	1	0	1	48.8311229432
537	1	2	0	2	151.634935409
537	36	1	0	1	127.076268642
537	70	3	0	3	115.336058589
537	73	16	1	15	115.528420636
537	74	3	0	3	111.168379696
537	75	2	0	2	113.773315535
537	78	0	0	0	110.989757831
537	79	1	0	1	118.60239333
537	81	1	0	1	116.428613144
537	82	2	0	2	113.042264055
537	84	4	0	4	114.085631589
537	85	1	0	1	108.902825823
537	87	2	0	2	110.935019423
537	103	1	0	1	115.428415106
537	113	3	0	3	110.875858929
537	155	1	0	1	99.6886231444
537	172	2	0	2	92.3756540429
537	177	4	0	4	89.5692742017
537	319	4	0	4	77.573408578
537	330	1	0	1	68.2641279127
537	338	1	0	1	108.042131001
537	345	0	0	0	167.624174147
537	382	0	0	0	45.4957536405
537	385	0	0	0	53.0760086707
537	398	1	0	1	53.0887533794
537	406	1	0	1	73.9239092746
537	408	4	0	4	68.3048330799
537	409	1	0	1	78.826380821
537	410	1	0	1	67.3300392052
537	411	0	0	0	62.4869097911
537	417	1	0	1	62.547036588
537	433	0	0	0	66.0783110501
537	441	1	0	1	62.3019301231
537	442	2	0	2	71.2203838261
537	443	0	0	0	72.7543090595
537	444	1	0	1	81.3311271478
537	507	50	4	46	51.5881066436
537	509	1	0	1	60.0995233729
537	510	3	1	2	37.0667371609
537	512	42	9	33	29.8211055342
537	514	1	0	1	30.8440996787
537	515	2	0	2	32.5725047263
537	516	1	0	1	47.2867268532
537	517	7	1	6	21.9316724898
537	518	0	0	0	43.8613664232
537	519	22	3	19	13.0989756968
537	520	2	0	2	37.3051562464
537	522	1	0	1	26.2693164917
537	523	6	0	6	23.4251606969
537	524	52	2	50	19.059859305
537	525	9	3	6	11.0162465718
537	527	15	9	6	12.3929969832
537	529	25	6	19	21.6603826205
537	530	6	0	6	31.9204745379
537	531	2	1	1	20.3028268488
537	532	2	0	2	27.114247784
537	533	4	0	4	29.9043566822
537	534	32	2	30	10.1672263066
537	535	20	2	18	21.7158946398
537	536	12	4	8	20.8037979225
537	538	10	5	5	9.52963986509
537	539	5	0	5	17.8197112248
537	540	226	100	126	11.5894643519
537	541	1	0	1	35.4968697102
537	543	2	0	2	37.0824177802
537	547	1	0	1	40.4185306254
537	548	3	1	2	54.4027693061
537	549	9	0	9	38.9115069434
537	552	2	0	2	28.7278222502
537	553	1	0	1	26.6489840508
537	554	4	1	3	30.2674799847
537	555	1	0	1	37.1005900155
537	557	1	0	1	36.3547794115
537	561	26	4	22	18.262622119
537	566	4	0	4	53.9492823446
537	568	1	0	1	68.9457367428
537	573	21	0	21	57.7936346431
537	577	0	0	0	68.7280121355
537	581	2	0	2	73.1025418831
537	583	1	0	1	61.7751333233
537	585	2	0	2	56.2949299434
537	587	1	0	1	69.7092269814
538	70	5	0	5	106.713702724
538	71	1	0	1	98.9383276896
538	72	1	0	1	109.805579632
538	73	11	1	10	107.202632906
538	74	1	0	1	102.7781193
538	75	2	0	2	105.519089991
538	76	0	0	0	104.053290758
538	78	3	0	3	102.52886176
538	79	1	0	1	110.176705766
538	82	3	0	3	104.528608988
538	86	1	0	1	97.9707015484
538	87	1	0	1	102.678688345
538	88	1	0	1	100.676844395
538	172	1	0	1	84.1725218637
538	173	0	0	0	71.3922415411
538	177	1	0	1	81.120154476
538	336	1	0	1	106.565770011
538	375	1	0	1	142.347066298
538	388	1	0	1	50.690089721
538	392	1	0	1	52.8548172727
538	405	0	0	0	68.2913784511
538	407	2	0	2	74.7211754093
538	408	3	0	3	67.0927207953
538	415	0	0	0	64.3623225479
538	416	1	0	1	74.9417497214
538	441	1	0	1	64.0771530473
538	482	1	0	1	122.048522009
538	507	13	0	13	60.3383371896
538	511	1	0	1	66.2500847055
538	512	7	2	5	38.8527006621
538	514	1	0	1	40.2755447184
538	519	2	0	2	22.3042456418
538	520	1	0	1	36.8317963553
538	522	3	0	3	25.9655714841
538	524	66	43	23	17.1114340033
538	525	6	2	4	11.6946960396
538	527	1	0	1	19.0711890456
538	528	1	0	1	39.1600372094
538	529	6	0	6	24.6663090897
538	531	2	0	2	13.8527954216
538	534	15	1	14	10.8564678904
538	535	5	0	5	29.0442079126
538	536	3	0	3	19.6967864777
538	537	27	3	24	9.52963986509
538	539	31	1	30	9.22878243035
538	540	42	5	37	20.1074289845
538	542	2	1	1	53.3822189601
538	548	3	0	3	61.3455428376
538	552	7	0	7	19.5869553533
538	553	1	0	1	22.5385322565
538	554	5	0	5	22.8059009209
538	555	1	0	1	27.9255678487
538	556	1	0	1	25.1926363062
538	559	5	0	5	20.087749193
538	561	43	5	38	9.92208899022
538	562	3	0	3	25.8179248314
538	564	1	0	1	31.4620633432
538	567	1	0	1	37.2547947819
538	573	22	5	17	49.6401832186
538	581	1	0	1	64.6792045631
538	585	4	1	3	46.765612053
539	1	1	0	1	142.318283235
539	70	2	0	2	102.805944708
539	73	14	0	14	103.904244967
539	74	1	0	1	99.3749763056
539	75	3	1	2	102.368136978
539	78	2	0	2	98.9835886188
539	80	1	0	1	104.795261589
539	82	1	0	1	100.863559811
539	83	1	0	1	102.269062762
539	85	3	0	3	96.5197270329
539	86	1	0	1	94.5047142683
539	87	2	0	2	99.5391548074
539	88	1	0	1	97.5131365596
539	103	1	0	1	104.538514491
539	142	1	0	1	95.5696679706
539	166	0	0	0	80.7886291724
539	168	3	0	3	83.9712754221
539	169	2	0	2	95.1791393309
539	172	1	0	1	81.2631316895
539	177	2	0	2	77.744401814
539	180	1	0	1	69.6121546192
539	319	4	0	4	61.9878364464
539	338	0	0	0	91.2324033208
539	342	1	0	1	97.1821389117
539	358	1	0	1	55.344873122
539	375	1	0	1	135.015657124
539	385	0	0	0	50.6794905283
539	392	0	0	0	54.9711335898
539	400	1	0	1	74.7894880197
539	408	5	0	5	72.5486356441
539	411	1	0	1	65.8829373825
539	415	2	0	2	68.6501078055
539	430	1	0	1	56.1510071865
539	442	0	0	0	79.9057662479
539	507	6	1	5	65.7115543311
539	511	1	0	1	71.1850119791
539	512	5	0	5	47.6208121733
539	519	2	0	2	30.9150777748
539	520	2	0	2	43.4444675336
539	522	1	0	1	33.1509104163
539	523	0	0	0	38.0663579556
539	524	31	0	31	24.1023638965
539	525	2	0	2	20.4294472463
539	529	7	1	6	25.2436751246
539	530	2	0	2	28.2863866363
539	531	2	1	1	6.62476716597
539	534	10	2	8	13.5174206144
539	535	5	0	5	33.3893432137
539	536	13	0	13	17.1698027202
539	537	15	0	15	17.8197112248
539	538	14	1	13	9.22878243035
539	540	37	0	37	26.3900282724
539	543	1	0	1	41.2009549014
539	545	1	0	1	68.7454524271
539	548	0	0	0	64.1302968172
539	549	1	0	1	51.8470117947
539	552	31	3	28	11.0471224363
539	553	11	3	8	16.3668784768
539	554	16	0	16	23.3520480552
539	555	12	4	8	23.7911987535
539	556	3	0	3	16.3330917458
539	557	1	0	1	30.9381338738
539	558	1	0	1	35.1361579167
539	559	16	0	16	15.5745943248
539	561	34	6	28	11.8940217291
539	563	5	1	4	31.5597580684
539	564	2	1	1	24.570302924
539	565	1	1	0	26.7602954827
539	566	1	0	1	47.5439494679
539	569	1	0	1	48.2952895519
539	571	1	0	1	40.4296398959
539	573	19	0	19	47.3374286962
539	576	1	0	1	62.7267787138
539	579	1	0	1	54.7562727914
539	581	1	0	1	61.5380030348
539	585	6	1	5	39.6600782849
540	1	0	0	0	163.218663781
540	36	0	0	0	138.663161493
540	70	1	0	1	126.709809715
540	71	3	0	3	118.768571315
540	73	24	0	24	127.019191912
540	74	3	1	2	122.637822205
540	75	1	0	1	125.283767505
540	76	1	0	1	124.036763714
540	78	2	0	2	122.433789432
540	81	1	0	1	127.85752272
540	82	1	0	1	124.465586553
540	83	1	0	1	125.552128205
540	84	3	0	3	125.574688308
540	85	1	0	1	120.293131948
540	87	3	0	3	122.444390874
540	88	1	0	1	120.455671201
540	99	1	0	1	126.391308066
540	104	1	0	1	137.428191338
540	113	2	0	2	122.430361168
540	116	1	0	1	122.97612004
540	117	1	0	1	120.631061299
540	124	1	0	1	122.525541222
540	168	2	0	2	107.129457766
540	172	0	0	0	103.894042582
540	177	3	0	3	101.012401303
540	183	1	0	1	212.035836992
540	191	1	0	1	219.114049746
540	277	1	0	1	173.637611992
540	319	2	0	2	87.9694079905
540	322	1	0	1	82.678410656
540	325	1	0	1	77.82661912
540	338	0	0	0	117.621839265
540	360	0	0	0	80.5244532864
540	375	1	0	1	161.404226723
540	385	0	0	0	64.1509977013
540	391	1	0	1	73.1028626055
540	401	1	0	1	72.2472200063
540	404	1	0	1	66.6057491892
540	406	1	0	1	82.8181902753
540	408	16	0	16	77.1964867108
540	411	0	0	0	71.8250349039
540	441	1	0	1	68.7258763444
540	442	1	0	1	77.7641084684
540	453	1	0	1	79.830418943
540	459	1	0	1	72.4800335235
540	464	0	0	0	125.190165022
540	493	1	0	1	122.945910313
540	507	171	0	171	40.2453472185
540	509	7	1	6	48.5285207011
540	510	1	0	1	26.3777922931
540	511	5	0	5	46.2471648445
540	512	63	33	30	25.4635611589
540	513	2	0	2	20.6297647803
540	515	3	0	3	33.2536754128
540	516	2	0	2	49.9123889017
540	517	18	0	18	13.2504311908
540	519	41	13	28	11.5656922376
540	521	1	0	1	40.1543137952
540	523	4	1	3	27.7836703038
540	524	41	10	31	29.8027390613
540	525	1	0	1	21.6662086904
540	526	1	0	1	31.0757721799
540	527	11	1	10	17.7533496838
540	529	108	91	17	16.2518477056
540	530	11	0	11	28.8785734672
540	532	1	0	1	18.6308446995
540	533	7	0	7	18.3558686253
540	534	42	12	30	13.6494049688
540	535	93	38	55	10.6070010964
540	536	24	0	24	20.8795011302
540	537	115	0	115	11.5894643519
540	538	4	0	4	20.1074289845
540	539	3	0	3	26.3900282724
540	541	3	1	2	25.2314943452
540	542	4	0	4	34.1312233433
540	543	5	2	3	28.5465313822
540	547	2	0	2	29.3046733752
540	548	16	0	16	43.0725417439
540	549	8	0	8	27.330477696
540	552	5	0	5	37.3379036423
540	553	5	0	5	28.9562785802
540	554	4	0	4	41.8426834425
540	556	2	0	2	37.4191367768
540	557	1	0	1	47.9165911836
540	561	18	2	16	29.6022644324
540	563	1	0	1	54.376511008
540	564	1	0	1	50.7969349059
540	565	4	1	3	37.8310553585
540	566	2	0	2	65.4848411436
540	573	37	0	37	69.3079367834
540	581	1	0	1	84.5486808262
540	585	3	0	3	66.001212919
541	1	1	0	1	185.198926009
541	70	1	0	1	145.966976694
541	71	1	0	1	138.886060577
541	73	4	0	4	147.148831323
541	75	1	0	1	145.608645265
541	76	2	0	2	143.390881003
541	78	1	0	1	142.215733671
541	82	1	0	1	144.078957684
541	83	1	0	1	145.510061563
541	84	1	0	1	145.699170469
541	85	1	0	1	139.714049476
541	87	0	0	0	142.778349395
541	95	1	0	1	154.08226981
541	112	1	0	1	150.790831095
541	113	1	0	1	143.276348442
541	142	0	0	0	138.118411429
541	168	2	0	2	127.215052278
541	173	1	0	1	111.0991638
541	177	1	0	1	120.988895052
541	281	0	0	0	181.590865032
541	296	0	0	0	166.913079733
541	319	2	1	1	103.649800886
541	320	1	0	1	97.5757805865
541	358	0	0	0	84.4036014695
541	361	0	0	0	108.360120633
541	375	1	0	1	172.917888983
541	385	0	0	0	88.5198252632
541	392	0	0	0	93.3512566015
541	408	3	0	3	102.386171895
541	415	1	0	1	102.113854694
541	441	0	0	0	92.9503009174
541	493	1	0	1	148.114194735
541	507	173	49	124	29.3776490697
541	508	1	0	1	26.4553716604
541	509	17	5	12	32.1255607641
541	510	1	0	1	25.9960116033
541	511	8	0	8	32.4111369616
541	512	7	0	7	42.2366902903
541	515	1	0	1	54.4382903834
541	517	1	0	1	28.3749428305
541	524	6	0	6	54.5111449792
541	529	13	2	11	18.1736982758
541	530	9	0	9	24.1173492888
541	532	1	0	1	10.2280008222
541	533	2	0	2	16.0578103784
541	534	3	0	3	30.7231661274
541	535	10	0	10	14.8650826091
541	536	7	1	6	27.7296667026
541	537	3	0	3	35.4968697102
541	540	42	2	40	25.2314943452
541	542	22	6	16	16.8524800881
541	543	118	64	54	8.46367379337
541	544	3	0	3	14.1442941031
541	545	4	0	4	26.7569269724
541	546	2	1	1	23.4337707267
541	547	34	12	22	7.70896179216
541	548	79	27	52	21.0720843046
541	549	36	0	36	16.3043075403
541	550	9	2	7	21.6050602181
541	551	0	0	0	78.4820530605
541	553	1	0	1	34.8695001135
541	554	0	0	0	64.053285723
541	561	0	0	0	51.1172606423
541	573	8	0	8	90.2781161097
541	576	1	1	0	105.880263387
541	577	1	0	1	97.7314851901
541	581	0	0	0	104.756681395
541	585	2	0	2	80.4868706828
541	588	1	0	1	66.2732113036
542	70	0	0	0	159.849604316
542	73	4	0	4	160.545632218
542	74	0	0	0	156.095682273
542	77	1	0	1	163.279644938
542	78	2	0	2	155.806681127
542	82	0	0	0	157.767159399
542	84	2	0	2	159.096866148
542	88	2	0	2	154.038632441
542	120	1	0	1	166.50975656
542	138	0	0	0	163.855957726
542	168	1	0	1	140.602771149
542	177	0	0	0	134.425932454
542	319	2	0	2	118.861999692
542	320	1	0	1	112.597144809
542	321	1	0	1	127.600407304
542	329	2	0	2	137.426526266
542	360	1	0	1	106.157569517
542	408	8	0	8	107.665608331
542	411	0	0	0	103.122667989
542	426	0	0	0	111.48668161
542	441	0	0	0	95.2699020046
542	475	1	0	1	130.747865393
542	493	2	2	0	152.789871278
542	507	325	181	144	13.3679608493
542	508	3	1	2	14.0084848908
542	509	30	1	29	15.6445399028
542	511	21	0	21	15.5610080612
542	512	6	0	6	40.6251030712
542	514	1	0	1	24.5155920262
542	517	1	0	1	30.0721832789
542	520	0	0	0	77.9764600736
542	524	4	0	4	63.5642062964
542	525	1	0	1	55.5478964093
542	529	1	0	1	33.5571998053
542	530	2	0	2	40.9653997912
542	533	4	1	3	16.5119152041
542	534	2	0	2	43.9232203632
542	535	9	0	9	24.3386676402
542	536	1	1	0	43.4104308493
542	537	1	0	1	45.68741027
542	539	1	0	1	57.2807959118
542	540	18	5	13	34.1312233433
542	541	9	1	8	16.8524800881
542	543	5	0	5	24.4901219038
542	544	1	0	1	12.0570640153
542	545	2	0	2	11.7221957857
542	546	4	1	3	7.02743134839
542	547	15	10	5	9.28176499231
542	548	104	11	93	10.6456701652
542	549	47	17	30	7.92391729801
542	550	8	1	7	16.9089275719
542	554	0	0	0	75.8153393864
542	555	0	0	0	80.6905632019
542	561	1	0	1	63.237044346
542	565	1	0	1	53.9489304856
542	573	6	0	6	103.019233883
542	581	1	0	1	118.015260195
542	585	1	0	1	95.9094645194
543	60	1	0	1	164.264195111
543	71	1	0	1	136.308576424
543	73	7	1	6	144.536979148
543	74	1	0	1	139.95323205
543	75	1	0	1	143.10185516
543	76	0	0	0	140.426114453
543	77	0	0	0	146.806124578
543	78	2	0	2	139.457887683
543	82	1	0	1	141.231731047
543	83	1	0	1	142.821320944
543	84	2	0	2	143.091495679
543	85	0	0	0	136.798869749
543	87	2	1	1	140.289655115
543	88	4	0	4	138.256424829
543	95	1	0	1	151.673119375
543	142	0	0	0	136.763989045
543	155	1	0	1	125.831628718
543	171	0	0	0	127.573583108
543	177	2	0	2	118.450188085
543	277	0	0	0	187.580352939
543	319	3	0	3	99.4999642398
543	323	3	0	3	101.294466798
543	330	1	0	1	92.214361121
543	338	1	0	1	124.574702424
543	356	1	0	1	93.0117989406
543	385	1	0	1	89.1761808683
543	392	1	0	1	93.8824342575
543	398	1	0	1	88.7765983509
543	408	7	0	7	105.216973416
543	411	1	0	1	99.5316755784
543	441	0	0	0	97.256451387
543	442	1	0	1	106.296823939
543	443	0	0	0	103.502626806
543	507	119	0	119	37.4777517375
543	508	1	0	1	34.9090328049
543	509	5	0	5	39.0289147688
543	510	1	0	1	34.2807569072
543	511	5	2	3	39.9359370322
543	512	9	1	8	48.8736644198
543	513	0	0	0	47.6436518577
543	514	1	0	1	35.6250429763
543	516	1	0	1	77.3128180217
543	521	1	0	1	68.5441814317
543	522	1	0	1	63.2726496129
543	524	7	0	7	56.0119932983
543	525	1	0	1	48.0875353847
543	529	20	4	16	16.4133230145
543	530	14	0	14	17.6176347674
543	532	9	0	9	10.0504410144
543	533	2	0	2	23.8156313754
543	534	5	0	5	30.2004765741
543	535	14	1	13	19.576109014
543	536	5	0	5	24.3732958215
543	537	7	0	7	37.0824177802
543	540	38	2	36	28.5465313822
543	541	39	24	15	8.46367379337
543	542	11	4	7	24.4901219038
543	544	3	1	2	18.1684513205
543	545	2	0	2	33.0128201663
543	547	18	0	18	15.238435554
543	548	70	0	70	26.2188565424
543	549	19	0	19	24.7571995468
543	550	3	1	2	24.342958062
543	552	1	0	1	48.7094041447
543	554	1	0	1	63.4416785444
543	561	1	0	1	50.5481287314
543	565	1	0	1	30.3112881017
543	566	1	0	1	88.0371740774
543	573	6	0	6	88.5279092255
543	581	0	0	0	102.462616198
544	1	0	0	0	199.340595343
544	70	1	0	1	159.974175669
544	73	4	0	4	161.235175217
544	74	0	0	0	156.694647944
544	78	1	0	1	156.276819997
544	81	2	0	2	161.528465861
544	83	1	0	1	159.58389249
544	84	1	0	1	159.78585694
544	85	0	0	0	153.743454076
544	113	1	0	1	157.405715142
544	142	1	0	1	152.243050575
544	155	0	0	0	143.090443927
544	159	1	0	1	133.279645275
544	168	1	0	1	141.309334324
544	177	2	0	2	135.079860189
544	196	1	0	1	231.64634037
544	277	1	0	1	205.165852438
544	319	2	0	2	117.229459246
544	338	1	0	1	142.725722876
544	345	1	0	1	202.135665817
544	373	1	0	1	170.64843189
544	401	1	0	1	109.395369041
544	408	1	0	1	114.691366455
544	412	1	0	1	115.953322618
544	441	0	0	0	103.822327949
544	442	0	0	0	112.76902897
544	493	1	0	1	160.251578956
544	507	102	35	67	24.6537920385
544	509	32	7	25	22.3698801014
544	511	5	1	4	24.6306314873
544	512	2	0	2	50.3874548913
544	513	1	0	1	52.659630211
544	521	0	0	0	77.3333466105
544	524	2	0	2	67.9761652521
544	525	1	0	1	59.8212274813
544	528	0	0	0	77.4711675559
544	529	2	0	2	32.1607079849
544	530	1	0	1	35.7845934636
544	535	1	0	1	27.6503431033
544	540	8	0	8	38.2557391246
544	541	11	4	7	14.1442941031
544	542	13	5	8	12.0570640153
544	543	15	5	10	18.1684513205
544	545	3	0	3	15.6884421743
544	546	6	0	6	14.9708716206
544	547	10	6	4	9.19997453629
544	548	218	0	218	8.21115486771
544	549	7	1	6	18.0499609396
544	550	14	10	4	7.65373436599
544	554	0	0	0	78.1300849025
544	561	0	0	0	65.2103366335
544	566	0	0	0	102.545403993
544	573	1	0	1	104.422018953
544	581	0	0	0	118.872849607
545	71	1	0	1	163.931501177
545	73	1	0	1	172.20146382
545	76	1	0	1	168.813553386
545	78	1	0	1	167.437318349
545	84	1	0	1	170.752272832
545	87	0	0	0	167.713132159
545	167	1	0	1	134.414474286
545	172	1	0	1	149.232252273
545	177	0	0	0	146.069905719
545	408	6	1	5	118.343569958
545	411	0	0	0	114.029453495
545	414	1	0	1	130.11746515
545	433	1	0	1	99.2787640991
545	442	0	0	0	113.729576272
545	507	161	0	161	14.2964951415
545	508	1	0	1	20.3359349558
545	509	117	28	89	6.94792755098
545	510	1	0	1	27.0639049858
545	511	48	9	39	10.6559208559
545	512	1	0	1	49.9685128936
545	529	2	0	2	44.4908103042
545	533	1	0	1	27.9763864673
545	535	1	0	1	36.032713917
545	536	1	0	1	54.2715183787
545	537	1	0	1	57.4039085003
545	540	5	1	4	45.8391584271
545	541	3	0	3	26.7569269724
545	542	3	2	1	11.7221957857
545	546	9	2	7	5.44121057655
545	547	5	0	5	19.1793624537
545	548	109	9	100	7.84705532207
545	549	5	0	5	18.9784931222
545	550	2	0	2	14.7280889071
545	561	0	0	0	74.941975929
545	573	2	0	2	114.714623092
545	581	0	0	0	129.673307899
546	0	1	0	1	191.742389784
546	70	0	0	0	166.804599198
546	73	7	0	7	167.446763243
546	74	0	0	0	163.007888486
546	75	1	0	1	165.771186738
546	78	0	0	0	162.731894973
546	82	1	0	1	164.702550897
546	84	0	0	0	165.998546874
546	85	0	0	0	160.445167481
546	87	1	0	1	162.930814205
546	88	0	0	0	160.928109095
546	172	1	0	1	144.422547873
546	177	0	0	0	141.340928854
546	319	2	0	2	125.888947867
546	320	1	0	1	119.624247419
546	330	0	0	0	117.612933545
546	345	0	0	0	212.853210256
546	358	1	0	1	107.804816658
546	408	2	0	2	112.902503976
546	411	0	0	0	108.593132941
546	415	1	0	1	114.646663297
546	441	0	0	0	99.6890697221
546	507	202	22	180	10.5641041723
546	508	1	0	1	15.3008712876
546	509	34	3	31	8.71216747529
546	510	2	0	2	21.7295550944
546	511	12	5	7	9.7234972818
546	512	4	0	4	44.6221115267
546	516	0	0	0	75.0129275808
546	524	3	0	3	69.9252968453
546	527	1	0	1	55.1905866988
546	535	4	0	4	31.2345494743
546	537	1	0	1	52.3666891672
546	540	6	1	5	40.7804534799
546	541	1	0	1	23.4337707267
546	542	6	0	6	7.02743134839
546	544	1	0	1	14.9708716206
546	545	7	2	5	5.44121057655
546	547	3	0	3	15.7262918921
546	548	75	33	42	9.15196016517
546	549	8	1	7	13.6646309321
546	550	1	0	1	16.6739272568
546	554	0	0	0	82.5740633279
546	555	0	0	0	87.658027269
546	573	3	0	3	109.86898162
546	581	0	0	0	124.917566377
547	71	0	0	0	145.52042893
547	73	0	0	0	153.790133303
547	76	2	0	2	150.197200592
547	78	0	0	0	148.930168718
547	79	1	0	1	156.608997898
547	81	1	0	1	154.239018433
547	82	0	0	0	150.832090717
547	84	1	0	1	152.340050887
547	85	1	0	1	146.502172852
547	87	0	0	0	149.36590821
547	103	1	0	1	154.223491914
547	142	1	0	1	144.119711144
547	155	1	0	1	136.157633601
547	177	1	0	1	127.62945024
547	320	1	0	1	104.805038648
547	358	0	0	0	92.0923559658
547	408	4	1	3	105.499434027
547	411	0	0	0	100.504537082
547	441	0	0	0	94.7008294569
547	442	0	0	0	103.662705434
547	507	157	67	90	22.2949886819
547	508	1	0	1	20.7183340856
547	509	19	0	19	24.4167601135
547	510	1	0	1	22.1964553242
547	511	6	1	5	24.8180853047
547	512	3	0	3	41.7276731335
547	524	1	0	1	59.0980238721
547	527	0	0	0	46.0442057022
547	529	1	0	1	25.3581566548
547	530	1	0	1	31.7908204639
547	532	1	0	1	17.5182737162
547	533	4	0	4	15.0113111283
547	534	1	0	1	37.0093385925
547	535	7	1	6	18.748516148
547	536	0	0	0	35.103709464
547	537	1	0	1	40.4185306254
547	540	28	1	27	29.3046733752
547	541	27	14	13	7.70896179216
547	542	40	26	14	9.28176499231
547	543	20	7	13	15.238435554
547	544	4	2	2	9.19997453629
547	545	1	0	1	19.1793624537
547	546	2	0	2	15.7262918921
547	548	97	27	70	14.2230495081
547	549	44	0	44	10.9959258236
547	550	3	0	3	16.7280445581
547	554	0	0	0	69.8989152049
547	561	0	0	0	57.0627502756
547	573	5	0	5	96.6032474947
547	581	0	0	0	111.311550092
547	585	0	0	0	87.8487070942
548	1	1	0	1	205.553688246
548	5	1	0	1	207.718591118
548	36	1	0	1	180.638552306
548	70	0	0	0	166.927532325
548	71	1	0	1	159.713049423
548	73	12	0	12	167.981719925
548	74	1	0	1	163.47238476
548	75	2	0	2	166.403048485
548	76	0	0	0	164.33786825
548	78	1	0	1	163.102376653
548	79	1	0	1	170.782721746
548	81	1	0	1	168.399065916
548	82	2	0	2	164.992208482
548	84	0	0	0	166.531646045
548	85	1	0	1	160.649556014
548	87	1	0	1	163.568125905
548	88	0	0	0	161.548267318
548	89	1	0	1	177.194629882
548	177	4	0	4	141.819321165
548	319	1	0	1	124.70336733
548	327	1	0	1	124.091011279
548	338	0	0	0	150.635134701
548	375	0	0	0	193.277247116
548	385	1	0	1	107.209807049
548	392	1	0	1	112.127731414
548	408	6	0	6	117.976550105
548	411	2	0	2	113.292010875
548	418	1	0	1	108.372412959
548	438	0	0	0	102.379831993
548	440	1	0	1	94.4913299815
548	441	0	0	0	105.871636487
548	442	4	0	4	114.699238973
548	507	378	6	372	19.7130550742
548	508	2	0	2	23.5220638134
548	509	134	59	75	14.7713675289
548	510	4	0	4	28.8519814701
548	511	49	37	12	17.896601708
548	512	2	0	2	51.2690173303
548	514	1	0	1	35.1610409701
548	517	1	0	1	40.4584092119
548	518	1	0	1	73.2556211771
548	519	1	0	1	50.5681393412
548	524	3	1	2	72.838229359
548	525	1	1	0	64.725234175
548	529	4	0	4	39.2298983498
548	530	1	0	1	43.820072471
548	533	2	0	2	26.5445097618
548	535	8	0	8	32.6891040525
548	536	2	0	2	48.7864794642
548	537	7	1	6	54.4027693061
548	540	24	3	21	43.0725417439
548	541	12	3	9	21.0720843046
548	542	41	6	35	10.6456701652
548	543	14	1	13	26.2188565424
548	544	14	8	6	8.21115486771
548	545	19	8	11	7.84705532207
548	546	18	3	15	9.15196016517
548	547	13	1	12	14.2230495081
548	549	29	19	10	18.4980888897
548	550	45	5	40	7.52749390254
548	554	0	0	0	84.0801557717
548	561	1	0	1	71.267585018
548	563	1	0	1	95.272372792
548	573	5	0	5	110.826202302
548	579	1	0	1	118.882934543
548	581	1	0	1	125.516564028
549	70	1	0	1	153.824163833
549	71	1	0	1	146.021221423
549	73	3	0	3	154.279529922
549	75	2	0	2	152.56570621
549	77	1	0	1	157.128127615
549	78	4	0	4	149.640221477
549	81	1	0	1	155.043243214
549	82	2	0	2	151.645499175
549	84	1	0	1	152.833374038
549	85	0	0	0	147.432626448
549	87	1	0	1	149.725603967
549	88	1	0	1	147.731634819
549	99	1	0	1	153.704040473
549	112	1	0	1	157.259324592
549	113	1	0	1	149.75182871
549	164	1	0	1	138.282482287
549	168	1	0	1	134.366957705
549	177	1	0	1	128.22617369
549	277	0	0	0	200.429581955
549	282	0	0	0	191.649292011
549	319	2	0	2	113.784968803
549	320	1	0	1	107.393126818
549	327	1	0	1	114.029976686
549	338	2	0	2	141.946178333
549	358	0	0	0	98.7010795216
549	375	0	0	0	185.385758615
549	385	0	0	0	90.5231270621
549	386	1	0	1	85.8033058075
549	396	1	0	1	105.712480476
549	398	0	0	0	80.5917215946
549	408	8	0	8	99.7732709968
549	411	0	0	0	95.2799573265
549	436	0	0	0	109.542289258
549	441	1	0	1	87.3747829427
549	442	0	0	0	96.2017296339
549	466	1	0	1	137.330332832
549	493	1	0	1	144.868899487
549	507	466	0	466	14.3500157326
549	508	8	5	3	10.1519149879
549	509	33	2	31	21.2074015873
549	510	5	1	4	11.4713165789
549	511	16	1	15	19.3392324403
549	512	12	3	9	32.8927406027
549	513	1	0	1	36.5643847754
549	514	2	1	1	16.790708916
549	515	1	0	1	46.8437234397
549	517	1	0	1	22.1824023264
549	520	0	0	0	70.201119518
549	524	7	2	5	56.2674473916
549	525	1	0	1	48.3504973491
549	529	4	1	3	29.734757814
549	530	3	1	2	39.1572503049
549	533	6	0	6	9.08100024099
549	534	1	0	1	38.3371544206
549	535	16	5	11	18.4576748543
549	536	1	0	1	39.4532954741
549	537	3	0	3	38.9115069434
549	540	52	3	49	27.330477696
549	541	14	0	14	16.3043075403
549	542	23	10	13	7.92391729801
549	543	5	1	4	24.7571995468
549	544	1	0	1	18.0499609396
549	545	0	0	0	18.9784931222
549	547	15	1	14	10.9959258236
549	548	46	8	38	18.4980888897
549	550	1	0	1	24.189718593
549	554	0	0	0	69.1730689253
549	555	1	0	1	74.8105973701
549	561	1	0	1	56.8352116518
549	570	1	0	1	99.1349804014
549	573	6	0	6	96.6048980898
549	581	1	0	1	111.774338305
549	585	1	0	1	91.0970744556
550	73	0	0	0	168.405431099
550	76	1	0	1	164.470195617
550	103	1	0	1	169.12255731
550	113	1	0	1	164.681833457
550	177	0	0	0	142.265306764
550	348	1	0	1	163.995689234
550	408	1	0	1	122.19430245
550	415	1	0	1	122.654781171
550	441	0	0	0	110.992041647
550	507	52	0	52	27.2270117053
550	509	24	0	24	21.6065456093
550	511	6	0	6	25.2138761429
550	512	2	0	2	57.0261023336
550	533	1	0	1	31.1065238492
550	535	3	1	2	35.3001412964
550	536	1	0	1	48.3459788959
550	537	1	0	1	56.774259367
550	540	8	1	7	45.9038719256
550	541	2	0	2	21.6050602181
550	542	10	0	10	16.9089275719
550	543	2	0	2	24.342958062
550	544	5	2	3	7.65373436599
550	545	4	0	4	14.7280889071
550	546	1	0	1	16.6739272568
550	547	4	2	2	16.7280445581
550	548	206	0	206	7.52749390254
550	549	3	0	3	24.189718593
550	556	1	0	1	65.0943021257
550	573	0	0	0	111.785776542
551	70	4	0	4	67.4856843616
551	71	3	0	3	60.6355071436
551	72	1	0	1	70.8163632496
551	73	42	0	42	68.8612052563
551	74	4	0	4	64.2804089345
551	75	3	0	3	67.4398384779
551	76	1	0	1	64.9099812899
551	78	4	0	4	63.8079937702
551	81	2	1	1	69.0297303378
551	82	4	3	1	65.6261503263
551	83	1	0	1	67.1530370073
551	84	0	0	0	67.4157314562
551	85	5	0	5	61.239403984
551	86	2	1	1	59.3895629402
551	87	6	0	6	64.63467304
551	88	4	0	4	62.6002045504
551	103	1	0	1	69.8940553548
551	112	2	0	2	73.0078909852
551	113	2	0	2	65.5682388312
551	142	3	0	3	63.0970009044
551	146	2	0	2	59.4585607268
551	155	1	0	1	50.9163175079
551	157	1	0	1	41.8352521975
551	163	3	0	3	45.6955173571
551	165	3	0	3	37.8183629979
551	166	1	0	1	45.8531272168
551	168	7	1	6	49.0335408507
551	170	1	0	1	33.71965409
551	171	1	0	1	52.131903053
551	172	2	0	2	46.7505332244
551	173	1	0	1	32.8752982898
551	177	18	1	17	42.797738125
551	180	1	0	1	35.6532712557
551	282	0	0	0	104.900325131
551	319	65	13	52	28.9625729499
551	320	8	0	8	22.1989170118
551	322	1	0	1	22.6700312801
551	323	7	0	7	26.7570758001
551	325	1	0	1	20.2869144336
551	327	1	0	1	31.7913301835
551	328	2	0	2	37.3389257338
551	329	2	0	2	46.3870446727
551	332	0	0	0	72.6919531433
551	338	4	0	4	61.2712898683
551	345	1	0	1	119.617511224
551	349	1	0	1	49.4283453394
551	353	0	0	0	61.1959201079
551	358	1	0	1	46.3984077134
551	364	1	0	1	35.452168342
551	366	1	0	1	28.1492239257
551	367	1	0	1	42.6498224341
551	379	0	0	0	44.0540454624
551	385	2	1	1	36.1195945033
551	389	2	1	1	48.5762885914
551	392	0	0	0	37.6504381156
551	408	2	0	2	65.3032430475
551	411	0	0	0	58.3305917105
551	415	1	0	1	56.9413388901
551	426	1	0	1	98.6081402161
551	442	2	0	2	80.4873654074
551	444	1	0	1	88.6173891833
551	466	2	0	2	86.807353459
551	507	1	0	1	100.361651249
551	509	1	0	1	107.870414453
551	522	1	0	1	44.6173473551
551	524	12	1	11	39.8492092307
551	552	5	2	3	27.0794358236
551	554	34	4	30	22.8682963393
551	555	178	23	155	12.2051515833
551	557	3	1	2	23.4901119514
551	559	2	0	2	20.1555340038
551	560	7	1	6	6.50584257587
551	561	3	1	2	31.258285466
551	563	193	179	14	9.30591437928
551	564	3	0	3	13.8060906121
551	566	6	2	4	25.6491580377
551	567	5	1	4	14.4284435921
551	568	4	0	4	30.3806827957
551	569	23	5	18	13.4799014338
551	570	11	0	11	12.3483617187
551	571	2	0	2	20.7596331185
551	572	23	18	5	9.86888953394
551	573	421	25	396	16.3684801624
551	575	41	25	16	6.40847028166
551	576	2	0	2	27.3983015477
551	577	22	4	18	19.5444083831
551	578	3	0	3	29.0166441373
551	579	18	0	18	19.4844174469
551	580	4	1	3	23.4640527006
551	581	15	6	9	27.1565875671
551	583	1	0	1	39.0593659924
551	584	1	0	1	20.9632658509
551	585	32	1	31	14.6197540968
551	586	4	0	4	22.9439589328
551	587	3	0	3	27.2807799199
552	1	3	0	3	135.468412829
552	15	1	0	1	125.196595464
552	36	0	0	0	109.948332331
552	70	2	0	2	94.2403885376
552	71	1	0	1	87.6805851695
552	73	36	0	36	95.887472751
552	74	3	0	3	91.2888521396
552	75	4	0	4	94.4992747128
552	76	2	0	2	91.7171471994
552	78	7	0	7	90.7683218521
552	81	2	0	2	95.9220991016
552	82	3	0	3	92.5271252135
552	83	1	0	1	94.1475716507
552	84	4	0	4	94.4447138242
552	85	4	0	4	88.0899653676
552	86	3	0	3	86.3930977981
552	87	2	0	2	91.6997877322
552	88	0	0	0	89.6648996283
552	92	1	0	1	98.6835048904
552	95	1	0	1	103.112272633
552	103	3	0	3	96.9727207797
552	113	2	0	2	92.6382843019
552	154	0	0	0	77.1305346085
552	155	1	0	1	77.218169091
552	158	1	0	1	65.4697058688
552	159	1	0	1	67.4478620518
552	164	2	0	2	79.4549938978
552	166	2	0	2	71.2783503186
552	168	3	0	3	76.1018071327
552	172	2	0	2	73.8065879507
552	177	4	0	4	69.8686983356
552	243	1	0	1	192.138103353
552	319	11	1	10	51.8421608083
552	323	1	0	1	52.6908177818
552	329	1	0	1	70.4121350578
552	338	0	0	0	80.3606311289
552	354	1	0	1	75.7741080901
552	356	1	0	1	51.6733375172
552	358	0	0	0	45.234161997
552	364	1	0	1	52.4152316526
552	385	1	0	1	50.077758004
552	392	1	0	1	53.7534280994
552	396	1	0	1	76.4392396544
552	406	0	0	0	80.210789939
552	408	6	0	6	75.1028230802
552	410	1	0	1	72.4851373351
552	411	0	0	0	68.143912731
552	415	3	0	3	69.736720207
552	416	0	0	0	84.0265350523
552	419	1	1	0	75.2644251202
552	426	1	0	1	101.172976509
552	441	0	0	0	76.9887530396
552	442	1	0	1	84.8913202015
552	475	3	0	3	81.7372798172
552	503	1	0	1	83.7467519969
552	507	6	0	6	76.1298217897
552	512	3	0	3	58.4114135269
552	523	2	0	2	47.2902385829
552	524	37	7	30	30.7314809732
552	525	2	0	2	29.3813764528
552	529	7	0	7	33.8882482383
552	530	5	1	4	33.2703946036
552	531	3	1	2	12.797252118
552	532	1	0	1	41.8224855909
552	534	9	0	9	24.0783888392
552	535	2	0	2	43.6777206029
552	536	8	0	8	24.4672987837
552	537	4	1	3	28.7278222502
552	538	9	3	6	19.5869553533
552	539	35	0	35	11.0471224363
552	540	17	1	16	37.3379036423
552	541	2	0	2	52.0441718014
552	543	1	0	1	48.7094041447
552	547	2	0	2	59.2051078512
552	548	1	0	1	73.1128299768
552	549	2	0	2	62.061930426
552	551	7	0	7	27.0794358236
552	553	23	2	21	19.6220166942
552	554	27	1	26	23.0586414384
552	555	127	38	89	17.4038514728
552	556	32	1	31	12.599082369
552	558	2	0	2	36.4905839797
552	559	96	2	94	10.9423680962
552	560	9	1	8	21.1198917104
552	561	34	6	28	17.0104359635
552	563	33	0	33	25.8402800349
552	564	15	0	15	14.5064873419
552	565	8	3	5	27.137092491
552	566	4	0	4	44.427742417
552	567	1	0	1	31.5395283963
552	569	2	0	2	40.5181811273
552	570	1	0	1	38.5739493217
552	573	123	3	120	41.2569608042
552	577	1	0	1	45.8438870733
552	579	2	0	2	46.4782480085
552	580	1	0	1	49.6187162815
552	581	5	2	3	54.139726117
552	582	1	0	1	38.0058030886
552	583	2	0	2	34.2271454309
552	584	3	0	3	18.9611359656
552	585	13	0	13	29.0423735315
552	586	4	1	3	27.3472990547
552	587	1	0	1	41.6158674963
552	588	3	1	2	23.7653760563
553	1	0	0	0	155.066539184
553	7	1	0	1	143.412004439
553	70	1	0	1	113.286946825
553	71	1	0	1	107.05021689
553	73	4	0	4	115.219763914
553	74	2	0	2	110.599862696
553	75	1	0	1	113.89193038
553	76	1	0	1	110.815595824
553	78	2	0	2	110.020678569
553	82	2	0	2	111.713334803
553	83	1	0	1	113.437180672
553	84	2	0	2	113.782408466
553	85	1	0	1	107.235483275
553	87	0	0	0	111.107416772
553	90	1	0	1	105.293576785
553	103	1	0	1	116.45849702
553	121	1	0	1	109.053732245
553	142	0	0	0	109.092889448
553	172	1	0	1	93.3470536986
553	177	2	0	2	89.3062703169
553	183	1	0	1	194.170675382
553	277	2	0	2	157.518592761
553	319	3	0	3	69.4143492027
553	338	0	0	0	95.1247252589
553	345	0	0	0	154.834699249
553	347	1	0	1	99.2538484063
553	364	1	0	1	67.4983061242
553	366	0	0	0	62.4449167083
553	385	1	0	1	66.8519491715
553	408	1	0	1	88.7727333078
553	411	0	0	0	82.1688870865
553	416	1	0	1	96.9760998034
553	507	11	0	11	61.9949105021
553	511	0	0	0	66.3438247663
553	515	1	0	1	59.1004581496
553	519	1	0	1	38.1179242508
553	524	3	0	3	39.4558798742
553	529	34	4	30	17.9163151046
553	530	33	0	33	13.6837233511
553	531	1	0	1	9.74211949736
553	533	0	0	0	41.1561304177
553	534	5	1	4	16.8392141215
553	535	4	0	4	30.6847459313
553	536	43	1	42	8.54884078809
553	537	2	0	2	26.6489840508
553	539	2	0	2	16.3668784768
553	540	29	0	29	28.9562785802
553	542	1	0	1	51.1318296722
553	543	1	0	1	30.0889677688
553	546	1	0	1	58.0267955153
553	548	1	0	1	55.6742659684
553	550	1	0	1	54.4310436308
553	551	1	0	1	46.5967852754
553	552	21	16	5	19.6220166942
553	554	2	0	2	39.3435284744
553	555	5	0	5	36.8251345271
553	556	18	4	14	10.8710470452
553	559	2	0	2	29.3885526377
553	561	3	0	3	28.2360213776
553	563	1	0	1	45.2052996355
553	565	28	11	17	10.9145574006
553	566	1	0	1	62.8783630819
553	567	1	0	1	50.4713238122
553	573	19	2	17	60.7989950674
553	579	1	0	1	65.8590263402
553	581	1	0	1	73.7201737692
553	585	3	0	3	46.1533061432
553	586	0	0	0	41.3204793289
554	1	4	0	4	121.523763915
554	5	1	0	1	123.676443887
554	36	1	0	1	96.8350093074
554	68	1	0	1	94.622405816
554	70	14	0	14	85.4941201508
554	71	4	0	4	77.1701227905
554	72	1	0	1	88.3681798412
554	73	150	7	143	85.3875697525
554	74	17	0	17	81.0804228581
554	75	15	1	14	83.5909795837
554	76	7	1	6	82.7829667465
554	78	22	0	22	80.9656719606
554	79	2	0	2	88.5348330172
554	80	1	0	1	86.8296722799
554	81	2	0	2	86.4372921416
554	82	30	1	29	83.0696639013
554	83	2	1	1	83.9923034441
554	84	18	0	18	83.9494716121
554	85	6	0	6	79.0264978999
554	86	8	0	8	76.3637448553
554	87	6	0	6	80.7561219657
554	88	3	0	3	78.7849855563
554	90	1	0	1	78.931331003
554	92	1	0	1	90.3245743077
554	95	1	0	1	91.7188526016
554	98	1	0	1	72.416709685
554	103	4	0	4	85.1770962896
554	109	1	0	1	84.6754988309
554	113	6	0	6	80.6196869478
554	116	1	0	1	81.8940277682
554	140	1	0	1	79.308899868
554	142	3	0	3	74.2302154299
554	145	1	0	1	81.5453408486
554	155	3	0	3	70.5037517463
554	157	1	0	1	55.6104172389
554	163	1	0	1	54.3042980895
554	164	1	0	1	69.7117748854
554	166	2	0	2	66.7972332468
554	167	2	0	2	46.9099623181
554	168	8	1	7	65.6006164435
554	171	0	0	0	70.6130226419
554	172	14	0	14	62.1869796138
554	173	2	0	2	50.1667027344
554	176	1	0	1	48.0999425001
554	177	25	1	24	59.5808562596
554	178	1	0	1	46.2083678109
554	180	1	0	1	50.2518903497
554	208	1	0	1	143.996309982
554	277	0	0	0	133.083359011
554	307	1	0	1	122.528967608
554	310	0	0	0	104.051179506
554	314	1	0	1	100.62359585
554	319	31	0	31	51.6544303057
554	320	2	0	2	44.9132217441
554	321	2	0	2	59.8602973006
554	322	1	0	1	44.7821627555
554	323	3	1	2	47.8874109594
554	329	1	0	1	68.3444895352
554	338	4	0	4	84.1386064466
554	349	1	0	1	72.183997288
554	361	1	0	1	63.2774295019
554	375	1	0	1	127.421455457
554	379	1	1	0	34.2575193261
554	381	8	5	3	22.0006801309
554	382	2	1	1	38.5453310585
554	384	1	0	1	30.1672296709
554	385	15	0	15	27.5524284133
554	387	1	0	1	25.9833107899
554	388	1	0	1	33.8873430781
554	392	1	0	1	31.6804247417
554	393	1	0	1	36.1933311021
554	394	2	0	2	37.1802206094
554	395	1	0	1	29.2817904206
554	396	1	0	1	53.3847916094
554	398	1	0	1	46.0995184804
554	399	1	0	1	65.0606329444
554	406	7	0	7	57.2116668729
554	408	29	1	28	52.1819741225
554	411	3	1	2	45.1748843979
554	415	7	0	7	46.7012980099
554	417	2	0	2	42.857910837
554	430	1	0	1	47.3102008175
554	433	2	2	0	67.6672853751
554	441	0	0	0	56.0803390631
554	442	0	0	0	63.3496222259
554	454	2	0	2	44.7017612653
554	455	1	0	1	44.2421767823
554	460	1	0	1	48.2916975907
554	465	2	0	2	74.3785178188
554	471	1	0	1	94.7297560374
554	475	1	0	1	60.4323798877
554	507	11	3	8	81.7092801819
554	512	5	0	5	53.5918591854
554	515	1	0	1	48.2132929132
554	516	1	1	0	54.7979960617
554	520	3	0	3	27.8908223942
554	522	2	0	2	22.0611629818
554	523	1	0	1	36.2587589896
554	524	181	65	116	17.1006879673
554	525	3	0	3	22.3932487855
554	526	2	0	2	28.6761961607
554	527	1	0	1	32.2820108046
554	529	1	0	1	47.0503697869
554	535	1	0	1	51.5643377351
554	536	6	0	6	40.2518522253
554	537	2	0	2	30.2674799847
554	538	3	0	3	22.8059009209
554	539	1	0	1	23.3520480552
554	540	16	0	16	41.8426834425
554	548	0	0	0	84.0801557717
554	549	2	0	2	69.1730689253
554	551	15	0	15	22.8682963393
554	552	28	1	27	23.0586414384
554	555	160	1	159	12.9511296342
554	556	2	0	2	35.3726264742
554	557	51	11	40	7.6079339699
554	558	23	7	16	13.5468247093
554	559	11	0	11	12.5983778204
554	560	6	1	5	22.0866866765
554	561	77	0	77	12.9536179516
554	562	14	2	12	14.3544121338
554	563	65	1	64	14.3283208223
554	564	19	0	19	22.6786341168
554	565	3	0	3	48.9157376854
554	566	31	0	31	24.5969132203
554	567	54	26	28	14.9498771003
554	568	3	0	3	38.8131078781
554	569	8	0	8	31.8738314131
554	570	1	0	1	34.2374420607
554	571	8	0	8	17.7052728164
554	572	2	0	2	32.6138947332
554	573	599	53	546	27.6662292545
554	574	5	1	4	18.7532509231
554	575	12	0	12	23.955896216
554	576	2	0	2	46.6557818641
554	577	9	1	8	40.685064276
554	578	5	1	4	33.0631886348
554	579	4	0	4	38.8411230581
554	580	3	0	3	36.4605668735
554	581	26	0	26	43.1521561243
554	583	1	1	0	52.4797257399
554	585	11	0	11	34.9737705608
554	586	7	0	7	39.6488310138
554	587	1	0	1	48.8844342865
555	11	1	0	1	132.119991736
555	36	1	0	1	93.3842001982
555	70	7	0	7	79.1680674061
555	71	1	0	1	71.8589024928
555	73	75	2	73	80.1242957859
555	74	14	1	13	75.605811824
555	75	9	0	9	78.578210159
555	76	5	0	5	76.5473007891
555	78	17	3	14	75.2385357152
555	81	6	0	6	80.5541124458
555	82	4	0	4	77.147381243
555	83	7	0	7	78.5038443805
555	84	10	1	9	78.6743906384
555	85	2	0	2	72.8385747605
555	86	4	0	4	70.7426642767
555	87	5	0	5	75.7486235506
555	88	6	0	6	73.7230683241
555	92	1	0	1	83.808491445
555	93	1	0	1	87.7583621985
555	109	1	0	1	77.5902318318
555	110	1	0	1	81.0266417016
555	112	4	1	3	83.8315903393
555	113	5	0	5	76.3294946745
555	141	0	0	0	56.8307760788
555	142	3	1	2	72.3513062325
555	154	1	0	1	59.9264622108
555	157	1	0	1	51.8673052711
555	161	1	0	1	51.3032333224
555	162	1	0	1	65.3350781825
555	164	1	0	1	63.8554864462
555	165	1	0	1	48.7332263849
555	166	2	0	2	58.0407016865
555	168	7	0	7	60.1853462072
555	171	1	0	1	63.8764819825
555	172	18	2	16	57.4871015265
555	173	2	0	2	44.0853525195
555	177	11	1	10	53.9618638508
555	183	3	1	2	164.021019919
555	229	1	0	1	148.896240557
555	307	1	0	1	117.560853986
555	310	0	0	0	93.5499716384
555	319	36	0	36	40.8382031143
555	320	1	0	1	34.09992649
555	321	1	0	1	49.4048471344
555	322	1	0	1	34.8506673398
555	323	2	0	2	38.9290793605
555	324	1	0	1	47.4837918962
555	329	1	0	1	58.5456652273
555	338	3	0	3	72.532125144
555	349	2	0	2	61.1235430868
555	356	1	0	1	48.7008617616
555	358	2	0	2	49.8384099524
555	364	1	0	1	45.6927012945
555	366	2	0	2	38.5965693499
555	368	1	0	1	53.0895255495
555	370	0	0	0	117.20508434
555	375	2	0	2	116.16278003
555	379	1	0	1	42.6887007875
555	380	1	0	1	38.685995189
555	381	2	1	1	33.2963873711
555	383	1	0	1	48.2060662249
555	385	3	0	3	35.0307364611
555	387	2	1	1	35.5825473492
555	389	1	0	1	42.9958477225
555	392	1	0	1	38.0245502151
555	402	1	0	1	52.0517386551
555	406	2	0	2	67.1968609396
555	407	2	0	2	67.1371922747
555	408	11	0	11	62.5513620968
555	411	2	0	2	55.4567743964
555	415	3	0	3	55.68716847
555	428	0	0	0	79.0294627285
555	441	0	0	0	68.4629270542
555	442	0	0	0	75.3613189184
555	460	1	0	1	54.4881978298
555	469	0	0	0	80.5414974346
555	475	3	0	3	65.048239387
555	507	4	0	4	88.231543396
555	512	5	2	3	63.8819719289
555	520	1	1	0	40.6609494866
555	521	1	0	1	44.0143355325
555	522	1	0	1	34.8794836163
555	523	0	0	0	48.0708787723
555	524	39	1	38	28.8510553707
555	526	1	0	1	41.0268145124
555	529	3	1	2	49.0194590521
555	530	1	0	1	50.3256954184
555	531	0	0	0	28.652958924
555	534	1	0	1	36.7887906903
555	535	3	1	2	56.4734093405
555	536	3	0	3	40.4434815529
555	537	4	2	2	37.1005900155
555	538	0	0	0	27.9255678487
555	539	3	1	2	23.7911987535
555	540	5	0	5	48.0286468713
555	541	1	0	1	67.0308266435
555	548	1	0	1	87.8678748585
555	551	43	0	43	12.2051515833
555	552	43	14	29	17.4038514728
555	553	1	0	1	36.8251345271
555	554	166	36	130	12.9511296342
555	556	2	1	1	29.617030716
555	557	9	1	8	17.0291608823
555	558	3	1	2	24.9791722802
555	559	30	1	29	8.23763113921
555	560	11	6	5	9.38828980402
555	561	15	1	14	19.1054210216
555	562	1	0	1	27.291058982
555	563	152	4	148	8.43740616779
555	564	19	1	18	10.3088269753
555	565	3	1	2	44.4429400874
555	566	25	3	22	27.6293647827
555	567	9	3	6	14.4574515587
555	568	1	0	1	37.6711123421
555	569	21	4	17	24.5485252358
555	571	0	0	0	20.7788925114
555	572	4	0	4	20.990808793
555	573	387	0	387	24.0001410074
555	575	20	3	17	16.1829620468
555	577	12	1	11	31.6850962318
555	579	3	0	3	31.1514616692
555	580	4	2	2	32.5822450633
555	581	16	3	13	37.7543233453
555	583	3	1	2	40.4815515429
555	584	1	0	1	20.9541892665
555	585	24	8	16	22.1838697633
555	586	19	0	19	26.8121815406
556	1	1	0	1	146.125900917
556	70	2	0	2	103.407794604
556	73	17	14	3	105.664972945
556	74	3	0	3	101.023448679
556	75	1	0	1	104.435055226
556	78	6	0	6	100.367635813
556	81	5	0	5	105.337321146
556	82	1	0	1	101.978558432
556	84	2	0	2	104.238315336
556	85	1	0	1	97.4655702997
556	87	4	0	4	101.682097709
556	88	1	0	1	99.6518591405
556	92	1	0	1	107.64378648
556	113	1	0	1	102.967378237
556	142	2	0	2	100.829444452
556	168	1	0	1	86.1727651353
556	171	1	0	1	88.1172494592
556	177	0	0	0	79.9933764735
556	220	1	0	1	195.016315275
556	319	3	0	3	58.9036812513
556	323	0	0	0	61.5299544464
556	332	1	0	1	92.6982266587
556	338	1	0	1	84.2554894882
556	349	2	0	2	76.016702777
556	385	1	0	1	62.6204587648
556	406	1	0	1	92.2364633323
556	408	1	0	1	87.0232007098
556	411	1	0	1	80.1442388399
556	415	1	0	1	82.0590070305
556	441	0	0	0	87.4723045426
556	442	0	0	0	95.6945316081
556	507	7	1	6	72.6009067153
556	512	2	0	2	61.500135832
556	523	1	0	1	54.1203878986
556	524	9	1	8	40.1985997917
556	529	13	0	13	28.5603739331
556	530	11	1	10	23.6855254802
556	531	5	0	5	11.9130970361
556	534	4	1	3	24.0010521488
556	535	1	0	1	40.7974815272
556	536	23	8	15	18.8070077267
556	537	4	0	4	32.2159006861
556	539	9	1	8	16.3330917458
556	540	30	2	28	37.4191367768
556	542	1	0	1	61.9569272084
556	543	1	0	1	40.7679273667
556	548	1	1	0	66.5166321706
556	551	3	0	3	37.775369757
556	552	95	27	68	12.599082369
556	553	62	4	58	10.8710470452
556	554	5	1	4	35.3726264742
556	555	28	0	28	29.617030716
556	559	4	2	2	23.5349682795
556	561	10	0	10	27.0273788823
556	563	4	0	4	38.0088602189
556	564	2	0	2	24.0678273245
556	565	18	0	18	14.9525131127
556	566	3	2	1	56.9583982031
556	569	1	0	1	51.1919667936
556	570	1	0	1	48.1377465347
556	573	37	1	36	52.9929377032
556	575	2	0	2	43.785700102
556	577	0	0	0	55.1743601775
556	579	2	0	2	56.5555959147
556	581	0	0	0	64.8688864628
556	583	1	0	1	30.7317341109
556	585	2	0	2	35.6739647809
556	586	2	0	2	30.4599720933
557	70	4	0	4	81.0510571315
557	71	2	0	2	72.2742071204
557	72	1	0	1	83.720235243
557	73	84	2	82	80.4003647927
557	74	10	0	10	76.2310706615
557	75	9	2	7	78.4969665494
557	76	5	0	5	78.313182709
557	78	15	0	15	76.2447727731
557	79	1	0	1	83.6998081879
557	80	1	0	1	82.0822778974
557	81	3	0	3	81.7528363752
557	82	8	0	8	78.4318229896
557	83	2	0	2	79.126355995
557	84	11	1	10	78.9788169672
557	85	4	2	2	74.5641747937
557	86	1	0	1	71.6305624239
557	87	7	1	6	75.6819301627
557	88	2	0	2	73.7533949973
557	89	1	0	1	90.9736651411
557	103	1	0	1	79.7976369227
557	112	2	0	2	82.6599654918
557	113	5	0	5	75.2172398901
557	123	1	0	1	95.9120511538
557	128	1	0	1	60.822631371
557	142	1	0	1	67.9285368912
557	146	1	0	1	69.2344848306
557	154	1	0	1	55.5618272423
557	155	2	0	2	66.9438944876
557	158	1	0	1	52.0075142717
557	163	1	0	1	47.797931269
557	167	2	0	2	41.2975496885
557	168	5	0	5	60.8851288276
557	171	1	0	1	66.5435869845
557	172	5	0	5	57.1671819627
557	177	17	0	17	55.0599981514
557	183	1	0	1	168.43186536
557	245	1	0	1	101.36244203
557	247	0	0	0	100.229936373
557	265	1	0	1	140.858157889
557	311	1	0	1	105.062635774
557	319	15	1	14	50.8729057381
557	320	2	0	2	44.3033273834
557	323	3	0	3	45.6809647587
557	329	1	0	1	66.3790089076
557	336	1	0	1	90.2016875944
557	338	1	0	1	83.7866964387
557	356	3	1	2	63.709968725
557	364	0	0	0	58.8581915848
557	379	0	0	0	26.9286840999
557	381	4	2	2	16.282850468
557	383	2	0	2	31.5027810845
557	385	12	7	5	19.9984892128
557	386	3	1	2	16.1412530978
557	387	1	0	1	19.006844494
557	389	2	0	2	26.050800077
557	392	2	0	2	24.0728326521
557	394	1	0	1	30.2123812654
557	396	2	0	2	46.374700087
557	406	3	1	2	50.5790699806
557	407	1	0	1	50.9603077677
557	408	19	0	19	45.7558218449
557	411	1	0	1	38.677538369
557	412	1	0	1	53.2297437968
557	415	3	1	2	39.6054055314
557	432	1	0	1	72.4485224909
557	435	1	0	1	53.4020193537
557	438	1	0	1	53.7072810881
557	440	1	0	1	47.3998108395
557	441	1	0	1	51.7504810029
557	442	0	0	0	58.413830573
557	453	1	0	1	40.8148753518
557	506	1	0	1	66.2841574979
557	507	1	0	1	87.2145274571
557	509	1	0	1	96.2627895827
557	512	2	1	1	56.9205967107
557	520	3	0	3	24.886178119
557	524	63	3	60	20.3025202501
557	525	1	0	1	27.2010389944
557	529	2	0	2	54.2588930121
557	530	1	0	1	59.2017630836
557	534	1	0	1	40.5326297409
557	536	1	0	1	47.7490089337
557	537	1	0	1	36.3547794115
557	539	1	0	1	30.9381338738
557	540	9	0	9	47.9165911836
557	541	1	0	1	70.9281860929
557	548	1	0	1	90.6284679004
557	551	6	3	3	23.4901119514
557	552	9	3	6	30.2267951774
557	554	404	45	359	7.6079339699
557	555	50	1	49	17.0291608823
557	556	1	0	1	42.7002066817
557	558	20	9	11	8.15285273302
557	559	3	1	2	19.4097185286
557	560	4	0	4	24.7799329439
557	561	11	0	11	20.1390658542
557	562	3	1	2	13.389180652
557	563	35	0	35	14.185040239
557	564	2	0	2	27.337252773
557	566	37	7	30	17.6350673993
557	567	43	0	43	11.2536010527
557	568	3	0	3	32.7625504986
557	569	6	0	6	29.3204987664
557	571	10	3	7	11.3009782734
557	573	351	0	351	23.3860281506
557	574	5	1	4	11.1455375023
557	575	5	1	4	22.4793764142
557	577	2	0	2	38.7580480177
557	578	2	0	2	26.4367202928
557	579	5	0	5	36.1112244069
557	580	2	0	2	31.71073857
557	581	16	3	13	38.9100225661
557	585	4	0	4	37.2902673082
557	586	2	0	2	43.4512712529
557	588	1	0	1	48.304628635
558	33	0	0	0	96.6712742881
558	70	3	0	3	85.1755226451
558	73	33	2	31	83.8681765376
558	74	4	0	4	79.9054951378
558	75	2	0	2	81.8386007317
558	78	3	0	3	80.077227555
558	79	1	0	1	87.3386730498
558	82	3	0	3	82.3476489568
558	83	1	0	1	82.7580936649
558	84	2	0	2	82.4783496255
558	86	2	0	2	75.4859889625
558	87	3	1	2	79.0717880451
558	88	3	0	3	77.2151296581
558	89	1	0	1	94.8515002921
558	113	1	0	1	78.1581562613
558	116	0	0	0	81.9353667589
558	121	1	0	1	75.6146077414
558	142	0	0	0	69.443431507
558	155	1	0	1	72.0872022478
558	163	1	0	1	49.186382999
558	167	1	0	1	44.4257724905
558	168	2	1	1	64.8705464355
558	172	1	0	1	60.8217150535
558	177	3	0	3	59.3466441533
558	319	3	0	3	58.0683935643
558	323	1	0	1	52.1232312942
558	330	1	0	1	47.8653846936
558	331	1	0	1	59.6126992452
558	347	0	0	0	83.2245381639
558	353	1	0	1	88.6337348548
558	375	0	0	0	133.269149996
558	379	3	0	3	21.800401082
558	381	26	3	23	8.48203654218
558	382	0	0	0	26.9220123548
558	383	1	0	1	23.3544069347
558	384	0	0	0	22.3641713302
558	385	36	7	29	16.5045760409
558	386	3	0	3	11.8336892016
558	387	9	4	5	13.0438839463
558	388	2	0	2	20.4487542261
558	389	4	1	3	18.0198580204
558	391	7	0	7	25.824424939
558	392	2	0	2	21.3310789919
558	394	4	0	4	24.0038648032
558	395	4	0	4	15.761100202
558	396	2	0	2	40.1530811226
558	404	1	0	1	30.0255561708
558	406	3	1	2	43.7202059831
558	407	1	0	1	44.6752212168
558	408	52	0	52	38.645011608
558	411	12	4	8	31.6581342397
558	412	0	0	0	45.6032842524
558	413	1	0	1	34.4531312961
558	414	0	0	0	52.2832936233
558	415	4	0	4	33.6071263312
558	417	1	0	1	29.5791195524
558	425	1	0	1	52.4937814411
558	426	1	0	1	67.9846874496
558	438	1	0	1	45.5655786912
558	442	1	0	1	50.382185006
558	459	1	0	1	27.3719487355
558	469	1	0	1	64.0134500016
558	507	3	0	3	85.6919804944
558	512	4	0	4	53.0436431197
558	520	16	3	13	17.0442797346
558	521	1	0	1	23.1368706205
558	522	4	0	4	16.7551271467
558	524	57	3	54	18.2045367527
558	525	1	0	1	26.1849312091
558	526	1	0	1	24.8611602665
558	528	1	0	1	30.5146753918
558	529	1	0	1	56.4080098706
558	532	1	0	1	63.0896424791
558	536	1	0	1	51.0530094782
558	537	1	0	1	36.6130313044
558	540	4	0	4	47.7993711096
558	548	1	0	1	90.8712165665
558	551	2	0	2	31.4510048003
558	554	141	29	112	13.5468247093
558	555	24	2	22	24.9791722802
558	557	23	16	7	8.15285273302
558	559	1	0	1	26.1432272319
558	561	3	1	2	23.3951364423
558	562	9	3	6	8.48507284246
558	563	7	0	7	22.1823863512
558	564	1	0	1	35.2494633136
558	566	18	5	13	19.4118744607
558	567	9	1	8	18.1725290918
558	568	0	0	0	35.4578034399
558	569	0	0	0	35.857363452
558	571	12	1	11	15.3977159462
558	573	112	23	89	28.8156128893
558	574	10	6	4	10.121255536
558	575	1	0	1	29.8050262251
558	578	2	0	2	28.3052042093
558	579	0	0	0	42.3583435443
558	580	2	0	2	36.2676184627
558	581	7	2	5	43.796719971
558	585	3	1	2	45.4166955504
558	586	3	0	3	51.5671409072
559	70	3	0	3	87.3865192487
559	71	1	0	1	80.093880055
559	73	32	0	32	88.3599895074
559	74	3	0	3	83.8431778437
559	75	3	0	3	86.8079553145
559	76	1	0	1	84.7710825774
559	78	14	12	2	83.4754737688
559	79	1	0	1	91.1547418302
559	81	2	0	2	88.7877768579
559	82	0	0	0	85.3809470052
559	83	1	0	1	86.7414017533
559	84	5	0	5	86.9100384952
559	85	3	0	3	81.0658101241
559	86	1	0	1	78.9802942073
559	87	3	0	3	83.9772596276
559	88	1	0	1	81.9526599085
559	103	1	0	1	88.9639519298
559	107	1	0	1	73.112144413
559	110	1	0	1	89.1814879782
559	113	3	0	3	84.5222219255
559	135	0	0	0	66.5805967542
559	142	0	0	0	80.2332368141
559	155	2	0	2	71.0387142111
559	169	1	0	1	80.3491629641
559	177	2	0	2	62.1971881444
559	205	1	0	1	127.884551815
559	237	1	0	1	141.045261612
559	262	0	0	0	120.34487935
559	272	1	0	1	137.918856594
559	277	0	0	0	133.737645559
559	307	0	0	0	125.796038164
559	310	1	0	1	100.714057661
559	319	8	0	8	48.0988554316
559	332	1	0	1	89.5938441073
559	338	1	0	1	78.9896810923
559	339	1	0	1	85.9675556074
559	349	1	0	1	68.071995727
559	356	1	0	1	53.1559743929
559	360	1	0	1	46.7425598
559	367	1	0	1	61.2704904948
559	370	1	0	1	124.212610697
559	408	7	0	7	64.7636141098
559	410	1	0	1	61.9705631086
559	411	0	0	0	57.7414493902
559	415	1	0	1	59.0060270737
559	438	1	0	1	69.1140677242
559	441	0	0	0	68.1332395386
559	468	1	0	1	85.2330627799
559	493	1	0	1	106.986664946
559	494	0	0	0	79.6532466018
559	507	3	0	3	80.2203458256
559	512	1	0	1	57.3455952345
559	519	1	0	1	41.5134014582
559	522	1	0	1	31.9043057407
559	524	19	0	19	24.4050452856
559	525	1	0	1	25.9504482866
559	526	1	0	1	36.836794975
559	528	1	0	1	48.3160155501
559	529	1	0	1	40.8164166888
559	531	1	0	1	20.7185075717
559	534	2	0	2	28.5755181172
559	536	1	0	1	32.3969058895
559	537	1	0	1	29.4758288979
559	538	1	0	1	20.087749193
559	539	6	1	5	15.5745943248
559	540	2	0	2	40.1044935717
559	548	0	0	0	79.6302446174
559	551	4	2	2	20.1555340038
559	552	67	28	39	10.9423680962
559	553	4	0	4	29.3885526377
559	554	63	0	63	12.5983778204
559	555	110	0	110	8.23763113921
559	556	3	0	3	23.5349682795
559	557	4	0	4	19.4097185286
559	558	1	0	1	26.1432272319
559	560	3	0	3	15.8898354232
559	561	33	7	26	12.2855200545
559	562	2	0	2	25.7905016966
559	563	20	6	14	16.108216344
559	564	12	4	8	12.6544318565
559	565	2	1	1	37.8619217886
559	566	5	0	5	33.6823635212
559	567	1	1	0	21.0830983361
559	569	3	0	3	32.7837433808
559	571	1	0	1	26.544406614
559	572	1	0	1	28.0913836683
559	573	120	30	90	31.8977457186
559	575	5	0	5	24.4197853208
559	577	3	0	3	39.6997281704
559	578	2	0	2	40.9463701054
559	579	1	0	1	39.3507714174
559	581	9	0	9	45.9646396945
559	583	1	0	1	40.7116078018
559	585	9	0	9	27.5019457213
559	586	6	1	5	29.6201703008
560	1	0	0	0	114.807550058
560	13	1	0	1	99.465487621
560	70	4	2	2	73.1269735142
560	71	1	0	1	66.6236172009
560	73	16	2	14	74.8101386731
560	74	3	0	3	70.2011540433
560	75	6	0	6	73.4593166402
560	76	2	0	2	70.5986462467
560	78	5	1	4	69.6612728227
560	80	1	0	1	75.3879695518
560	82	3	0	3	71.4093760273
560	83	1	0	1	73.0520361355
560	84	2	0	2	73.3699265987
560	87	2	0	2	70.6717431999
560	89	1	0	1	83.3938489311
560	95	1	0	1	82.0996888476
560	103	1	0	1	76.0327509097
560	113	3	0	3	71.753580575
560	146	1	0	1	65.66437023
560	155	3	0	3	56.2030992959
560	158	0	0	0	44.4029804068
560	166	1	0	1	50.586915051
560	168	4	0	4	55.090143623
560	171	1	0	1	57.7537488478
560	172	5	0	5	52.9846596237
560	175	1	0	1	53.0973566689
560	177	4	0	4	48.8700591029
560	277	0	0	0	118.606653223
560	281	0	0	0	108.854934432
560	310	0	0	0	84.8265429395
560	319	21	0	21	32.2197962034
560	320	2	0	2	25.5969664342
560	324	1	0	1	38.4654621284
560	325	1	0	1	22.4054712388
560	327	1	0	1	33.8663690484
560	345	0	0	0	122.488270851
560	347	1	0	1	61.7907965432
560	349	1	0	1	52.2119709101
560	356	0	0	0	39.4834783047
560	360	1	0	1	34.7298605766
560	375	2	0	2	107.063996156
560	379	1	0	1	48.090052844
560	382	1	0	1	59.6859191302
560	391	1	0	1	47.9881100219
560	396	2	1	1	67.9751222927
560	408	0	0	0	68.8970073111
560	411	1	1	0	61.8374752097
560	441	0	0	0	76.5195152392
560	451	1	0	1	64.9574497797
560	471	1	0	1	100.201810012
560	507	1	0	1	95.750127968
560	524	10	1	9	38.2376235707
560	537	1	0	1	45.3565773602
560	540	1	0	1	55.8173593738
560	548	0	0	0	94.008157785
560	551	25	17	8	6.50584257587
560	552	8	1	7	21.1198917104
560	553	1	1	0	40.4374008065
560	554	25	1	24	22.0866866765
560	555	156	64	92	9.38828980402
560	557	3	2	1	24.7799329439
560	559	4	1	3	15.8898354232
560	561	1	0	1	27.8974374679
560	563	26	9	17	11.6429851973
560	564	19	1	18	7.32066686535
560	565	1	0	1	46.208528672
560	566	6	2	4	30.631660422
560	567	4	1	3	18.1308017756
560	569	4	1	3	19.8309509977
560	570	1	0	1	17.4758175253
560	571	1	0	1	24.8675447475
560	572	7	0	7	12.2160602196
560	573	106	10	96	22.6690513077
560	574	1	0	1	31.8233488122
560	575	8	1	7	12.8292177985
560	576	2	0	2	33.1435331568
560	577	7	0	7	24.7656070942
560	579	6	0	6	25.422786765
560	581	5	1	4	33.5087233974
560	583	2	0	2	34.1964866896
560	585	34	1	33	12.8872705037
560	586	7	0	7	18.907895578
560	588	1	0	1	26.5478196337
561	0	1	0	1	121.813126968
561	1	3	0	3	134.286310531
561	7	1	0	1	122.678484125
561	23	1	0	1	127.852117531
561	32	1	0	1	123.157292499
561	36	1	0	1	109.441924424
561	52	1	0	1	101.078901022
561	70	6	0	6	97.1165091346
561	71	3	1	2	89.1883782285
561	73	59	0	59	97.44506725
561	74	4	0	4	93.0483559934
561	75	4	0	4	95.7326627826
561	76	2	0	2	94.4397346739
561	78	5	0	5	92.8342321858
561	79	1	0	1	100.465592714
561	81	4	0	4	98.2555295972
561	82	12	0	12	94.8633511131
561	83	2	0	2	95.9624113871
561	84	9	1	8	95.9991938531
561	85	3	0	3	90.6946251727
561	87	7	0	7	92.892405449
561	89	1	0	1	107.296319669
561	111	1	0	1	106.515752511
561	112	1	0	1	100.497458781
561	113	2	0	2	92.9817166648
561	142	0	0	0	87.0687156703
561	153	1	0	1	80.4966176758
561	155	2	0	2	81.4293049355
561	156	1	0	1	85.5285780453
561	157	1	0	1	68.0323695128
561	158	1	0	1	67.6641980359
561	166	1	0	1	76.9477561522
561	168	5	0	5	77.5397198993
561	172	5	0	5	74.3619529652
561	177	7	0	7	71.4136674442
561	191	1	0	1	191.088328283
561	229	1	0	1	167.999667923
561	309	1	0	1	128.085151922
561	310	0	0	0	112.608590643
561	319	17	0	17	59.9051166671
561	321	1	0	1	68.5010655322
561	323	1	0	1	57.8279712165
561	325	1	0	1	50.2983337318
561	328	0	0	0	68.5960290621
561	329	0	0	0	77.6391029991
561	338	0	0	0	91.1899385468
561	339	2	0	2	98.2231004052
561	349	1	0	1	80.0833626025
561	350	2	0	2	113.046270567
561	356	2	0	2	65.2987688243
561	357	1	0	1	75.8674799493
561	358	1	1	0	61.6596329154
561	359	2	0	2	75.1376306659
561	375	1	0	1	134.948550923
561	379	2	0	2	45.1885518354
561	381	1	0	1	30.8382941009
561	385	2	0	2	39.3137982832
561	387	1	0	1	36.4290462558
561	391	2	0	2	48.8149129875
561	392	1	0	1	43.7926621961
561	394	1	0	1	47.1978172952
561	396	1	0	1	63.1662877074
561	398	2	0	2	50.4699402676
561	407	1	0	1	67.6040588077
561	408	23	4	19	60.6813323194
561	411	3	0	3	53.9938754248
561	413	1	0	1	53.5615478322
561	414	1	0	1	74.4504007398
561	416	1	0	1	69.1151026894
561	417	1	0	1	52.6085036563
561	421	1	0	1	77.3893918776
561	426	0	0	0	84.4917272394
561	433	1	0	1	69.0908336254
561	437	2	0	2	69.5866015934
561	441	0	0	0	60.5007767188
561	442	0	0	0	68.6700231348
561	451	1	0	1	63.6532145276
561	469	2	0	2	87.1419382747
561	480	1	0	1	96.3507911569
561	507	33	12	21	69.8037533489
561	509	1	0	1	78.0390971887
561	510	1	0	1	55.3030981321
561	511	1	0	1	75.849282935
561	512	17	5	12	45.0947770321
561	517	1	0	1	39.8582261003
561	519	4	1	3	29.5012212101
561	520	5	0	5	32.0655328006
561	521	2	0	2	31.7121062558
561	522	7	1	6	22.4248370108
561	523	6	0	6	31.1247299361
561	524	428	35	393	13.7214255609
561	525	23	5	18	13.6991494572
561	526	4	2	2	25.7527235625
561	527	6	0	6	23.7476129755
561	529	4	0	4	34.1410105932
561	530	1	0	1	39.5184075954
561	531	1	0	1	18.5038569888
561	533	1	0	1	47.9408180127
561	534	16	8	8	20.4904470282
561	535	6	0	6	38.9110069646
561	536	5	3	2	27.8163895047
561	537	29	1	28	18.262622119
561	538	27	1	26	9.92208899022
561	539	40	9	31	11.8940217291
561	540	77	2	75	29.6022644324
561	543	1	0	1	50.5481287314
561	548	2	0	2	71.267585018
561	551	2	0	2	31.258285466
561	552	34	11	23	17.0104359635
561	553	3	1	2	28.2360213776
561	554	104	14	90	12.9536179516
561	555	38	1	37	19.1054210216
561	556	3	1	2	27.0273788823
561	557	1	0	1	20.1390658542
561	558	7	0	7	23.3951364423
561	559	25	10	15	12.2855200545
561	560	1	0	1	27.8974374679
561	562	9	3	6	19.1148229587
561	563	12	0	12	24.7948148043
561	564	0	0	0	24.8346628197
561	565	2	0	2	38.6315320015
561	566	5	1	4	37.5277300573
561	567	6	0	6	27.344886278
561	569	1	0	1	42.6518738274
561	570	1	0	1	43.5380240185
561	571	1	0	1	30.6573910428
561	573	197	7	190	39.7945516586
561	577	2	0	2	50.5542931605
561	578	2	0	2	46.0117256694
561	579	1	0	1	49.5243314965
561	580	1	0	1	48.6864881015
561	581	5	0	5	54.9525495537
561	583	1	0	1	50.8674348162
561	584	2	0	2	33.5505603299
561	585	8	0	8	39.786470554
561	586	5	0	5	41.4484337703
562	1	2	0	2	125.218193191
562	17	1	0	1	111.773701604
562	70	4	0	4	93.3747210483
562	73	19	1	18	92.2224721022
562	74	3	0	3	88.2150120515
562	75	2	0	2	90.2142644559
562	76	2	0	2	90.6265613006
562	77	1	0	1	95.7428693289
562	78	3	0	3	88.3502920063
562	80	2	0	2	94.1351438575
562	82	2	0	2	90.6016290692
562	83	1	0	1	91.0788624866
562	84	4	0	4	90.8257240664
562	85	0	0	0	86.9005022264
562	86	2	0	2	83.7495716346
562	87	2	0	2	87.4372674615
562	88	1	0	1	85.5660948514
562	102	1	0	1	107.959488298
562	103	1	0	1	91.1691978929
562	113	1	0	1	86.5892703908
562	116	1	0	1	90.0702428827
562	131	1	0	1	80.0189418132
562	142	1	0	1	77.9172958396
562	164	2	0	2	77.4948806206
562	165	1	0	1	61.9252697663
562	166	1	0	1	77.3100341017
562	172	4	0	4	69.1166606046
562	177	1	0	1	67.4681903788
562	319	3	0	3	64.1799709542
562	320	1	0	1	57.5636366533
562	325	1	0	1	56.4213054906
562	338	0	0	0	97.0421429289
562	349	2	0	2	84.6653787477
562	356	1	0	1	75.7466834342
562	379	2	0	2	28.1736203498
562	381	8	2	6	12.6553133203
562	382	1	0	1	24.5357411493
562	383	2	0	2	22.698007098
562	385	7	1	6	24.2135788473
562	386	2	0	2	19.4847696299
562	388	1	0	1	24.8763074917
562	389	1	0	1	19.2086984831
562	394	1	0	1	29.1020555366
562	395	2	0	2	19.9962763161
562	398	2	0	2	32.3240097389
562	401	1	0	1	38.4709132695
562	404	1	0	1	31.849322576
562	405	1	0	1	43.5904869124
562	406	1	0	1	47.0859482889
562	407	1	0	1	48.9474567895
562	408	44	5	39	41.6508195462
562	409	2	0	2	52.1299057153
562	410	0	0	0	39.7965407709
562	411	6	0	6	35.0884082423
562	414	1	0	1	55.4126298212
562	415	2	0	2	38.5559485611
562	416	1	0	1	50.0008889422
562	417	4	0	4	34.1837869514
562	418	3	0	3	29.7071791455
562	441	0	0	0	42.3906916845
562	442	1	0	1	50.1363939028
562	471	1	0	1	91.0674050158
562	507	4	0	4	77.324225216
562	509	1	0	1	87.0363357912
562	512	8	1	7	44.6433701235
562	515	2	0	2	36.5177172431
562	519	1	0	1	33.9928065814
562	520	56	10	46	13.8115709177
562	521	4	0	4	16.9825823631
562	522	16	1	15	8.85537828589
562	523	1	0	1	25.2296192652
562	524	249	39	210	10.2057883526
562	525	6	0	6	18.356907827
562	526	4	1	3	16.764448303
562	527	1	1	0	25.3649425914
562	528	1	0	1	24.4588798612
562	529	1	0	1	49.84075647
562	530	1	0	1	57.4338518773
562	535	1	0	1	50.5640161668
562	536	2	0	2	45.4882377028
562	537	7	1	6	29.1735869371
562	538	0	0	0	25.8179248314
562	539	1	0	1	30.9251860482
562	540	6	0	6	40.0075305128
562	542	1	0	1	73.6941762797
562	548	1	0	1	83.030709092
562	549	1	1	0	66.3287597435
562	551	1	0	1	36.2055805842
562	554	49	18	31	14.3544121338
562	555	10	0	10	27.291058982
562	557	3	1	2	13.389180652
562	558	16	1	15	8.48507284246
562	559	2	0	2	25.7905016966
562	561	18	1	17	19.1148229587
562	563	5	1	4	27.010833856
562	566	5	0	5	27.8456784082
562	567	2	0	2	24.6249565323
562	568	0	0	0	43.8675311272
562	569	1	0	1	42.6877656746
562	571	1	0	1	23.2652740059
562	573	59	10	49	36.353594799
562	575	2	0	2	35.8061060357
562	576	1	0	1	56.6962578387
562	581	1	0	1	51.6599317395
562	583	1	0	1	66.4206097784
562	585	1	0	1	49.1432379848
563	1	0	0	0	110.75864973
563	13	1	0	1	95.4324367029
563	70	8	0	8	72.3339238552
563	71	3	0	3	64.5641618138
563	73	86	8	78	72.8331988843
563	74	7	1	6	68.3871255887
563	75	10	1	9	71.1881195509
563	76	2	0	2	69.6639648756
563	77	1	0	1	75.6086717475
563	78	18	3	15	68.1239938654
563	81	3	2	1	73.5205662968
563	82	8	0	8	70.1226882829
563	83	3	0	3	71.298384432
563	84	13	1	12	71.3842957803
563	85	5	1	4	65.922992639
563	86	6	0	6	63.570298191
563	87	12	7	5	68.3491389358
563	88	2	0	2	66.3381567543
563	89	2	0	2	82.5278946936
563	92	3	0	3	77.0767484778
563	98	1	0	1	59.5587454571
563	103	4	0	4	73.1677374965
563	107	1	1	0	57.3805693929
563	112	1	0	1	76.2039028615
563	113	3	0	3	68.6852504449
563	116	1	0	1	68.6042025073
563	118	1	0	1	64.7597005479
563	141	0	0	0	48.5319631386
563	142	1	0	1	64.1272643958
563	146	1	0	1	62.5533244624
563	154	1	0	1	51.6668994045
563	155	5	2	3	56.7187942175
563	156	1	0	1	60.9211226101
563	161	1	0	1	43.073768072
563	163	1	0	1	45.1966264213
563	164	1	0	1	56.7607117725
563	165	1	0	1	41.3468708573
563	166	5	1	4	52.6304897527
563	168	14	0	14	52.8903140566
563	170	1	0	1	39.4375726169
563	171	2	0	2	57.2033058376
563	172	11	1	10	49.9126438852
563	175	2	1	1	52.2107925424
563	176	1	0	1	40.5923321709
563	177	19	3	16	46.7215252267
563	183	1	0	1	158.274453347
563	284	1	0	1	117.255517328
563	319	26	2	24	37.4494608965
563	320	3	0	3	30.7437933807
563	321	2	0	2	45.5622650503
563	323	3	0	3	33.629475234
563	325	3	1	2	29.4122525042
563	326	1	0	1	53.192337963
563	333	1	0	1	82.157610528
563	338	5	1	4	70.1425047293
563	349	1	0	1	57.9894668833
563	381	1	0	1	29.6846848959
563	383	1	0	1	45.3219550705
563	384	1	0	1	26.6311903126
563	385	4	0	4	28.598329533
563	388	1	0	1	38.9740225723
563	389	0	0	0	39.5437450763
563	392	0	0	0	30.9534472458
563	398	1	0	1	55.9201461587
563	406	1	0	1	61.5495927644
563	408	9	1	8	57.2572856696
563	411	2	0	2	50.2020390683
563	415	3	0	3	49.5323003087
563	417	2	0	2	46.5803822512
563	433	1	0	1	78.9710355926
563	438	1	0	1	67.6746875438
563	441	0	0	0	65.4551367425
563	456	1	0	1	44.4999213692
563	507	5	1	4	94.5968027533
563	512	2	0	2	67.8616750778
563	520	1	0	1	39.0698714498
563	522	1	0	1	35.5505153893
563	523	1	0	1	50.4998864904
563	524	19	0	19	31.4199951105
563	528	1	0	1	51.4453895885
563	529	1	0	1	56.7690244189
563	530	1	0	1	58.6449033038
563	536	2	0	2	48.5022271604
563	537	2	0	2	43.0454410033
563	540	4	0	4	54.376511008
563	547	1	0	1	81.0568893569
563	548	0	0	0	95.272372792
563	551	57	18	39	9.30591437928
563	552	4	1	3	25.8402800349
563	554	100	4	96	14.3283208223
563	555	186	35	151	8.43740616779
563	557	7	1	6	14.185040239
563	558	0	0	0	22.1823863512
563	559	3	0	3	16.108216344
563	560	1	0	1	11.6429851973
563	561	4	0	4	24.7948148043
563	562	2	0	2	27.010833856
563	564	1	1	0	16.6275400928
563	565	0	0	0	52.8656780219
563	566	18	0	18	19.7940741818
563	567	26	0	26	6.70045675855
563	568	1	0	1	29.2618427265
563	569	18	3	15	17.9128846237
563	570	3	0	3	19.9218574375
563	571	0	0	0	13.4458606692
563	572	4	1	3	19.135000673
563	573	540	128	412	15.7935502661
563	574	1	0	1	20.1808852297
563	575	35	17	18	9.7050060766
563	576	1	0	1	32.7986713052
563	577	9	1	8	26.3959302786
563	578	3	1	2	25.6547465231
563	579	8	1	7	24.8456474021
563	581	19	2	17	30.3035729016
563	583	1	0	1	45.7587259
563	585	14	1	13	23.382953043
563	586	3	0	3	30.5102357271
563	587	1	0	1	36.5247023576
563	588	1	0	1	37.6274512859
564	1	1	0	1	122.065905268
564	13	1	0	1	106.729840904
564	59	1	0	1	117.795902432
564	71	1	0	1	73.6992364362
564	72	1	0	1	83.4334738538
564	73	24	0	24	81.8520614039
564	74	5	0	5	77.2274617772
564	75	4	0	4	80.5506254872
564	76	2	0	2	77.4572785229
564	78	9	1	8	76.6407199067
564	79	1	0	1	84.2854595633
564	80	1	0	1	82.3268305595
564	82	6	1	5	78.3364668033
564	83	1	0	1	80.0604324617
564	84	3	0	3	80.4166657866
564	85	4	0	4	73.8647860447
564	87	3	0	3	77.7767711266
564	88	1	0	1	75.7431364649
564	107	1	0	1	67.3637769551
564	112	2	0	2	86.3328773479
564	113	2	0	2	78.9521791502
564	119	1	0	1	68.9835546827
564	130	0	0	0	71.2226096636
564	142	1	0	1	76.8961416229
564	154	1	0	1	64.7711725268
564	155	3	0	3	62.7915063475
564	157	1	0	1	55.5647548087
564	159	1	0	1	53.0864861812
564	166	5	1	4	56.7727836627
564	168	1	0	1	62.2211251791
564	169	2	0	2	71.1104464127
564	171	2	0	2	64.5861406849
564	172	3	0	3	60.2199809169
564	173	1	0	1	46.1490551703
564	177	3	0	3	56.0176183995
564	244	1	0	1	179.506646954
564	264	1	0	1	111.886749677
564	319	44	11	33	37.4682063246
564	320	1	0	1	31.1438515633
564	322	1	0	1	33.1822221374
564	323	5	1	4	38.2537486406
564	327	1	0	1	38.0727174866
564	329	3	0	3	55.9839537331
564	330	1	0	1	29.2863044069
564	332	1	0	1	77.3301306219
564	338	2	0	2	67.052207747
564	341	0	0	0	79.6774911636
564	347	1	0	1	67.3839546548
564	349	2	0	2	56.713709791
564	355	1	0	1	46.0640507589
564	358	0	0	0	39.6673454376
564	365	0	0	0	55.4409354263
564	366	1	0	1	32.7776379726
564	367	1	0	1	49.9742436067
564	368	1	0	1	43.9941591537
564	375	0	0	0	110.886631836
564	379	1	0	1	52.6519398504
564	385	0	0	0	44.8720028005
564	397	1	0	1	71.0842241112
564	398	1	0	1	68.6974429053
564	408	2	0	2	72.7894621363
564	417	1	0	1	62.4746774661
564	442	0	0	0	85.6235945972
564	460	1	0	1	63.6708007532
564	507	1	0	1	90.2629821103
564	512	1	0	1	69.6756816031
564	523	1	0	1	55.6531163062
564	524	11	0	11	36.9094010189
564	525	1	1	0	38.5334127393
564	535	1	0	1	57.875585585
564	536	1	0	1	38.9268006155
564	538	1	0	1	31.4620633432
564	539	1	0	1	24.570302924
564	540	1	0	1	50.7969349059
564	541	1	0	1	66.5483659686
564	548	0	0	0	87.6181400302
564	551	2	0	2	13.8060906121
564	552	30	1	29	14.5064873419
564	553	4	0	4	33.3802647997
564	554	19	0	19	22.6786341168
564	555	133	84	49	10.3088269753
564	557	3	0	3	27.337252773
564	559	11	0	11	12.6544318565
564	560	16	8	8	7.32066686535
564	561	3	1	2	24.8346628197
564	563	24	0	24	16.6275400928
564	565	1	0	1	38.8915655677
564	566	5	2	3	36.3910243429
564	567	3	0	3	23.3159136386
564	568	1	0	1	43.8222250401
564	569	5	1	4	27.138265415
564	572	2	0	2	17.9948279666
564	573	90	2	88	29.7037935185
564	575	3	0	3	20.0342521427
564	576	1	0	1	40.1369278081
564	577	5	0	5	31.5255743096
564	579	2	0	2	32.5575358079
564	580	2	0	2	37.2421270199
564	581	3	1	2	40.8067500103
564	582	1	0	1	27.7526095138
564	583	4	0	4	30.1732473417
564	584	9	2	7	10.6577798848
564	585	31	16	15	15.3038784885
564	586	10	1	9	17.1842092788
564	587	1	0	1	28.9232392844
564	588	5	0	5	21.2389496974
565	65	1	0	1	164.481960479
565	70	1	0	1	117.498793065
565	73	4	0	4	120.049331041
565	74	0	0	0	115.398332641
565	75	1	0	1	118.893015287
565	76	1	0	1	115.142931203
565	78	4	0	4	114.681209341
565	81	1	0	1	119.548902498
565	82	2	0	2	116.216850658
565	84	0	0	0	118.633041203
565	85	0	0	0	111.679545557
565	87	0	0	0	116.165596981
565	142	1	0	1	115.745501942
565	166	1	0	1	92.862763495
565	168	1	0	1	100.726340604
565	177	1	0	1	94.5830713845
565	180	1	0	1	88.2444553371
565	214	1	0	1	151.217476071
565	234	1	0	1	173.36158975
565	249	1	0	1	134.720647296
565	308	1	0	1	163.967031092
565	319	5	0	5	72.1665247632
565	324	1	0	1	75.0566387587
565	328	1	0	1	83.0527849763
565	334	1	0	1	94.8386695861
565	338	1	0	1	94.9320817831
565	351	1	0	1	93.0944161594
565	370	1	0	1	141.000698021
565	373	1	0	1	122.372470562
565	379	0	0	0	83.0866635212
565	397	1	0	1	101.261465032
565	407	1	0	1	106.143524302
565	408	1	0	1	99.3072550583
565	410	1	0	1	97.2209443889
565	411	0	0	0	92.6210775795
565	425	1	0	1	108.944361972
565	442	1	0	1	106.115901077
565	484	1	0	1	155.399396695
565	507	9	2	7	66.0255544998
565	512	1	0	1	63.2885797819
565	524	3	0	3	50.301817852
565	529	9	5	4	23.7083153696
565	530	31	1	30	12.9835668094
565	532	1	0	1	28.8993271244
565	533	1	0	1	46.9178402956
565	534	3	0	3	27.1204785637
565	535	1	0	1	37.1252816178
565	536	17	2	15	17.0935809964
565	537	0	0	0	37.1875847832
565	539	1	0	1	26.7602954827
565	540	14	0	14	37.8310553585
565	541	2	0	2	37.0999667403
565	543	1	0	1	30.3112881017
565	548	2	0	2	56.5028548305
565	549	1	0	1	51.96464714
565	552	10	2	8	27.137092491
565	553	23	2	21	10.9145574006
565	554	2	0	2	48.9157376854
565	555	5	0	5	44.4429400874
565	556	17	4	13	14.9525131127
565	559	1	0	1	37.8619217886
565	561	3	0	3	38.6315320015
565	563	3	1	2	52.8656780219
565	573	11	0	11	67.9425477125
565	577	1	0	1	69.5715340842
565	583	1	0	1	37.4773572
565	586	1	0	1	42.5252376879
566	1	7	1	6	97.9126480627
566	12	1	0	1	103.599648473
566	13	1	0	1	82.9274993976
566	59	1	0	1	83.3432660045
566	62	1	0	1	103.260444094
566	70	23	0	23	66.012766903
566	71	7	2	5	56.5972050551
566	73	225	4	221	64.4912476162
566	74	17	0	17	60.5806271337
566	75	25	1	24	62.4441779167
566	76	11	0	11	63.2651778702
566	78	42	0	42	60.8027774888
566	79	3	0	3	67.9944903135
566	81	7	0	7	66.3061636852
566	82	27	0	27	63.0997341591
566	83	9	0	9	63.4176492415
566	84	29	0	29	63.1085489827
566	85	13	6	7	59.5829962805
566	86	4	0	4	56.2306789066
566	87	16	0	16	59.6859840203
566	88	10	1	9	57.8434411769
566	90	1	0	1	60.877963994
566	92	1	0	1	70.9669015238
566	95	3	2	1	69.9758895342
566	96	3	1	2	63.7747250289
566	98	1	0	1	52.5790113963
566	103	5	0	5	63.3269921592
566	110	2	1	1	62.316824531
566	112	6	0	6	66.0680953912
566	113	9	0	9	58.7484728432
566	118	1	0	1	59.1964115575
566	120	1	0	1	70.6600070308
566	142	7	0	7	50.4954829919
566	144	1	0	1	45.3685322305
566	146	1	0	1	52.9379458269
566	154	5	0	5	38.257006615
566	155	10	0	10	53.8194772283
566	156	2	0	2	58.7062195975
566	157	1	0	1	34.1984438095
566	158	0	0	0	38.2974273329
566	159	1	0	1	44.6918492642
566	160	4	0	4	39.0916620725
566	161	1	0	1	30.6315217341
566	162	1	0	1	59.1322740854
566	163	4	0	4	30.2753631444
566	164	1	0	1	50.2202568215
566	165	3	0	3	34.9720366825
566	166	6	0	6	52.7421259982
566	167	7	0	7	25.0552263402
566	168	21	0	21	45.7110397272
566	170	3	1	2	38.4796402727
566	171	2	0	2	52.4344898634
566	172	20	11	9	41.5368270968
566	173	5	0	5	32.7693721978
566	175	3	0	3	47.3930327705
566	176	7	0	7	23.5620610012
566	177	50	6	44	40.4084024167
566	178	2	0	2	22.4656080586
566	180	1	0	1	30.1206444795
566	183	2	0	2	154.036811529
566	220	1	0	1	169.896223205
566	245	1	0	1	86.295812082
566	254	0	0	0	91.6892321556
566	263	1	0	1	96.3618020496
566	310	0	0	0	92.3623412821
566	319	72	6	66	44.7410108991
566	320	6	2	4	39.2257727934
566	321	7	2	5	50.7641469847
566	322	3	0	3	36.6524263679
566	323	9	0	9	36.7027299537
566	325	1	0	1	40.6340557297
566	326	2	0	2	58.0061051007
566	327	1	0	1	50.173420286
566	329	4	0	4	56.6272947741
566	338	5	0	5	76.9744266616
566	341	3	0	3	88.9519609848
566	349	6	1	5	63.8129018615
566	353	1	0	1	72.628252191
566	357	1	0	1	62.9798270151
566	359	1	0	1	68.2848440741
566	361	0	0	0	59.6308821634
566	366	1	0	1	48.9728056115
566	375	2	0	2	117.48715214
566	379	27	9	18	19.3904780437
566	380	12	0	12	11.0605246829
566	382	1	0	1	40.8368127035
566	384	6	1	5	6.85217259888
566	385	210	17	193	11.9609457362
566	386	8	0	8	13.0366649916
566	387	4	0	4	17.2695203954
566	388	3	0	3	24.4956301462
566	389	1	0	1	29.2577346926
566	391	18	3	15	17.6420336395
566	392	43	4	39	12.1558191064
566	393	1	0	1	31.190335932
566	394	15	0	15	24.6815672691
566	395	3	1	2	22.8442602701
566	396	8	0	8	38.4308485177
566	397	1	0	1	36.2257357185
566	398	1	0	1	45.6766860596
566	401	1	0	1	42.0509192777
566	402	0	0	0	36.9510320636
566	406	10	1	9	44.3864195652
566	407	5	0	5	42.829733739
566	408	138	49	89	40.9471959944
566	409	4	0	4	48.74387743
566	410	2	0	2	36.8442062268
566	411	21	0	21	34.3157939351
566	413	2	0	2	43.1979450976
566	415	27	0	27	31.7511451561
566	416	5	0	5	50.5001188948
566	417	12	0	12	29.7418578654
566	418	1	0	1	31.0816814605
566	419	1	0	1	46.8106236074
566	421	1	0	1	60.8493231316
566	427	2	0	2	55.1805178601
566	433	4	1	3	69.9222022691
566	436	1	0	1	77.8861073949
566	438	3	0	3	57.292638096
566	441	0	0	0	53.8109407938
566	442	5	0	5	58.2231249711
566	450	2	1	1	15.7053530295
566	451	2	0	2	34.5234738694
566	454	4	1	3	22.1349446939
566	455	19	14	5	19.9669435585
566	456	1	0	1	26.1954881135
566	457	2	1	1	33.2834721008
566	459	2	0	2	24.6365858602
566	460	4	0	4	27.3529578625
566	461	1	1	0	14.7689327289
566	462	1	0	1	21.9046644926
566	469	0	0	0	52.9252053482
566	471	1	0	1	71.4284590015
566	474	1	0	1	71.3820079095
566	475	2	0	2	37.4234719025
566	503	1	0	1	42.7443070529
566	507	2	0	2	104.441414708
566	512	5	0	5	72.4554866601
566	519	1	0	1	61.2804821263
566	520	1	0	1	33.5680340308
566	521	0	0	0	41.2826388049
566	524	24	0	24	36.9296967323
566	528	3	0	3	48.2008933376
566	535	0	0	0	75.5982812941
566	537	2	0	2	53.9492823446
566	540	3	0	3	65.4848411436
566	548	1	0	1	108.261300399
566	551	4	0	4	25.6491580377
566	552	0	0	0	44.427742417
566	554	44	1	43	24.5969132203
566	555	38	8	30	27.6293647827
566	557	4	1	3	17.6350673993
566	558	2	0	2	19.4118744607
566	559	2	0	2	33.6823635212
566	561	5	0	5	37.5277300573
566	562	1	0	1	27.8456784082
566	563	19	6	13	19.7940741818
566	564	2	0	2	36.3910243429
566	567	9	0	9	13.2120695486
566	568	15	2	13	16.0518451533
566	569	17	0	17	22.1568086254
566	570	2	0	2	28.6581545659
566	571	31	1	30	7.16143147824
566	572	1	0	1	32.8984066914
566	573	1624	26	1598	13.4406621339
566	574	20	7	13	9.54719796148
566	575	9	1	8	20.4480398271
566	576	3	0	3	32.5099425908
566	577	27	1	26	31.2760336054
566	578	48	8	40	8.99270612929
566	579	21	5	16	27.0687893563
566	580	6	2	4	18.1894855233
566	581	62	5	57	25.783826249
566	585	11	2	9	39.8462573519
566	586	1	0	1	48.5927019229
567	1	2	0	2	106.987852441
567	36	1	0	1	82.0971381612
567	70	6	0	6	70.6140292615
567	71	1	0	1	62.2212920671
567	72	1	0	1	73.4468012182
567	73	90	3	87	70.4377009192
567	74	14	0	14	66.1342983446
567	75	11	0	11	68.6447007569
567	76	2	0	2	67.8949421253
567	78	17	1	16	66.031401637
567	79	2	1	1	73.590917717
567	81	1	0	1	71.5096398545
567	82	10	1	9	68.1480410023
567	83	2	0	2	69.0456318382
567	84	12	0	12	68.9996085538
567	85	3	1	2	64.1381561765
567	86	2	0	2	61.4265725586
567	87	10	0	10	65.8091237669
567	88	3	0	3	63.8363017132
567	95	1	0	1	76.7966636718
567	96	1	0	1	66.1577636426
567	98	1	0	1	57.4891484931
567	103	1	0	1	70.2708392303
567	107	1	0	1	54.7272086462
567	112	2	0	2	73.2282340338
567	113	7	0	7	65.7218996509
567	142	4	0	4	59.8936349601
567	146	0	0	0	59.6413704351
567	151	1	0	1	69.2781883045
567	155	4	1	3	55.9803263774
567	157	4	2	2	40.7309399316
567	159	1	0	1	46.0910587909
567	160	2	1	1	46.7449561816
567	163	1	0	1	40.3588287803
567	166	3	0	3	52.8555568476
567	167	1	0	1	32.1683378708
567	168	9	0	9	50.6614121708
567	170	1	0	1	39.0033115986
567	172	14	1	13	47.2408200265
567	177	22	3	19	44.6661449443
567	180	1	0	1	35.3073821758
567	183	2	0	2	157.587020495
567	277	1	0	1	118.352057472
567	281	0	0	0	109.031405704
567	310	0	0	0	91.1570643797
567	319	37	10	27	39.9088134674
567	320	1	0	1	33.4609842672
567	321	1	0	1	47.4395775417
567	323	2	0	2	34.4288712107
567	329	1	0	1	55.1290850008
567	338	4	0	4	72.8707015111
567	346	0	0	0	151.609450446
567	349	2	0	2	60.2620373896
567	375	1	0	1	115.295794668
567	385	5	0	5	22.0523742603
567	388	1	0	1	32.9131759303
567	392	1	0	1	24.260390765
567	408	18	3	15	50.9959294518
567	411	1	0	1	43.9853405195
567	417	4	0	4	40.1740470536
567	438	2	2	0	62.86561711
567	442	2	0	2	66.1011678405
567	459	1	0	1	35.8071746456
567	472	1	0	1	70.2433302614
567	488	1	0	1	90.0145569451
567	503	1	0	1	55.2457738206
567	507	1	0	1	96.6537173871
567	509	1	0	1	105.235172247
567	512	4	0	4	67.7960642379
567	523	1	0	1	49.3852798886
567	524	24	3	21	31.0270537765
567	536	1	0	1	53.0242790535
567	537	1	0	1	45.1596249873
567	540	7	0	7	56.708492315
567	548	0	0	0	98.5825846246
567	551	4	0	4	14.4284435921
567	552	3	0	3	31.5395283963
567	553	0	0	0	50.4713238122
567	554	84	0	84	14.9498771003
567	555	24	1	23	14.4574515587
567	557	7	0	7	11.2536010527
567	558	1	0	1	18.1725290918
567	559	2	0	2	21.0830983361
567	560	1	0	1	18.1308017756
567	561	7	0	7	27.344886278
567	562	5	0	5	24.6249565323
567	563	90	1	89	6.70045675855
567	565	1	0	1	58.6763190775
567	566	22	4	18	13.2120695486
567	568	5	1	4	24.5136042998
567	569	9	0	9	18.0673851617
567	570	1	0	1	22.2137157515
567	571	10	4	6	6.76213901893
567	572	1	0	1	23.5576970446
567	573	765	39	726	12.7327992702
567	574	1	0	1	14.0065821284
567	575	22	0	22	11.6594149908
567	576	2	0	2	32.3572888249
567	577	5	0	5	27.5405071175
567	578	2	0	2	19.8641938748
567	579	9	4	5	24.8711598787
567	580	4	0	4	21.5121232361
567	581	29	0	29	28.2780169049
567	583	1	0	1	52.3246565158
567	585	6	3	3	29.0338042184
567	587	1	0	1	41.4350673339
568	0	1	0	1	70.4817217883
568	19	1	0	1	71.0696089447
568	34	1	0	1	55.0722432112
568	36	2	0	2	58.2198515486
568	70	18	0	18	50.1850420486
568	71	8	0	8	40.6043620118
568	73	273	0	273	48.4501714619
568	74	53	0	53	44.5855182664
568	75	30	0	30	46.3938505068
568	76	17	0	17	47.4454535067
568	77	2	0	2	52.1321374445
568	78	70	1	69	44.8598022414
568	79	3	1	2	51.9779712267
568	80	3	0	3	50.5469796512
568	81	21	0	21	50.3481028605
568	82	32	2	30	47.1825571608
568	83	10	0	10	47.4062342929
568	84	40	0	40	47.0727347376
568	85	17	0	17	43.8086709291
568	86	19	2	17	40.3160208058
568	87	39	6	33	43.6399299436
568	88	12	1	11	41.8073564963
568	89	1	0	1	59.6030394947
568	90	1	0	1	45.5402604153
568	92	1	0	1	55.1411113959
568	95	2	0	2	53.9548370889
568	96	1	0	1	48.8584075563
568	98	1	0	1	36.7607305708
568	102	1	0	1	64.0966573165
568	103	7	0	7	47.311052407
568	107	1	0	1	32.707698173
568	109	3	0	3	50.9063120738
568	110	2	0	2	46.4348379088
568	112	7	1	6	50.0870178074
568	113	29	2	27	42.7288426749
568	114	1	0	1	53.3236026119
568	116	2	0	2	47.2138576411
568	118	2	0	2	43.5989710796
568	119	2	0	2	40.6570899171
568	128	1	0	1	28.5131498806
568	140	2	0	2	40.756936254
568	141	0	0	0	22.1213547201
568	142	8	0	8	35.440444163
568	146	2	0	2	36.8900807894
568	147	3	0	3	25.2807311614
568	151	1	0	1	46.0644549333
568	154	15	2	13	22.9591216025
568	155	18	0	18	39.2449867363
568	156	1	0	1	44.2504369347
568	157	12	4	8	18.1891432965
568	158	8	0	8	23.8113430971
568	159	1	0	1	31.0265073519
568	160	14	6	8	23.1200441063
568	161	6	0	6	14.8066403477
568	163	33	1	32	15.9413397318
568	164	9	1	8	34.5307516939
568	165	14	4	10	19.9141672492
568	166	11	3	8	39.6865370081
568	167	66	22	44	9.05957016058
568	168	68	1	67	29.9576431354
568	169	3	0	3	50.9389540749
568	170	1	0	1	26.067937785
568	171	6	0	6	37.2009601478
568	172	106	1	105	25.6203247254
568	173	8	2	6	19.1120154671
568	174	1	0	1	19.0475319398
568	175	2	0	2	32.3021278827
568	176	8	0	8	12.4833591659
568	177	121	0	121	25.0619918898
568	178	10	7	3	7.81373715883
568	180	5	1	4	14.7409626433
568	183	1	0	1	138.267979018
568	245	1	0	1	70.4034364419
568	257	1	0	1	74.795152078
568	277	1	0	1	98.3938703465
568	319	68	7	61	37.3539628748
568	320	2	0	2	33.7040151071
568	321	2	0	2	41.1061566952
568	323	5	2	3	27.4452285533
568	325	1	0	1	37.1415696088
568	328	0	0	0	37.1262920566
568	329	3	0	3	44.7854378923
568	330	1	0	1	30.2125708972
568	331	1	0	1	32.1690414898
568	338	3	0	3	66.8928281142
568	347	1	0	1	53.158139435
568	349	3	0	3	53.6365795037
568	355	1	0	1	48.8978686782
568	356	2	0	2	60.0392290396
568	361	1	0	1	52.8200850718
568	367	2	0	2	48.5352090309
568	373	1	0	1	94.1984045056
568	375	1	0	1	104.958535275
568	377	0	0	0	89.3433688782
568	379	1	0	1	29.7361479902
568	381	2	0	2	36.7500957396
568	384	2	0	2	15.7868814501
568	385	11	1	10	24.8426092308
568	387	1	0	1	31.408874672
568	391	3	0	3	24.6405819808
568	392	0	0	0	21.8420615726
568	396	4	1	3	44.4837382276
568	406	6	0	6	51.3642192991
568	407	1	0	1	48.1663974957
568	408	31	1	30	49.4193267751
568	410	1	0	1	44.9238731734
568	411	5	0	5	43.9123163184
568	415	8	1	7	38.9040587324
568	416	4	0	4	58.3202619365
568	417	4	1	3	38.6602074294
568	426	2	0	2	86.9837843502
568	438	4	1	3	69.9689851914
568	441	0	0	0	65.8313163052
568	442	1	0	1	68.7039536141
568	450	3	1	2	18.3179489416
568	454	3	0	3	22.28954681
568	455	12	3	9	15.4208549672
568	457	1	0	1	35.377763724
568	460	2	0	2	28.8775963708
568	461	7	3	4	9.83745477639
568	475	1	0	1	33.0655709022
568	476	1	0	1	53.5188402695
568	482	0	0	0	80.6330047301
568	524	12	1	11	52.7063751429
568	526	1	0	1	60.247055246
568	536	2	0	2	77.4650904162
568	540	1	0	1	80.5344336338
568	551	1	0	1	30.3806827957
568	552	1	0	1	55.0579759962
568	554	14	1	13	38.8131078781
568	555	9	2	7	37.6711123421
568	558	1	1	0	35.4578034399
568	559	1	0	1	45.2277361187
568	560	1	0	1	36.7573825963
568	561	3	0	3	51.6289611035
568	563	10	0	10	29.2618427265
568	566	34	17	17	16.0518451533
568	567	4	0	4	24.5136042998
568	569	11	5	6	19.5027015897
568	570	7	0	7	26.2698374191
568	571	4	1	3	21.4631301309
568	572	1	0	1	33.2778942677
568	573	1168	0	1168	14.1185649163
568	574	0	0	0	25.5486048599
568	575	5	0	5	23.9726127256
568	576	8	0	8	21.643371317
568	577	25	0	25	24.8336970997
568	578	44	10	34	7.52185298641
568	579	25	8	17	20.0099342077
568	580	26	0	26	8.68682480787
568	581	111	1	110	13.5454669438
568	585	1	0	1	41.4421146736
568	587	2	0	2	48.222509682
569	1	2	0	2	95.0256257222
569	24	1	0	1	87.4463503874
569	36	0	0	0	69.4518258335
569	70	7	4	3	54.6535625398
569	71	1	0	1	47.3662555112
569	73	74	4	70	55.6213160127
569	74	8	0	8	51.0813880388
569	75	6	0	6	54.1272193633
569	76	4	0	4	52.0185201818
569	78	15	0	15	50.6937402623
569	79	2	0	2	58.3741590418
569	81	5	1	4	56.0059624188
569	82	9	0	9	52.5993206465
569	83	1	0	1	53.9740855555
569	84	8	0	8	54.1723059944
569	85	2	0	2	48.3016518263
569	86	3	0	3	46.2094510561
569	87	7	0	7	51.3081096731
569	88	2	0	2	49.2766834574
569	90	1	0	1	47.5224817856
569	92	1	0	1	59.3335133828
569	98	1	0	1	42.1706160358
569	102	1	0	1	72.3817341273
569	103	3	0	3	56.4769375034
569	112	3	0	3	59.581175675
569	113	2	0	2	52.1234365535
569	120	1	0	1	61.4645851535
569	140	3	0	3	52.2882809095
569	142	2	0	2	49.8728942447
569	144	1	0	1	43.1068185667
569	146	1	0	1	46.0050224258
569	155	4	0	4	38.8062056015
569	156	2	0	2	43.0308669302
569	158	3	0	3	25.3107492955
569	161	2	0	2	29.4333107669
569	162	1	0	1	42.1059023513
569	163	1	1	0	33.463642391
569	164	2	0	2	39.3119943065
569	165	1	0	1	24.3844224555
569	166	4	0	4	34.9624156158
569	167	5	0	5	22.2921313527
569	168	10	1	9	35.7136177477
569	170	2	0	2	21.5282090327
569	171	2	0	2	39.4146564075
569	172	13	5	8	33.2884819357
569	173	5	0	5	19.5679636079
569	175	1	0	1	34.4847818404
569	176	2	0	2	31.9273976078
569	177	26	1	25	29.4774197939
569	180	2	1	1	22.2181259616
569	276	1	0	1	93.3128991109
569	277	0	0	0	101.559480946
569	317	0	0	0	86.1345762559
569	319	88	2	86	22.8083889888
569	320	13	2	11	17.0705400393
569	321	2	0	2	29.6668253838
569	322	2	0	2	14.8014771992
569	323	10	0	10	16.3624167883
569	324	1	0	1	30.905672292
569	325	3	0	3	18.8616199633
569	326	1	0	1	37.2158502519
569	327	3	0	3	28.0234051812
569	328	0	0	0	27.9235617032
569	329	2	0	2	37.0652240786
569	330	1	0	1	13.1238091044
569	334	1	0	1	61.8296502523
569	338	8	0	8	55.5558663498
569	345	0	0	0	111.426739344
569	349	1	1	0	42.6513268626
569	350	1	0	1	72.1201229103
569	351	1	0	1	46.6808726531
569	355	3	0	3	34.9094275143
569	356	3	0	3	42.0254208081
569	358	1	0	1	53.5100369638
569	367	2	0	2	36.3093564576
569	375	0	0	0	97.4130734641
569	377	2	0	2	81.724609273
569	380	1	0	1	29.3424457894
569	385	3	0	3	34.106157333
569	386	0	0	0	34.4523890067
569	391	2	0	2	38.6891368926
569	392	2	0	2	33.8071664287
569	406	1	0	1	66.0750260241
569	408	8	0	8	62.9478857478
569	409	1	0	1	70.1854142534
569	411	1	0	1	56.4294192777
569	415	2	0	2	53.3271964758
569	416	1	0	1	72.4360248381
569	417	1	0	1	51.7235128404
569	438	1	0	1	78.8046459029
569	441	0	0	0	75.6280757908
569	442	1	0	1	80.343830488
569	444	1	0	1	87.4103005095
569	507	0	0	0	112.412092684
569	512	2	0	2	85.4203856066
569	516	1	0	1	82.5810717331
569	524	7	0	7	48.7123773386
569	525	1	0	1	54.1997308656
569	537	1	0	1	60.9143773356
569	540	2	0	2	72.1690863566
569	548	0	0	0	112.408652995
569	551	1	0	1	13.4799014338
569	554	11	2	9	31.8738314131
569	555	7	1	6	24.5485252358
569	559	2	0	2	32.7837433808
569	561	1	0	1	42.6518738274
569	563	19	0	19	17.9128846237
569	564	2	0	2	27.138265415
569	566	10	0	10	22.1568086254
569	567	1	1	0	18.0673851617
569	568	8	3	5	19.5027015897
569	570	28	12	16	7.04522546816
569	572	5	2	3	13.7974161078
569	573	881	469	412	8.74743532134
569	575	21	13	8	8.41387551065
569	576	10	0	10	14.8860650364
569	577	75	53	22	9.65297189048
569	578	1	0	1	21.061798044
569	579	118	92	26	6.96805775426
569	580	18	14	4	11.2174291921
569	581	45	0	45	13.6841073179
569	583	1	1	0	48.2953214355
569	585	8	1	7	22.0019129269
569	586	1	0	1	31.8682956657
569	587	2	0	2	29.480584662
569	588	1	0	1	43.3917601669
570	1	2	0	2	98.2158744433
570	28	1	0	1	95.8242238483
570	70	8	1	7	55.6689276819
570	71	2	0	2	49.434864289
570	72	1	0	1	59.1232289981
570	73	57	2	55	57.554957295
570	74	7	0	7	52.9226428446
570	75	9	0	9	56.2985976415
570	76	2	1	1	53.1571527086
570	78	7	1	6	52.3193828228
570	82	8	1	7	54.0144567477
570	83	3	0	3	55.7466779988
570	84	4	0	4	56.1233550816
570	85	3	0	3	49.5497510732
570	86	2	0	2	48.0286856529
570	87	4	0	4	53.5444427389
570	88	0	0	0	51.5144781323
570	89	1	0	1	65.9321591945
570	96	1	0	1	48.5452695974
570	109	1	0	1	53.584751902
570	110	1	0	1	60.1022991697
570	112	0	0	0	62.2206189103
570	113	2	0	2	54.9216001847
570	131	1	0	1	72.9736421337
570	142	1	0	1	54.4157286695
570	144	0	0	0	47.472503139
570	155	4	1	3	38.7582386481
570	156	2	0	2	42.4499187234
570	157	1	1	0	32.7003060805
570	158	3	0	3	27.2646187967
570	163	1	0	1	39.3729009797
570	164	1	0	1	41.0966897744
570	165	1	0	1	27.4594828293
570	166	11	3	8	33.5053302862
570	167	3	1	2	27.8838443094
570	168	9	1	8	38.0558690175
570	169	1	0	1	47.8780588691
570	170	4	1	3	21.7558713633
570	172	11	0	11	36.4160331545
570	173	2	0	2	22.1977349294
570	177	18	1	17	31.9094503947
570	180	1	0	1	26.4941198103
570	183	1	0	1	139.495017323
570	310	0	0	0	69.8137641598
570	319	408	0	408	17.7350663923
570	320	81	6	75	11.2556596067
570	321	8	0	8	25.6469784012
570	322	22	4	18	10.5509328799
570	323	42	2	40	14.4241694943
570	324	4	1	3	25.5107267172
570	325	11	4	7	11.992657916
570	326	5	1	4	33.2819487287
570	327	13	0	13	22.0409615939
570	328	2	0	2	25.1074669827
570	329	6	3	3	34.2280630942
570	330	19	1	18	7.50468738101
570	332	2	0	2	62.5927698502
570	338	9	0	9	50.6748679582
570	345	1	0	1	107.993894
570	349	7	1	6	38.2111704321
570	351	2	0	2	42.6354757772
570	353	2	0	2	49.3815851325
570	354	1	0	1	40.1895467684
570	355	1	0	1	29.4691876982
570	357	3	1	2	35.757317879
570	361	1	0	1	31.4190834568
570	364	2	0	2	27.3570042331
570	366	3	0	3	20.314967981
570	367	1	0	1	31.5780760097
570	368	1	0	1	42.319236383
570	375	0	0	0	93.4064223056
570	379	1	0	1	48.0458173876
570	385	4	0	4	40.5078874411
570	406	1	0	1	72.863697342
570	407	1	0	1	70.8640223688
570	408	4	1	3	69.5921054168
570	411	2	1	1	62.9679693972
570	414	0	0	0	80.8649579952
570	415	4	1	3	60.135133855
570	442	2	0	2	86.5879528029
570	453	1	0	1	59.2092118221
570	475	1	0	1	59.2564666167
570	512	0	0	0	87.6420592341
570	520	1	0	1	57.3809725229
570	523	1	0	1	70.4113361862
570	524	5	1	4	51.3366831651
570	536	1	0	1	63.0243930455
570	551	7	1	6	12.3483617187
570	554	6	1	5	34.2374420607
570	555	10	0	10	24.5451450048
570	557	1	0	1	33.1383665647
570	560	1	0	1	17.4758175253
570	561	1	0	1	43.5380240185
570	563	17	6	11	19.9218574375
570	566	3	1	2	28.6581545659
570	567	1	0	1	22.2137157515
570	568	1	0	1	26.2698374191
570	569	26	8	18	7.04522546816
570	572	32	16	16	7.81895273832
570	573	344	117	227	15.5013764509
570	575	14	2	12	10.6590148416
570	576	13	0	13	15.8442291652
570	577	201	2	199	7.29938885214
570	579	100	39	61	8.74318698138
570	580	4	1	3	17.7139112577
570	581	36	12	24	18.0293062039
570	583	2	0	2	42.007629751
570	584	1	0	1	27.7250483392
570	585	15	9	6	15.9066065983
570	586	6	2	4	25.7767314485
570	587	2	0	2	22.4401460739
570	588	1	0	1	37.9563124104
571	70	9	0	9	70.1653932191
571	71	3	0	3	61.1872128394
571	73	67	2	65	69.2648813055
571	74	11	0	11	65.1569186623
571	75	9	0	9	67.3257852052
571	76	2	0	2	67.4195226954
571	78	9	1	8	65.2284166106
571	79	3	1	2	72.6202667103
571	81	6	0	6	70.7433130166
571	82	2	0	2	67.4510290651
571	83	2	0	2	68.0405230753
571	84	10	1	9	67.851379983
571	85	8	0	8	63.6843326608
571	86	3	1	2	60.6182488519
571	87	4	0	4	64.5208421434
571	88	1	0	1	62.6102118929
571	92	1	0	1	75.0897361732
571	98	1	0	1	56.8100815106
571	103	3	0	3	68.5457471128
571	107	1	0	1	53.4448765211
571	109	1	0	1	70.0426132251
571	110	2	0	2	67.8455065237
571	112	2	0	2	71.3912703808
571	113	2	0	2	63.9630777767
571	137	1	0	1	51.3840387112
571	142	4	0	4	56.7047275088
571	154	1	0	1	44.3026879201
571	155	4	0	4	56.7125783038
571	157	1	0	1	39.0394236636
571	160	3	0	3	44.4986815084
571	161	1	0	1	36.2692890604
571	163	3	0	3	36.6571101466
571	164	2	0	2	54.2779759912
571	166	2	0	2	54.5820469253
571	167	1	0	1	30.0337607048
571	168	11	3	8	49.9121900332
571	169	1	0	1	67.8524997231
571	170	1	0	1	40.3778645009
571	171	2	0	2	55.9370994797
571	172	19	7	12	46.0617481706
571	176	2	0	2	30.4228634839
571	177	19	0	19	44.2228160348
571	178	1	0	1	28.6162552265
571	180	1	0	1	34.2488799417
571	277	0	0	0	118.281555765
571	319	26	0	26	43.8501959854
571	320	3	2	1	37.7483061849
571	322	1	0	1	35.9157201994
571	323	2	0	2	37.0953640573
571	325	1	0	1	38.1912555537
571	329	1	0	1	57.6508231084
571	330	1	0	1	33.8434763722
571	338	2	0	2	76.6850777478
571	358	1	0	1	67.0269415433
571	364	1	0	1	53.7911185675
571	375	1	0	1	118.340943607
571	379	1	0	1	23.3348787613
571	381	1	0	1	20.0486103791
571	384	1	0	1	13.6348446343
571	385	25	1	24	15.3933130003
571	386	0	0	0	14.1030627418
571	387	1	0	1	18.4336168861
571	389	1	0	1	29.3264584642
571	390	1	0	1	27.1866882216
571	392	4	1	3	17.5084428069
571	394	1	0	1	28.0853855599
571	395	1	0	1	23.8747732255
571	396	3	1	2	43.1474715811
571	397	3	1	2	41.3583482979
571	399	1	0	1	54.7816989362
571	401	1	0	1	44.706135877
571	405	1	0	1	49.4853894333
571	406	4	0	4	48.5593148855
571	408	24	3	21	44.5515598766
571	410	1	0	1	40.7787558845
571	411	4	0	4	37.6023083585
571	415	3	0	3	36.3032965524
571	417	1	0	1	33.6094140944
571	426	1	0	1	78.6421362154
571	441	1	0	1	54.9740050683
571	442	2	0	2	60.3203449007
571	450	1	0	1	22.5143389649
571	455	1	0	1	27.1281496995
571	460	2	0	2	33.745352149
571	461	1	0	1	21.828613699
571	475	1	0	1	44.4246118852
571	496	0	0	0	47.1160885657
571	507	2	1	1	98.5155004517
571	512	3	0	3	67.7270504158
571	520	1	0	1	31.5954293254
571	524	15	3	12	31.4184085996
571	529	1	0	1	64.7030538643
571	530	1	0	1	68.5999008785
571	535	0	0	0	69.0861522256
571	537	2	0	2	47.5528396501
571	540	1	0	1	59.1337940341
571	548	0	0	0	101.687298647
571	551	1	0	1	20.7596331185
571	552	0	0	0	37.3332017305
571	554	54	0	54	17.7052728164
571	555	7	0	7	20.7788925114
571	557	7	1	6	11.3009782734
571	558	3	1	2	15.3977159462
571	560	1	0	1	24.8675447475
571	561	3	0	3	30.6573910428
571	562	2	0	2	23.2652740059
571	563	29	11	18	13.4458606692
571	564	1	0	1	30.0187835744
571	566	122	4	118	7.16143147824
571	567	24	7	17	6.76213901893
571	568	5	1	4	21.4631301309
571	569	10	1	9	21.1333533134
571	570	3	0	3	26.5998608074
571	573	613	0	613	13.4857211763
571	574	10	1	9	8.139959924
571	575	14	0	14	16.7853331816
571	576	1	0	1	33.9480049444
571	577	7	0	7	30.7699099624
571	578	6	1	5	15.3611457805
571	579	5	2	3	27.2731976122
571	580	6	0	6	20.9693772213
571	581	10	2	8	28.4367659568
571	585	5	1	4	35.3556504439
571	586	0	0	0	43.4425797928
572	1	0	0	0	105.699586738
572	70	17	1	16	62.2796071795
572	71	4	0	4	56.6057486808
572	72	1	0	1	65.857682604
572	73	67	4	63	64.6232947365
572	74	16	1	15	59.9728437586
572	75	10	0	10	63.4780675498
572	76	11	0	11	59.8538273502
572	77	1	0	1	66.4165773686
572	78	10	0	10	59.2715410308
572	81	1	0	1	64.204407547
572	82	11	0	11	60.850949989
572	83	3	1	2	62.7491301159
572	84	4	1	3	63.2066091051
572	85	2	0	2	56.3320496699
572	86	5	1	4	55.099430389
572	87	8	0	8	60.7639440457
572	88	3	0	3	58.7445269948
572	90	1	0	1	54.2198790086
572	95	1	0	1	72.1857529942
572	96	1	0	1	54.3450387247
572	112	3	0	3	69.5671964532
572	113	3	0	3	62.3491497872
572	142	1	0	1	62.2239526308
572	146	1	0	1	56.4010107403
572	155	3	0	3	44.9190288239
572	157	1	0	1	40.5049298584
572	158	2	0	2	34.6015966718
572	162	1	0	1	46.0232483689
572	164	2	0	2	48.2061059033
572	165	1	0	1	35.1085205272
572	166	9	0	9	38.7783123505
572	168	10	0	10	45.4105667447
572	170	3	0	3	28.5114861254
572	171	1	0	1	46.9802791049
572	172	12	0	12	44.0203247103
572	175	1	0	1	42.6104951163
572	177	23	11	12	39.347847089
572	183	0	0	0	144.437265874
572	252	1	0	1	87.864598056
572	277	0	0	0	106.866006889
572	310	1	0	1	72.6601312499
572	314	1	0	1	68.6371169406
572	318	2	0	2	31.312103049
572	319	561	32	529	20.0076021579
572	320	137	0	137	13.3900599502
572	321	11	0	11	28.7051427499
572	322	14	0	14	15.1936223445
572	323	63	7	56	20.418312216
572	324	3	0	3	26.500829118
572	325	49	0	49	10.5318408963
572	326	1	0	1	36.067024056
572	327	6	0	6	22.0931284312
572	328	3	0	3	29.5301590259
572	329	5	0	5	38.2277066942
572	330	22	9	13	11.2931895187
572	331	2	0	2	27.7149331061
572	332	1	0	1	62.9087873417
572	334	1	0	1	56.1959258887
572	338	10	0	10	51.6365357408
572	345	1	0	1	110.4307381
572	347	2	0	2	49.635226248
572	349	7	1	6	40.140304647
572	351	1	0	1	44.9786323302
572	353	2	0	2	52.343472675
572	355	2	0	2	30.1387912162
572	356	1	0	1	31.0959598229
572	358	2	0	2	39.9611690173
572	360	1	0	1	28.9766713864
572	361	1	0	1	30.6918114936
572	364	9	1	8	25.5895490194
572	366	10	1	9	18.2818123743
572	367	4	1	3	33.3320509605
572	368	3	0	3	37.4629258742
572	373	2	0	2	81.7495872183
572	375	0	0	0	95.1870737971
572	379	1	0	1	52.0635319369
572	380	2	0	2	41.8609441961
572	384	1	0	1	39.1136882285
572	386	1	0	1	43.370692942
572	391	1	0	1	50.4036373202
572	392	2	1	1	45.0480348726
572	406	1	0	1	77.2382797216
572	407	1	0	1	75.699544991
572	408	5	1	4	73.567344082
572	411	1	0	1	66.7228428408
572	415	1	0	1	64.6450936209
572	416	1	0	1	83.1664587999
572	417	1	0	1	62.4503363602
572	438	1	0	1	86.3820045894
572	441	0	0	0	83.8580922795
572	471	1	0	1	97.2916180932
572	496	0	0	0	71.4645512663
572	507	1	0	1	107.874567497
572	522	1	0	1	54.464472672
572	523	1	0	1	68.7249104234
572	524	7	1	6	49.4592998143
572	534	1	0	1	55.7283313726
572	535	1	0	1	75.6045848948
572	536	0	0	0	56.9086309248
572	540	1	0	1	68.0143928609
572	551	37	9	28	9.86888953394
572	552	2	0	2	32.5000389844
572	554	10	1	9	32.6138947332
572	555	38	4	34	20.990808793
572	559	1	0	1	28.0913836683
572	560	4	1	3	12.2160602196
572	563	33	19	14	19.135000673
572	564	2	0	2	17.9948279666
572	566	3	0	3	32.8984066914
572	567	1	0	1	23.5576970446
572	568	5	2	3	33.2778942677
572	569	25	4	21	13.7974161078
572	570	63	23	40	7.81895273832
572	573	316	17	299	20.900994749
572	574	1	0	1	37.2818560705
572	575	29	1	28	12.5723773286
572	576	13	0	13	23.1469934319
572	577	114	15	99	14.1700375299
572	578	2	0	2	34.0585951347
572	579	59	0	59	16.5289925566
572	580	4	1	3	24.9823119272
572	581	19	4	15	25.8468845579
572	582	1	0	1	23.0941884466
572	583	15	0	15	34.5073885662
572	585	151	43	108	8.22817347271
572	586	46	3	43	18.1225990623
572	587	23	0	23	17.9343616175
572	588	2	0	2	30.1387370401
573	0	1	0	1	82.2493548755
573	1	12	2	10	94.9897524127
573	2	1	0	1	82.3285595931
573	12	1	0	1	101.702942071
573	15	1	0	1	84.5365342393
573	28	1	0	1	93.335864916
573	32	3	0	3	83.3629926194
573	36	5	0	5	69.8402866204
573	41	1	0	1	71.0074105802
573	42	1	0	1	74.9413935489
573	48	1	0	1	78.9310291023
573	50	1	0	1	78.3040752576
573	59	1	0	1	88.2277583645
573	60	1	0	1	78.2043233222
573	70	123	0	123	57.8919877553
573	71	48	0	48	49.5135738962
573	72	2	0	2	60.7140175167
573	73	1589	243	1346	57.7433067742
573	74	182	27	155	53.4170079275
573	75	146	2	144	55.9799662074
573	76	47	15	32	55.1698367072
573	77	2	0	2	60.79390823
573	78	269	77	192	53.3013200286
573	79	15	0	15	60.8693438715
573	80	7	6	1	59.1646425601
573	81	56	3	53	58.7774970318
573	82	163	5	158	55.415254378
573	83	73	2	71	56.3295801689
573	84	165	35	130	56.30251981
573	85	56	5	51	51.4132910674
573	86	54	1	53	48.6980937685
573	87	166	5	161	53.1414748627
573	88	41	5	36	51.1584964668
573	89	7	1	6	67.9335407449
573	90	10	0	10	51.6052324217
573	92	9	0	9	62.752207963
573	95	6	0	6	64.2040229884
573	96	11	0	11	53.7433080849
573	98	3	2	1	44.7568505605
573	100	1	0	1	70.5702544298
573	103	36	3	33	57.7201334177
573	104	1	0	1	68.1208958657
573	107	8	0	8	42.0778255786
573	109	7	1	6	57.316892681
573	110	6	0	6	57.6039569079
573	111	2	0	2	67.6449770168
573	112	23	1	22	60.7129629414
573	113	73	14	59	53.1946407187
573	116	5	0	5	54.3584353829
573	117	4	0	4	51.3307149891
573	118	4	1	3	50.530991796
573	120	3	0	3	63.8077136942
573	127	1	0	1	47.5138316853
573	128	1	0	1	41.7837716718
573	131	2	0	2	61.7489821583
573	134	1	1	0	52.5505022125
573	137	3	0	3	40.9897752163
573	141	0	0	0	35.351893661
573	142	30	3	27	48.3603425003
573	144	1	0	1	42.0845107322
573	145	1	0	1	56.3891210921
573	146	7	0	7	47.0860716137
573	147	1	0	1	39.3962552083
573	153	1	0	1	45.5488553961
573	154	21	4	17	35.9263624237
573	155	50	1	49	43.5751494547
573	156	4	0	4	48.1936662906
573	157	14	1	13	28.3046177385
573	158	15	2	13	28.6595371697
573	159	4	0	4	33.8263312074
573	160	14	0	14	34.5788522074
573	161	8	0	8	27.307638418
573	162	2	0	2	47.9446441503
573	163	18	2	16	29.8134333167
573	164	39	2	37	42.0694038587
573	165	20	1	19	26.4092733969
573	166	75	7	68	41.1174323029
573	167	50	0	50	20.1916471223
573	168	115	0	115	37.9344336115
573	169	5	1	4	54.5316226734
573	170	6	1	5	26.9562653672
573	171	42	2	40	43.1998064926
573	172	247	5	242	34.5861264577
573	173	24	2	22	22.7220857453
573	175	15	3	12	38.1025477566
573	176	9	0	9	26.3154578449
573	177	416	38	378	31.9342507373
573	178	5	1	4	21.8513035188
573	179	2	0	2	57.455170563
573	180	4	1	3	22.676129311
573	183	8	0	8	145.052738838
573	208	1	0	1	119.576628417
573	212	1	0	1	113.722604806
573	262	0	0	0	92.2421441483
573	270	1	0	1	111.071731132
573	275	1	0	1	111.667022783
573	277	3	0	3	105.709388373
573	280	1	0	1	112.989931933
573	281	0	0	0	96.4454566803
573	307	2	0	2	94.9732833197
573	309	1	0	1	88.2909318919
573	310	2	0	2	80.2266445246
573	312	1	0	1	83.9903305234
573	316	1	0	1	86.888113605
573	318	2	0	2	41.4268913933
573	319	650	55	595	31.3332241085
573	320	51	1	50	25.7976087374
573	321	14	1	13	37.6578754498
573	322	7	0	7	23.2528404788
573	323	73	1	72	23.7707886171
573	324	4	0	4	39.4657903705
573	325	8	2	6	27.4786320682
573	326	8	3	5	45.0509957177
573	327	9	0	9	36.73819209
573	328	5	1	4	35.271553056
573	329	31	6	25	44.2082700485
573	330	7	0	7	21.8565585769
573	331	3	0	3	30.9496055049
573	332	3	0	3	76.0988311213
573	334	1	0	1	70.3266899566
573	338	47	0	47	63.7853319603
573	339	2	0	2	71.8570935216
573	340	0	0	0	83.2243207415
573	341	7	0	7	75.9182480641
573	345	2	0	2	118.52351232
573	347	5	1	4	54.4450722631
573	348	2	0	2	64.2361509476
573	349	39	4	35	50.715144751
573	350	2	0	2	78.5808286044
573	351	1	0	1	54.4866382998
573	353	3	0	3	60.1635287544
573	354	1	0	1	50.3271189907
573	355	3	0	3	43.4647829142
573	356	3	0	3	50.5630620237
573	357	4	1	3	49.6023373844
573	360	1	0	1	49.7021261804
573	361	0	0	0	46.1947549399
573	363	1	0	1	69.0382844249
573	364	6	1	5	42.6132705696
573	365	2	0	2	55.4617815922
573	366	2	0	2	35.732942049
573	367	1	0	1	44.5693935717
573	373	1	0	1	92.9132925649
573	375	14	0	14	104.975161964
573	377	0	0	0	89.250076838
573	379	28	21	7	32.7128775724
573	380	4	0	4	21.0269493646
573	381	8	1	7	33.2428588136
573	382	1	0	1	53.3356253543
573	384	2	0	2	18.71742354
573	385	97	5	92	25.401166668
573	386	3	0	3	25.993214721
573	387	7	1	6	30.3651611235
573	389	1	0	1	42.0495714036
573	391	16	0	16	30.0598757514
573	392	13	0	13	25.0816564255
573	394	5	0	5	38.0711662644
573	395	1	0	1	35.9707926789
573	396	13	0	13	51.1270490401
573	397	2	0	2	48.5952477893
573	401	5	0	5	55.4839336889
573	404	1	0	1	50.0076897332
573	405	1	0	1	59.889829042
573	406	15	0	15	57.3803786614
573	407	1	0	1	55.3723878844
573	408	247	3	244	54.2049729179
573	409	2	0	2	61.5435088556
573	410	2	0	2	50.0034483998
573	411	29	1	28	47.683510314
573	412	1	0	1	63.6343787049
573	413	2	0	2	56.5510624907
573	414	5	1	4	65.3636092006
573	415	28	0	28	44.6432338086
573	416	4	0	4	63.7020333531
573	417	8	0	8	42.9806251578
573	418	1	0	1	44.5219619301
573	421	2	1	1	74.0954108816
573	425	2	0	2	72.8548142311
573	426	1	0	1	90.1235108299
573	427	1	0	1	68.5446628139
573	431	0	0	0	77.1015077168
573	433	7	0	7	82.8580284293
573	436	1	0	1	91.3147406382
573	437	0	0	0	90.9718111742
573	438	3	0	3	70.4162927684
573	439	1	0	1	77.0407644685
573	441	0	0	0	67.1047493146
573	442	19	0	19	71.6605786831
573	450	1	0	1	26.08220625
573	451	3	0	3	46.3037162127
573	452	1	0	1	38.3111532283
573	453	2	0	2	43.7195778002
573	454	1	0	1	31.9037262503
573	455	24	3	21	26.9021343307
573	456	1	0	1	31.0305740793
573	457	1	0	1	44.4561187657
573	458	1	0	1	41.4947338931
573	459	5	0	5	37.6802763306
573	460	7	0	7	38.0718974457
573	461	3	0	3	20.5335162464
573	465	2	1	1	63.1719416721
573	468	1	0	1	56.6570512725
573	471	4	0	4	77.7453801404
573	475	7	0	7	45.3706015607
573	496	1	0	1	50.5783231456
573	503	1	0	1	54.2501266481
573	507	20	1	19	109.33686545
573	509	1	0	1	117.812251444
573	510	1	0	1	94.3799281256
573	512	7	0	7	80.28944321
573	515	1	0	1	72.8645135387
573	520	2	0	2	45.0303427215
573	521	3	1	2	51.9091705882
573	522	1	0	1	45.172684881
573	523	3	0	3	61.4950566691
573	524	131	0	131	43.5754739391
573	525	4	0	4	49.905535533
573	526	1	0	1	53.1046900762
573	528	1	0	1	59.2004996215
573	529	2	0	2	72.5168305286
573	530	2	0	2	74.3252757312
573	534	2	0	2	59.6230107345
573	535	2	0	2	78.6832510564
573	536	10	0	10	64.2942022763
573	537	6	0	6	57.7936346431
573	538	1	0	1	49.6401832186
573	539	1	0	1	47.3374286962
573	540	23	0	23	69.3079367834
573	542	1	0	1	103.019233883
573	543	2	0	2	88.5279092255
573	546	1	0	1	109.86898162
573	548	6	0	6	110.826202302
573	549	1	0	1	96.6048980898
573	551	36	6	30	16.3684801624
573	552	13	1	12	41.2569608042
573	553	1	0	1	60.7989950674
573	554	167	14	153	27.6662292545
573	555	160	30	130	24.0001410074
573	556	2	0	2	52.9929377032
573	557	16	2	14	23.3860281506
573	558	6	0	6	28.8156128893
573	559	4	1	3	31.8977457186
573	560	4	0	4	22.6690513077
573	561	19	2	17	39.7945516586
573	562	4	2	2	36.353594799
573	563	272	66	206	15.7935502661
573	564	2	0	2	29.7037935185
573	565	1	0	1	67.9425477125
573	566	321	96	225	13.4406621339
573	567	101	3	98	12.7327992702
573	568	158	30	128	14.1185649163
573	569	274	0	274	8.74743532134
573	570	46	0	46	15.5013764509
573	571	19	2	17	13.4857211763
573	572	13	2	11	20.900994749
573	574	9	1	8	20.985910258
573	575	174	102	72	9.98407816304
573	576	50	0	50	20.4734202345
573	577	241	101	140	17.9059406783
573	578	76	0	76	13.1918642894
573	579	319	38	281	13.9621140175
573	580	137	114	23	8.89706798426
573	581	440	261	179	15.5805994565
573	583	3	0	3	54.6332883863
573	584	4	0	4	37.2726432547
573	585	58	2	56	28.6649274231
573	586	26	5	21	38.1841165935
573	587	10	0	10	37.8054272878
573	588	1	0	1	48.524232002
574	1	0	0	0	106.664850949
574	73	29	0	29	73.9984615101
574	74	6	1	5	70.1140916985
574	75	2	0	2	71.933782672
574	78	6	2	4	70.3463079887
574	79	2	0	2	77.5200960477
574	80	1	0	1	76.0678409591
574	81	1	0	1	75.8480589215
574	82	5	1	4	72.6456115975
574	83	1	0	1	72.9453981107
574	84	3	0	3	72.6212463694
574	85	4	1	3	69.1266071825
574	86	2	0	2	65.7763771839
574	87	2	0	2	69.1862103701
574	88	0	0	0	67.3558509124
574	102	1	0	1	89.5222090916
574	103	1	0	1	72.728408666
574	110	1	0	1	71.5950062157
574	112	1	0	1	75.42902676
574	114	0	0	0	78.348507802
574	116	1	0	1	72.4266227581
574	118	1	0	1	68.7209910254
574	120	1	0	1	80.166980849
574	142	2	0	2	59.3272485451
574	146	3	0	3	62.3961477468
574	154	1	0	1	47.2958129001
574	155	3	0	3	63.1432364765
574	158	1	0	1	47.6693929749
574	167	1	0	1	34.5805300695
574	168	1	0	1	55.2555596654
574	172	4	0	4	51.0809951601
574	177	6	0	6	49.9150363262
574	288	1	0	1	135.374240133
574	319	5	0	5	51.8736631825
574	320	1	0	1	45.8458142156
574	322	1	0	1	43.8893475499
574	323	2	0	2	44.7565411133
574	325	1	0	1	46.3275991255
574	332	0	0	0	96.8455940395
574	338	2	0	2	84.6232239256
574	349	1	0	1	71.6331320034
574	359	1	0	1	74.3747754712
574	366	1	0	1	54.7127685361
574	373	0	0	0	113.887099963
574	379	8	0	8	16.5972952634
574	381	2	0	2	12.2780799884
574	384	2	0	2	12.4247030841
574	385	96	49	47	9.06338349715
574	386	7	4	3	6.26658660667
574	387	1	0	1	10.417741289
574	388	2	0	2	18.9066178198
574	389	1	0	1	21.2386597518
574	391	10	0	10	18.3388440523
574	392	13	4	9	12.9273054985
574	393	1	0	1	24.2715907872
574	394	7	0	7	20.7592033187
574	395	2	0	2	15.7622091585
574	396	3	0	3	36.4817791971
574	397	1	0	1	35.1276015994
574	401	2	0	2	36.820699567
574	406	1	0	1	41.402166962
574	407	2	0	2	41.0691356455
574	408	22	1	21	37.0794923666
574	409	1	0	1	46.1852066806
574	411	7	3	4	30.0344575639
574	413	1	0	1	36.5905408339
574	414	1	0	1	49.9451148435
574	415	3	0	3	29.6148394034
574	417	5	2	3	26.4494082757
574	433	2	0	2	62.007076104
574	438	2	1	1	49.7835390593
574	454	1	0	1	26.0348409857
574	455	4	0	4	26.4438872309
574	456	1	0	1	33.2581364586
574	458	1	0	1	30.4000290766
574	459	1	0	1	22.5554237402
574	460	4	1	3	29.5705535808
574	520	1	0	1	24.3053819362
574	524	11	0	11	28.159989446
574	539	0	0	0	42.0601891759
574	540	1	0	1	57.4259592204
574	548	0	0	0	100.442427655
574	551	1	0	1	28.4261030377
574	552	1	0	1	41.0384558943
574	554	49	0	49	18.7532509231
574	555	8	0	8	26.0921824309
574	557	5	1	4	11.1455375023
574	558	6	1	5	10.121255536
574	561	2	0	2	31.0123644661
574	562	2	1	1	18.6048639766
574	563	11	0	11	20.1808852297
574	564	0	0	0	36.0828680327
574	566	162	27	135	9.54719796148
574	567	8	0	8	14.0065821284
574	568	1	0	1	25.5486048599
574	569	3	1	2	29.0879276111
574	571	36	9	27	8.139959924
574	572	1	0	1	37.2818560705
574	573	187	0	187	20.985910258
574	575	3	1	2	24.8765572344
574	577	1	0	1	38.6698445469
574	578	1	0	1	18.2626810776
574	579	4	0	4	34.9421437633
574	580	2	1	1	27.3142009284
574	581	5	0	5	34.9356944766
575	1	3	0	3	102.887665534
575	13	1	0	1	87.532100485
575	36	0	0	0	77.4146936092
575	70	15	0	15	63.065409188
575	71	4	0	4	55.6769016727
575	72	2	0	2	66.2407836762
575	73	114	0	114	63.9416485384
575	74	14	0	14	59.4236389582
575	75	18	0	18	62.4036939904
575	76	7	0	7	60.4270813661
575	78	25	2	23	59.0653944703
575	79	1	0	1	66.7424750476
575	80	1	0	1	64.8963861419
575	81	5	0	5	64.396238812
575	82	7	1	6	60.9902701751
575	83	4	0	4	62.3225406964
575	84	11	1	10	62.4917783825
575	85	9	9	0	56.7068512158
575	86	5	0	5	54.5626042298
575	87	9	2	7	59.5762009285
575	88	2	0	2	57.5490549541
575	92	0	0	0	67.7472938417
575	96	2	0	2	57.2107021231
575	97	1	0	1	68.0281671768
575	103	4	0	4	64.6381281291
575	109	4	0	4	61.6650921483
575	111	1	0	1	72.2988231053
575	112	3	0	3	67.7229397513
575	113	8	0	8	60.2347198539
575	116	1	0	1	59.2685276006
575	122	1	0	1	67.6608016815
575	142	3	1	2	57.0548910473
575	146	1	0	1	54.1012765178
575	154	1	0	1	44.8212463626
575	155	4	0	4	47.1368560545
575	156	2	0	2	51.2717196606
575	158	1	0	1	33.6979599915
575	160	1	0	1	42.6855673937
575	163	2	0	2	39.3487067664
575	164	1	0	1	47.6818198449
575	165	2	0	2	32.5746743951
575	166	6	0	6	42.9256866929
575	167	2	0	2	28.9385208988
575	168	13	0	13	44.0051232513
575	171	2	0	2	47.8271301482
575	172	16	0	16	41.3817064467
575	173	1	0	1	27.9041204314
575	175	1	0	1	42.8977981269
575	177	29	6	23	37.7796797452
575	183	0	0	0	148.620776072
575	196	1	0	1	148.374405424
575	222	0	0	0	159.135841497
575	310	1	0	1	80.2482348363
575	319	100	15	85	28.3936541786
575	320	5	0	5	21.8541227427
575	321	1	0	1	36.203795239
575	322	3	1	2	21.0289923073
575	323	8	0	8	23.9384344714
575	324	1	1	0	36.1115647119
575	325	4	0	4	21.5566465505
575	326	1	1	0	43.8426102435
575	327	2	0	2	32.435142624
575	328	1	0	1	35.2358699816
575	329	4	1	3	44.4162757383
575	330	1	0	1	18.1632533946
575	331	1	0	1	31.8437479924
575	338	6	0	6	61.3214019184
575	341	2	0	2	73.8678389135
575	345	1	0	1	118.491762786
575	349	7	1	6	48.8593709279
575	353	0	0	0	59.8365843035
575	357	2	0	2	46.3394437401
575	360	1	0	1	41.4206395789
575	364	1	0	1	37.1738958051
575	366	1	0	1	29.9052101515
575	377	1	0	1	88.4269378282
575	379	4	0	4	39.5034276758
575	380	1	0	1	30.0027007137
575	385	7	0	7	31.6682958321
575	386	1	0	1	30.8800500033
575	389	1	0	1	45.830545366
575	391	1	0	1	38.0542180523
575	392	1	0	1	32.6004212843
575	396	1	0	1	58.8655922296
575	406	2	0	2	64.7020495703
575	408	20	2	18	60.9962127346
575	409	1	0	1	69.1427479965
575	411	0	0	0	54.1519524185
575	413	1	0	1	61.4659802609
575	415	5	2	3	52.1478399794
575	417	1	0	1	49.8879729094
575	427	1	0	1	74.8986852054
575	441	0	0	0	71.6440039067
575	442	1	0	1	77.1053311248
575	453	1	0	1	51.7282443273
575	455	0	0	0	36.685097456
575	457	1	0	1	53.299542135
575	459	1	0	1	44.9904820979
575	506	1	0	1	81.4193662467
575	507	4	0	4	104.018267493
575	512	2	0	2	77.537203185
575	520	1	0	1	46.8336668666
575	523	1	0	1	59.9367072491
575	524	17	1	16	40.9916081986
575	535	1	0	1	72.5221367361
575	536	2	0	2	56.4484777592
575	540	1	0	1	63.7732719483
575	548	0	0	0	104.048917573
575	551	26	0	26	6.40847028166
575	552	3	1	2	32.5963221521
575	554	20	6	14	23.955896216
575	555	63	0	63	16.1829620468
575	556	1	0	1	43.785700102
575	557	2	0	2	22.4793764142
575	558	1	0	1	29.8050262251
575	559	2	0	2	24.4197853208
575	561	2	0	2	34.2924527997
575	563	179	30	149	9.7050060766
575	564	1	0	1	20.0342521427
575	566	21	6	15	20.4480398271
575	567	14	3	11	11.6594149908
575	568	4	1	3	23.9726127256
575	569	70	51	19	8.41387551065
575	570	27	23	4	10.6590148416
575	571	1	0	1	16.7853331816
575	572	10	0	10	12.5723773286
575	573	1278	14	1264	9.98407816304
575	574	1	0	1	24.8765572344
575	576	6	1	5	23.2363072045
575	577	48	5	43	16.7303958566
575	578	3	0	3	22.84243351
575	579	44	1	43	15.2318787798
575	580	13	0	13	17.2429307186
575	581	47	1	46	21.6460356599
575	583	3	0	3	44.9412684092
575	584	1	0	1	27.2913711944
575	585	20	1	19	19.4603487712
575	586	0	0	0	28.59066847
575	587	1	0	1	30.4520242147
576	1	0	0	0	82.5565346855
576	36	1	0	1	56.8540750122
576	47	1	0	1	87.4682691288
576	70	21	3	18	40.0876617855
576	71	10	1	9	33.5909073476
576	72	4	0	4	43.4353229352
576	73	155	3	152	41.7173730116
576	74	14	3	11	37.0905730174
576	75	13	2	11	40.4557947929
576	76	9	0	9	37.5145765364
576	77	1	0	1	43.8464263206
576	78	24	1	23	36.5204382636
576	79	3	1	2	44.181458683
576	81	5	1	4	41.6699738598
576	82	10	0	10	38.2722172885
576	83	10	1	9	39.9259106226
576	84	15	0	15	40.283807874
576	85	15	4	11	33.8550819785
576	86	8	1	7	32.1945989415
576	87	14	0	14	37.7067093035
576	88	6	0	6	35.6784412564
576	90	2	0	2	32.7016040288
576	92	1	0	1	44.6665970237
576	95	1	0	1	49.1447799465
576	96	1	0	1	34.0383518781
576	98	2	0	2	28.1726406398
576	99	1	0	1	46.2096390777
576	103	2	0	2	43.2893294674
576	109	1	0	1	38.4453224359
576	110	3	0	3	44.4783704096
576	112	4	1	3	46.4361391358
576	113	7	1	6	39.2022129161
576	117	2	0	2	36.6503766877
576	119	2	0	2	29.1163687939
576	142	1	0	1	40.2090745018
576	146	1	0	1	33.2685963184
576	149	1	0	1	49.1106310462
576	154	2	0	2	30.0058181974
576	155	20	3	17	23.9201617602
576	156	1	1	0	28.1975022936
576	157	2	0	2	18.9009094387
576	158	8	0	8	11.4598630735
576	159	4	0	4	13.9055823698
576	160	5	1	4	25.3923415659
576	161	1	0	1	22.957902258
576	162	1	0	1	27.5594868518
576	163	4	0	4	28.8786657411
576	164	5	0	5	25.2587151365
576	165	9	0	9	12.4017069565
576	166	46	0	46	20.6470150662
576	167	8	0	8	17.8247535471
576	168	27	3	24	22.2700183672
576	169	1	0	1	34.302559412
576	170	31	5	26	6.67181676077
576	171	20	3	17	24.7414813037
576	172	44	6	38	21.0532637486
576	173	18	1	17	7.13155974861
576	175	9	1	8	19.9720849565
576	177	77	11	66	16.2102018799
576	179	1	0	1	37.0317734641
576	180	4	0	4	13.4132556457
576	245	1	0	1	59.7888743949
576	247	1	0	1	56.7324711024
576	277	2	0	2	86.6796093426
576	310	2	0	2	59.9242507285
576	312	1	0	1	65.0182138321
576	319	248	7	241	16.7153931651
576	320	25	2	23	15.4881029116
576	321	1	0	1	19.4628164238
576	322	7	3	4	10.9949705422
576	323	92	3	89	6.33790904792
576	324	1	0	1	23.9031639723
576	325	5	0	5	20.620782099
576	326	1	0	1	26.0364345318
576	327	3	0	3	23.4095516074
576	328	4	0	4	15.7155653192
576	329	10	0	10	24.1250241119
576	330	3	0	3	13.6700770641
576	331	8	1	7	10.9171842469
576	334	1	0	1	52.9520600724
576	338	8	0	8	45.3865133932
576	341	1	0	1	56.87837593
576	349	11	0	11	32.1077874023
576	351	1	0	1	35.1711479533
576	353	2	0	2	40.122007019
576	355	4	0	4	27.5040747729
576	357	1	0	1	32.8532168801
576	366	2	0	2	25.8838801609
576	367	4	0	4	26.8933690193
576	375	1	0	1	84.9780056915
576	377	0	0	0	69.2532660897
576	380	1	0	1	35.6579444909
576	385	3	2	1	43.9479124945
576	391	1	0	1	45.8364946702
576	392	0	0	0	42.1564479941
576	408	5	0	5	70.7475322411
576	411	0	0	0	64.9012932531
576	524	1	0	1	63.3254991925
576	536	1	0	1	78.6459199097
576	537	1	0	1	75.7851272063
576	538	0	0	0	66.9205759876
576	540	0	0	0	87.0025882041
576	554	3	0	3	46.6557818641
576	555	2	0	2	39.1661178534
576	561	1	0	1	57.5230811977
576	563	2	0	2	32.7986713052
576	566	3	0	3	32.5099425908
576	568	6	0	6	21.643371317
576	569	8	0	8	14.8860650364
576	570	2	1	1	15.8442291652
576	572	1	0	1	23.1469934319
576	573	137	16	121	20.4734202345
576	574	1	0	1	41.1596059976
576	575	3	1	2	23.2363072045
576	577	54	0	54	9.01258730929
576	579	43	24	19	8.02269447652
576	580	7	0	7	14.6521672251
576	581	171	38	133	8.13292557315
576	583	1	0	1	55.0471055563
576	585	4	2	2	30.4196735235
576	586	1	0	1	39.7688179693
577	1	3	0	3	91.5595025317
577	39	1	0	1	72.3753606963
577	41	1	0	1	68.7637292526
577	62	1	0	1	111.405200653
577	70	19	6	13	48.4228646564
577	71	8	1	7	42.4493886327
577	72	2	0	2	51.9134575236
577	73	193	21	172	50.4997981716
577	74	17	3	14	45.8543588307
577	75	23	8	15	49.3216324804
577	76	16	2	14	45.9327874942
577	77	1	0	1	52.4146419641
577	78	32	2	30	45.1957435714
577	79	2	0	2	52.8118700233
577	81	4	1	3	50.2137615274
577	82	17	1	16	46.8391333656
577	83	7	0	7	48.6515373011
577	84	16	0	16	49.0772952521
577	85	12	0	12	42.3512370342
577	86	8	2	6	40.9711653182
577	87	21	5	16	46.5997433127
577	88	3	0	3	44.5785771465
577	89	1	0	1	58.6790781856
577	90	1	0	1	40.6162812499
577	92	4	0	4	52.8397175584
577	95	1	0	1	58.0263524102
577	96	1	0	1	41.2700518315
577	102	3	0	3	67.2679533955
577	103	7	3	4	52.2507479963
577	104	1	0	1	61.1495291264
577	107	2	0	2	36.6622687263
577	109	3	0	3	46.2863284588
577	110	4	1	3	53.4892683648
577	112	8	1	7	55.3988767345
577	113	7	0	7	48.1984755525
577	116	2	1	1	44.4433189557
577	117	1	0	1	45.6179471325
577	118	1	0	1	40.6920058748
577	120	1	0	1	55.9964127232
577	121	1	0	1	45.028758375
577	140	1	0	1	49.454254463
577	142	1	0	1	48.8375083971
577	145	2	0	2	57.610303533
577	146	1	0	1	42.279254635
577	154	2	0	2	38.0476278557
577	155	20	8	12	31.459358256
577	156	3	0	3	35.1901298237
577	157	2	0	2	27.2243326046
577	158	8	1	7	20.4437978362
577	159	4	1	3	21.6085389257
577	160	1	0	1	33.9228114752
577	161	1	0	1	30.3047969436
577	162	2	1	1	33.6745784146
577	163	4	0	4	35.6312262446
577	164	3	0	3	34.0618457798
577	165	3	0	3	21.2366260327
577	166	33	0	33	26.3935084959
577	167	10	0	10	24.058256309
577	168	20	2	18	31.2484217579
577	169	7	0	7	40.7205289816
577	170	7	0	7	14.5117979076
577	171	8	0	8	33.0605688641
577	172	49	24	25	30.0268589022
577	173	6	0	6	15.9014216561
577	175	3	0	3	28.543200351
577	176	1	0	1	36.3186904667
577	177	51	0	51	25.2209414881
577	178	1	0	1	29.9749788096
577	179	1	0	1	42.746007418
577	180	1	0	1	21.2499201555
577	183	2	0	2	132.342278939
577	186	1	0	1	123.132721031
577	204	1	0	1	92.7382770306
577	220	1	0	1	146.185318098
577	254	1	0	1	70.8037858236
577	257	1	0	1	74.6362458623
577	277	1	0	1	94.0486421581
577	281	0	0	0	84.3689244316
577	310	0	0	0	63.6525509391
577	311	1	0	1	66.6401200033
577	318	4	0	4	23.6620986
577	319	919	155	764	13.4836324731
577	320	147	118	29	8.87102145985
577	321	21	0	21	20.014577705
577	322	67	2	65	5.40104939887
577	323	216	17	199	7.27656011664
577	324	4	0	4	21.6210964988
577	325	9	2	7	12.8258249374
577	326	9	1	8	27.5762325489
577	327	11	0	11	19.3226007626
577	328	3	2	1	18.5295469988
577	329	11	0	11	27.7116796949
577	330	45	5	40	5.57830478581
577	331	11	3	8	15.1998160842
577	332	1	0	1	58.2154002646
577	336	1	0	1	51.6625069433
577	338	27	1	26	45.9540653373
577	341	3	0	3	58.2153518635
577	342	1	0	1	55.2068771902
577	347	2	0	2	38.7285060629
577	349	18	0	18	33.0037017206
577	350	1	0	1	63.0116407616
577	353	6	3	3	43.2922952651
577	354	1	0	1	33.7851011172
577	355	8	0	8	25.6073367038
577	356	2	0	2	35.2433808746
577	357	2	0	2	31.7060715258
577	359	0	0	0	37.6965250153
577	361	4	0	4	28.6837903304
577	363	1	0	1	57.1039088647
577	364	6	1	5	25.836861027
577	365	1	0	1	37.6281076712
577	366	8	0	8	19.7592901479
577	367	9	1	8	26.7122465253
577	375	2	0	2	87.7974468046
577	379	3	0	3	50.2925725597
577	380	1	0	1	37.0947114444
577	385	4	0	4	43.2183247979
577	390	1	0	1	51.454892851
577	392	1	0	1	42.4319525995
577	406	2	1	1	74.3952068223
577	408	11	0	11	71.5887211587
577	410	1	0	1	67.2732712773
577	411	1	0	1	65.26348453
577	412	1	0	1	81.1840412941
577	414	1	0	1	82.0701834234
577	415	2	0	2	61.6494441861
577	430	1	0	1	84.0491226817
577	442	0	0	0	89.4703265085
577	447	1	0	1	98.8144502706
577	455	1	0	1	40.2337227383
577	457	1	0	1	59.8236753627
577	471	1	0	1	86.7744090362
577	475	2	0	2	57.6766084031
577	491	1	0	1	86.6829984091
577	496	1	0	1	64.579169802
577	512	4	0	4	94.2563338847
577	524	17	1	16	57.7160187016
577	534	1	0	1	68.1544869208
577	536	1	0	1	70.303081414
577	551	3	0	3	19.5444083831
577	554	4	0	4	40.685064276
577	555	10	1	9	31.6850962318
577	557	4	1	3	38.7580480177
577	561	2	1	1	50.5542931605
577	563	8	0	8	26.3959302786
577	564	1	0	1	31.5255743096
577	566	17	0	17	31.2760336054
577	567	4	0	4	27.5405071175
577	568	6	0	6	24.8336970997
577	569	68	43	25	9.65297189048
577	570	87	10	77	7.29938885214
577	571	1	0	1	30.7699099624
577	572	12	0	12	14.1700375299
577	573	547	100	447	17.9059406783
577	575	18	0	18	16.7303958566
577	576	79	54	25	9.01258730929
577	578	4	1	3	28.5566798385
577	579	436	48	388	4.83399646793
577	580	19	4	15	16.2746922265
577	581	155	0	155	13.5309799733
577	583	4	0	4	46.5171726034
577	585	33	0	33	21.4436520701
577	586	10	0	10	30.9218559763
577	587	1	0	1	23.9593027823
577	588	1	0	1	43.6707355285
578	36	2	0	2	64.9041970392
578	59	1	0	1	76.4875270441
578	70	9	2	7	57.6918829182
578	71	3	1	2	48.0465270951
578	72	2	0	2	59.8235192607
578	73	81	5	76	55.8182680322
578	74	9	0	9	52.0232400283
578	75	11	2	9	53.7237756785
578	76	5	0	5	54.9544275435
578	78	16	1	15	52.3320825017
578	79	2	0	2	59.3888471331
578	80	1	0	1	57.9910058168
578	82	7	0	7	54.6652920764
578	83	4	0	4	54.8257149843
578	84	12	0	12	54.4544669912
578	85	7	0	7	51.3247735058
578	86	7	2	5	47.8028034368
578	87	16	0	16	50.9948093388
578	88	3	0	3	49.1919602944
578	92	2	0	2	62.6471955412
578	93	1	0	1	73.8537157816
578	96	2	0	2	56.280385171
578	103	1	0	1	54.4660129057
578	110	1	0	1	53.3676509035
578	112	3	0	3	57.1698325406
578	113	6	0	6	49.8956053003
578	117	0	0	0	48.7030372771
578	120	1	0	1	61.9833263052
578	121	1	0	1	47.4157521131
578	140	1	0	1	47.5750447599
578	141	0	0	0	22.939276768
578	142	1	0	1	41.5356941982
578	146	2	1	1	44.1564433374
578	154	3	1	2	29.2665151651
578	155	7	0	7	46.5677652042
578	156	1	0	1	51.5504246287
578	157	4	1	3	25.6429690077
578	160	2	1	1	30.2126465301
578	161	3	0	3	21.7024242637
578	163	6	0	6	21.3617896686
578	164	3	1	2	42.0525860247
578	165	1	0	1	27.3109431308
578	166	4	0	4	46.5160533102
578	167	9	0	9	16.5515797055
578	168	9	0	9	37.4782067484
578	169	1	1	0	58.2218063598
578	171	1	0	1	44.6754932474
578	172	38	1	37	33.1163883128
578	175	2	0	2	39.7414807021
578	176	6	2	4	15.2129161715
578	177	37	0	37	32.5418583685
578	178	2	1	1	13.4755930545
578	191	1	0	1	159.665097915
578	219	1	0	1	164.770526618
578	277	1	0	1	105.888311256
578	288	1	0	1	117.39862356
578	319	39	2	37	41.80906124
578	320	3	0	3	37.2468905938
578	321	3	1	2	46.5947811604
578	323	6	0	6	32.5596516462
578	329	3	0	3	51.1872654274
578	345	1	0	1	124.120648015
578	349	1	0	1	59.4301990022
578	351	1	0	1	62.5037183672
578	353	1	0	1	67.0584964031
578	375	1	0	1	111.742394838
578	379	2	0	2	22.9205311224
578	380	4	1	3	8.54522137534
578	384	2	1	1	8.47832837549
578	385	17	6	11	17.4401144943
578	387	1	0	1	23.9304345332
578	391	8	1	7	18.5741967148
578	392	6	0	6	14.887747382
578	400	1	0	1	48.3343049176
578	401	1	0	1	45.7751678794
578	406	3	0	3	45.9488869008
578	408	24	1	23	43.4679449779
578	411	0	0	0	37.5445009379
578	412	1	0	1	53.2537976383
578	415	9	0	9	33.2489143723
578	417	3	0	3	32.4251392488
578	426	1	0	1	80.6315075809
578	438	1	0	1	62.8911495244
578	441	1	0	1	58.9109856955
578	442	2	0	2	62.2363607856
578	450	1	0	1	13.3408328246
578	454	1	0	1	18.8028925776
578	455	19	1	18	13.8596802725
578	460	1	0	1	25.1256127953
578	461	6	0	6	7.57092492765
578	469	3	0	3	48.0664793013
578	475	2	0	2	32.3212092503
578	496	1	0	1	37.4064746589
578	507	1	0	1	113.420758969
578	524	9	0	9	45.9223000907
578	538	1	0	1	55.8606682438
578	551	2	0	2	29.0166441373
578	552	1	0	1	51.3277028595
578	554	3	0	3	33.0631886348
578	555	2	0	2	34.0219383021
578	557	2	0	2	26.4367202928
578	558	1	1	0	28.3052042093
578	563	4	1	3	25.6547465231
578	566	73	21	52	8.99270612929
578	568	58	39	19	7.52185298641
578	569	12	1	11	21.061798044
578	570	2	0	2	28.103474286
578	571	2	0	2	15.3611457805
578	573	656	99	557	13.1918642894
578	574	1	0	1	18.2626810776
578	575	3	0	3	22.84243351
578	576	3	0	3	27.3567973879
578	577	14	0	14	28.5566798385
578	579	6	1	5	23.8246068677
578	580	10	2	8	12.8293242882
578	581	22	1	21	19.6532756427
578	583	0	0	0	67.744067673
578	585	1	0	1	41.8551064255
579	1	1	0	1	89.6249716301
579	24	1	0	1	82.4933826356
579	36	1	0	1	63.9478848668
579	41	1	0	1	66.4232820533
579	59	1	0	1	91.1135903376
579	70	21	0	21	48.0513246476
579	71	8	1	7	41.2068413669
579	72	1	0	1	51.3434057516
579	73	181	5	176	49.4093502529
579	74	22	0	22	44.8147185761
579	75	25	3	22	48.0374719861
579	76	11	2	9	45.4549373875
579	78	33	0	33	44.3252677577
579	79	2	0	2	52.0033979299
579	80	3	0	3	50.098383185
579	81	11	0	11	49.5486990803
579	82	14	6	8	46.1442767623
579	83	4	1	3	47.6802594395
579	84	16	1	15	47.9664666921
579	85	13	0	13	41.7707799894
579	86	10	0	10	39.9205390858
579	87	14	0	14	45.2489637929
579	88	7	0	7	43.2141164475
579	96	1	0	1	41.9872228147
579	103	1	0	1	50.6434949224
579	104	1	0	1	60.0636723124
579	107	2	0	2	34.8193301859
579	110	3	0	3	51.5154156094
579	112	7	2	5	53.7767667492
579	113	14	0	14	46.4117838993
579	116	1	0	1	44.1907752708
579	118	3	0	3	40.3677606671
579	120	1	0	1	55.1351606162
579	124	1	0	1	59.0380144438
579	129	0	0	0	57.1196980176
579	135	1	0	1	36.9887356404
579	142	1	0	1	45.6985764257
579	146	5	0	5	40.3591535493
579	154	5	0	5	34.4203984521
579	155	17	9	8	31.9049801198
579	156	1	0	1	36.0771889216
579	157	5	0	5	23.9781260967
579	158	7	0	7	18.9914954086
579	159	6	2	4	21.8838305177
579	160	1	0	1	30.782895453
579	161	2	0	2	26.3505496057
579	162	2	0	2	35.1465157336
579	163	1	0	1	31.3617099253
579	164	2	1	1	32.9852448974
579	165	3	1	2	18.7934025687
579	166	27	4	23	28.0255979385
579	167	10	0	10	19.7668702632
579	168	23	6	17	29.6715935677
579	169	1	0	1	42.0284113248
579	170	8	1	7	14.6034798182
579	171	14	3	11	32.7314314663
579	172	42	5	37	27.7726228349
579	173	5	1	4	13.6063551824
579	175	4	0	4	27.8958690202
579	176	1	0	1	31.6206011578
579	177	65	4	61	23.4607601215
579	180	1	1	0	17.7948603986
579	183	1	0	1	133.429647664
579	190	1	0	1	135.285554818
579	310	1	0	1	66.4976526984
579	312	1	0	1	70.0568322106
579	313	1	0	1	58.996572487
579	314	0	0	0	64.0621163042
579	318	1	0	1	27.5358500584
579	319	401	93	308	18.0166595833
579	320	53	2	51	13.7020251805
579	321	11	1	10	23.7262948583
579	322	20	2	18	10.059103267
579	323	94	4	90	9.82612679783
579	324	2	1	1	26.1066297719
579	325	6	1	5	17.3678781533
579	326	5	1	4	31.0892205256
579	327	2	0	2	24.0728028243
579	328	3	0	3	21.3848801118
579	329	16	0	16	30.429481947
579	330	18	0	18	10.2496204044
579	331	2	0	2	17.2936643524
579	332	2	0	2	62.2879179891
579	333	1	0	1	63.6940237588
579	334	1	0	1	56.6995859073
579	338	17	4	13	49.9115732872
579	339	1	1	0	58.0192042163
579	341	1	0	1	61.9735786497
579	349	14	3	11	36.7856636371
579	350	1	0	1	65.2774102758
579	353	2	0	2	46.3124132534
579	355	3	1	2	30.0556544316
579	356	1	0	1	40.041216601
579	357	1	0	1	36.038189519
579	358	2	1	1	54.0674619719
579	361	2	0	2	33.3723416519
579	364	2	0	2	30.6608030642
579	366	1	0	1	24.5695334771
579	367	2	1	1	30.752864597
579	368	1	0	1	47.9183216379
579	372	1	0	1	96.1595483545
579	375	1	0	1	91.0698168646
579	379	5	0	5	45.8382225793
579	382	1	0	1	67.2965748483
579	385	6	0	6	38.9395463016
579	391	1	0	1	42.2777116032
579	394	1	0	1	51.288580598
579	396	4	1	3	63.1394851333
579	401	1	0	1	68.796976318
579	406	1	0	1	69.73041667
579	408	12	0	12	67.0231809234
579	410	1	0	1	62.6776435143
579	411	2	0	2	60.7828571457
579	414	0	0	0	77.3457624433
579	415	3	0	3	56.9973919501
579	416	2	0	2	76.3566038062
579	417	1	0	1	55.8522341972
579	425	1	0	1	86.1628762058
579	427	1	0	1	81.5473425159
579	438	1	0	1	84.2991423492
579	441	0	0	0	80.8794015949
579	442	1	0	1	85.1234358446
579	453	1	0	1	55.5544056092
579	455	2	0	2	35.4027284293
579	457	1	0	1	55.0053489983
579	458	1	0	1	52.6344073472
579	469	0	0	0	68.1308010458
579	471	1	0	1	82.3779684519
579	475	2	0	2	52.9096873481
579	507	2	0	2	119.229798723
579	510	1	0	1	104.820411224
579	512	5	0	5	92.3773855901
579	524	15	2	13	55.6546006015
579	540	1	0	1	78.9848888001
579	551	7	1	6	19.4844174469
579	554	10	0	10	38.8411230581
579	555	8	1	7	31.1514616692
579	557	2	0	2	36.1112244069
579	559	1	0	1	39.3507714174
579	560	1	0	1	25.422786765
579	561	1	0	1	49.5243314965
579	562	1	0	1	49.4335072742
579	563	8	0	8	24.8456474021
579	564	1	0	1	32.5575358079
579	566	14	2	12	27.0687893563
579	567	4	0	4	24.8711598787
579	568	10	0	10	20.0099342077
579	569	63	14	49	6.96805775426
579	570	35	2	33	8.74318698138
579	571	0	0	0	27.2731976122
579	572	5	0	5	16.5289925566
579	573	826	24	802	13.9621140175
579	574	1	0	1	34.9421437633
579	575	10	4	6	15.2318787798
579	576	54	16	38	8.02269447652
579	577	518	378	140	4.83399646793
579	578	10	0	10	23.8246068677
579	580	26	10	16	11.4415174578
579	581	164	25	139	9.47284093649
579	582	2	0	2	36.6805788736
579	583	3	1	2	50.216454729
579	585	18	4	14	24.4555662626
579	586	6	0	6	34.2295313342
580	36	0	0	0	60.9807319863
580	70	17	0	17	49.3404616049
580	71	12	1	11	40.7251729768
580	73	191	8	183	48.9299849589
580	74	22	3	19	44.6514156123
580	75	16	0	16	47.1331764298
580	76	5	0	5	46.6032514716
580	78	31	0	31	44.5943354647
580	79	2	0	2	52.1152770368
580	81	7	1	6	50.0909546447
580	82	25	2	23	46.7517483115
580	83	8	0	8	47.5595943166
580	84	28	4	24	47.4934522883
580	85	12	0	12	42.853586521
580	86	6	1	5	39.9821729433
580	87	18	0	18	44.297220635
580	88	5	0	5	42.3244370733
580	89	1	0	1	59.2897802972
580	92	1	0	1	54.2396207856
580	102	1	0	1	65.3313703009
580	103	1	0	1	48.8263929485
580	107	1	0	1	33.2181570865
580	109	2	0	2	49.0774292199
580	110	2	0	2	48.7203917319
580	112	4	1	3	51.8162845442
580	113	9	0	9	44.2983346074
580	119	1	0	1	38.9416028239
580	137	1	0	1	32.1124887103
580	142	2	0	2	39.8803201763
580	146	2	0	2	38.1921133672
580	147	1	0	1	32.7357688893
580	154	2	0	2	27.5859860089
580	155	7	0	7	35.8716283589
580	156	1	0	1	40.6810085123
580	157	6	1	5	19.4252915396
580	158	2	0	2	20.512142281
580	160	3	0	3	25.794705078
580	161	3	1	2	18.936734189
580	163	6	0	6	22.3788400463
580	164	8	2	6	33.4637481525
580	165	7	0	7	17.7929863833
580	166	7	0	7	34.5635840099
580	167	14	0	14	11.7022614299
580	168	41	4	37	29.2188174804
580	169	3	0	3	47.2090323681
580	170	1	1	0	20.3224802135
580	171	7	4	3	34.9682173724
580	172	70	15	55	25.7298251285
580	173	4	0	4	14.7488707559
580	175	3	0	3	29.8655112391
580	176	3	1	2	20.8515826848
580	177	76	9	67	23.3493947029
580	180	2	0	2	13.8006120955
580	241	1	0	1	167.557076156
580	273	1	0	1	94.9451280351
580	277	0	0	0	97.3609300286
580	281	0	0	0	88.2228279458
580	319	64	1	63	29.1789855018
580	320	4	0	4	25.1356544518
580	321	1	0	1	33.7687260781
580	323	10	0	10	19.7343444782
580	325	2	0	2	28.4569762204
580	329	3	0	3	38.7056404948
580	330	1	0	1	21.5694493197
580	331	1	0	1	25.5647332725
580	334	1	0	1	67.2127346703
580	338	3	0	3	59.9078729005
580	341	0	0	0	71.5177289546
580	344	1	0	1	63.2410269016
580	349	3	1	2	46.6354313736
580	366	1	0	1	35.9630680582
580	367	1	0	1	41.1010298615
580	370	1	0	1	97.9605462088
580	375	1	0	1	99.4890395043
580	379	3	0	3	35.5627056996
580	385	2	0	2	29.3435952724
580	391	1	0	1	31.4003591649
580	392	2	0	2	27.5236364593
580	396	1	0	1	52.0132484177
580	400	1	0	1	61.1578240349
580	401	1	0	1	58.507321594
580	406	3	0	3	58.7206892726
580	408	10	0	10	56.2970938639
580	411	2	0	2	50.323453503
580	415	8	0	8	46.0511670488
580	417	2	0	2	45.2381828084
580	426	1	0	1	93.3736862023
580	427	1	0	1	70.9003740558
580	430	1	0	1	73.4230142319
580	441	0	0	0	71.3043906734
580	442	2	0	2	74.9473248764
580	455	4	0	4	23.9911726221
580	471	1	0	1	72.3205632578
580	501	0	0	0	71.7342647321
580	507	1	0	1	118.165436757
580	512	1	0	1	88.581700026
580	520	1	0	1	51.6056298527
580	524	6	2	4	52.008078688
580	529	1	0	1	81.3318488541
580	536	0	0	0	72.9964552436
580	539	1	0	1	56.1203620474
580	540	1	0	1	78.1790071578
580	548	0	0	0	119.713096608
580	552	1	0	1	49.6187162815
580	554	7	0	7	36.4605668735
580	555	7	0	7	32.5822450633
580	561	1	0	1	48.6864881015
580	562	1	0	1	44.2327922201
580	563	9	0	9	24.5636838306
580	566	12	0	12	18.1894855233
580	567	2	0	2	21.5121232361
580	568	26	0	26	8.68682480787
580	569	9	3	6	11.2174291921
580	570	5	0	5	17.7139112577
580	571	3	0	3	20.9693772213
580	573	971	130	841	8.89706798426
580	575	8	0	8	17.2429307186
580	576	10	4	6	14.6521672251
580	577	19	0	19	16.2746922265
580	578	8	5	3	12.8293242882
580	579	27	0	27	11.4415174578
580	581	134	99	35	7.62303162036
580	583	1	0	1	59.4896679555
580	585	6	0	6	33.2027883481
581	1	3	0	3	81.352912353
581	5	1	0	1	85.2713755591
581	36	0	0	0	55.8088011055
581	46	1	0	1	84.9171350653
581	70	38	3	35	42.3437300283
581	71	34	7	27	34.2625247488
581	72	4	0	4	45.2427038631
581	73	745	15	730	42.5304366859
581	74	96	38	58	38.1006662866
581	75	51	30	21	40.8938472526
581	76	27	2	25	39.6308497976
581	77	1	0	1	45.3830554864
581	78	149	0	149	37.8880423282
581	79	6	0	6	45.5130629644
581	80	1	1	0	43.7529305132
581	81	31	1	30	43.3288307711
581	82	63	13	50	39.9473018366
581	83	32	15	17	41.0140333235
581	84	67	0	67	41.0818017877
581	85	43	3	40	35.8743457708
581	86	39	14	25	33.3095638718
581	87	105	28	77	38.0565419388
581	88	23	2	21	36.0412412677
581	90	2	0	2	36.060331409
581	92	7	0	7	47.1873415683
581	95	4	0	4	49.3259462681
581	96	1	0	1	38.4035502969
581	98	2	0	2	29.3218247463
581	103	17	0	17	43.0065737015
581	104	1	0	1	53.0484988659
581	107	10	1	9	27.1475313506
581	109	5	0	5	41.7568143241
581	110	4	1	3	43.3951826464
581	111	1	0	1	52.0644870955
581	112	12	0	12	46.0834737816
581	113	44	19	25	38.5901765017
581	116	6	0	6	38.7815586677
581	117	2	0	2	36.4615180001
581	118	1	0	1	34.951859852
581	119	1	0	1	31.7279926835
581	120	2	0	2	48.5154757892
581	129	1	0	1	48.4923341268
581	135	3	0	3	27.6438863147
581	137	2	0	2	27.0710509673
581	138	0	0	0	50.2993745539
581	140	1	0	1	38.6051365051
581	142	9	0	9	36.4693151965
581	145	1	0	1	45.1030549747
581	146	1	0	1	32.4557958578
581	147	3	0	3	33.0122638006
581	154	12	0	12	24.9763579662
581	155	31	0	31	28.2939162014
581	156	2	0	2	33.0739470896
581	157	19	0	19	14.8322079581
581	158	20	17	3	13.0977033352
581	159	8	2	6	18.9179680641
581	160	8	0	8	21.6404256753
581	163	22	4	18	22.1021623539
581	164	29	8	21	26.5767201933
581	165	42	26	16	11.0434349632
581	166	40	19	21	27.0447245525
581	167	40	1	39	10.550400005
581	168	115	35	80	22.5947186991
581	169	2	0	2	39.5886567941
581	170	7	1	6	12.9069175557
581	171	23	2	21	27.6344850776
581	172	249	113	136	19.7386807545
581	173	59	15	44	7.2048926666
581	175	12	0	12	22.5323667224
581	176	3	0	3	23.4333074533
581	177	326	199	127	16.4667620765
581	178	3	0	3	16.9004830706
581	179	2	0	2	42.8793498217
581	180	33	0	33	8.59078455345
581	211	1	0	1	112.742580285
581	239	1	0	1	116.118077541
581	281	0	0	0	80.8996449373
581	307	1	0	1	79.9227493181
581	310	0	0	0	66.773498838
581	313	1	0	1	59.7012137072
581	316	1	0	1	72.4065382041
581	318	1	0	1	31.522228385
581	319	192	2	190	24.435525624
581	320	10	3	7	21.920642239
581	321	5	1	4	27.5792460955
581	322	3	1	2	17.6001670772
581	323	40	1	39	14.192046075
581	324	4	0	4	31.9173238032
581	325	4	1	3	26.3451302395
581	326	5	0	5	33.9777931011
581	327	2	0	2	31.0493935501
581	329	13	0	13	31.5363035724
581	331	4	2	2	18.6741802194
581	332	1	0	1	65.9018694214
581	338	17	0	17	53.3674338843
581	341	2	1	1	64.6557181461
581	349	8	1	7	40.1025456483
581	351	1	0	1	42.9442312992
581	353	2	0	2	47.4124563492
581	354	1	0	1	37.4376041805
581	355	1	0	1	35.58423166
581	356	1	0	1	48.2179134897
581	358	1	0	1	63.3174769657
581	364	1	0	1	38.0889450983
581	367	1	1	0	35.0160072107
581	375	2	0	2	92.1456745788
581	379	3	0	3	42.5738020856
581	380	1	0	1	27.7551901291
581	381	1	1	0	47.0616091739
581	384	1	0	1	28.0427603122
581	385	6	3	3	36.7120897325
581	392	1	1	0	34.5388414104
581	396	2	1	1	58.0270128439
581	398	1	0	1	71.0208999865
581	408	16	1	15	62.8276028484
581	411	2	0	2	57.1172925337
581	413	1	0	1	67.7849875056
581	415	8	0	8	52.3807659539
581	416	1	0	1	71.8177311842
581	441	0	0	0	78.5240874832
581	442	3	0	3	81.8579656192
581	455	4	0	4	28.5420227818
581	475	1	0	1	44.974293725
581	512	0	0	0	95.8305918283
581	521	0	0	0	66.6228309432
581	524	9	0	9	59.1454612269
581	530	1	0	1	87.3956208551
581	536	1	0	1	78.0944947708
581	537	1	0	1	73.1025418831
581	548	0	0	0	125.516564028
581	551	1	0	1	27.1565875671
581	554	19	0	19	43.1521561243
581	555	8	1	7	37.7543233453
581	558	2	0	2	43.796719971
581	559	1	0	1	45.9646396945
581	560	1	0	1	33.5087233974
581	561	2	1	1	54.9525495537
581	563	3	1	2	30.3035729016
581	565	2	0	2	79.6849818417
581	566	18	0	18	25.783826249
581	567	1	0	1	28.2780169049
581	568	24	0	24	13.5454669438
581	569	31	2	29	13.6841073179
581	570	4	0	4	18.0293062039
581	572	1	0	1	25.8468845579
581	573	717	208	509	15.5805994565
581	575	3	1	2	21.6460356599
581	576	67	2	65	8.13292557315
581	577	58	4	54	13.5309799733
581	578	8	0	8	19.6532756427
581	579	64	39	25	9.47284093649
581	580	35	19	16	7.62303162036
581	582	1	0	1	45.9456028934
581	583	1	0	1	59.6848828154
581	585	11	1	10	33.8815657222
581	586	0	0	0	43.6874875953
581	587	2	0	2	37.4435974201
582	68	1	1	0	107.775075284
582	70	5	1	4	72.9497156455
582	73	21	5	16	77.2567029995
582	74	8	0	8	72.7404912238
582	75	1	0	1	76.7246814006
582	76	2	0	2	71.0307087361
582	78	5	0	5	71.6147917129
582	81	1	0	1	75.6170376604
582	82	2	0	2	72.5828840063
582	84	1	0	1	75.9783067757
582	85	1	0	1	68.0915593064
582	86	1	0	1	68.2301339453
582	87	3	0	3	74.3405915622
582	90	1	0	1	64.2129687447
582	92	1	0	1	76.3021276918
582	95	1	0	1	85.2122990713
582	100	1	0	1	91.8492554661
582	109	1	0	1	68.9715993957
582	113	1	1	0	77.0293698493
582	142	1	0	1	80.4368564349
582	155	4	1	3	55.2264969967
582	166	3	0	3	47.0200469083
582	168	1	0	1	60.5346853265
582	172	2	0	2	60.6720996433
582	176	1	0	1	67.9244380668
582	177	3	1	2	55.3321955282
582	183	1	0	1	145.933907275
582	277	0	0	0	111.470682033
582	310	0	0	0	69.5038983796
582	319	250	0	250	26.8642478401
582	320	15	1	14	24.9536758356
582	321	4	1	3	33.2883290803
582	322	3	0	3	29.4053629136
582	323	4	0	4	34.8940886612
582	324	1	0	1	26.6234112045
582	325	8	3	5	19.7702820603
582	326	1	0	1	37.6565065734
582	327	8	0	8	22.3768459073
582	328	2	0	2	37.3949959464
582	329	5	0	5	42.7912360586
582	332	1	0	1	52.9939646915
582	333	1	0	1	51.6438488995
582	338	8	0	8	44.8538207704
582	342	1	0	1	49.0679609839
582	348	1	0	1	62.4520877651
582	349	6	0	6	38.2775491788
582	353	1	0	1	51.4601916546
582	355	3	0	3	27.7359482093
582	356	6	2	4	13.7988535242
582	358	26	3	23	17.3868861269
582	359	0	0	0	25.3302018074
582	360	24	18	6	6.56185672735
582	361	1	0	1	24.0070883068
582	363	4	0	4	25.1483122232
582	364	8	0	8	18.4168023009
582	366	16	0	16	16.5284686543
582	367	2	1	1	32.8087835996
582	368	2	1	1	16.2649438938
582	375	0	0	0	87.638856041
582	406	1	0	1	99.9250737908
582	408	0	0	0	96.0185653894
582	421	1	0	1	115.739175844
582	524	5	0	5	64.6606321433
582	530	1	0	1	62.1513591161
582	554	1	0	1	49.8092739134
582	555	7	0	7	36.8637947782
582	561	1	0	1	52.2443493297
582	563	1	0	1	39.3302970418
582	566	1	0	1	55.7874405567
582	569	0	0	0	36.3356549739
582	571	1	0	1	51.4673309598
582	572	9	2	7	23.0941884466
582	573	21	2	19	43.9769621525
582	577	3	0	3	32.4343416513
582	579	4	0	4	36.6805788736
582	580	1	0	1	47.0939442513
582	581	3	0	3	45.9456028934
582	583	40	1	39	16.0653150429
582	584	0	0	0	19.0868152445
582	585	37	0	37	16.1152847609
582	586	88	30	58	10.8220244006
582	587	56	18	38	9.68293794626
582	588	3	0	3	19.3956451564
583	1	2	0	2	135.588029002
583	5	1	0	1	141.456247373
583	14	1	0	1	121.224933379
583	36	1	0	1	110.220428925
583	59	1	0	1	141.194839369
583	70	5	0	5	88.9924951709
583	71	2	0	2	85.9459083191
583	72	1	0	1	92.9100351776
583	73	41	3	38	93.1886700362
583	74	8	7	1	88.6444847251
583	75	5	0	5	92.5934524631
583	76	2	0	2	87.0477373711
583	78	7	0	7	87.553672047
583	81	2	0	2	91.6318833227
583	82	6	0	6	88.57122426
583	83	1	0	1	91.0954854193
583	84	6	0	6	91.8933790604
583	85	2	0	2	84.0640976903
583	86	4	0	4	84.0762505148
583	87	4	0	4	90.1613398581
583	89	1	0	1	98.5082938134
583	110	1	0	1	98.2494834029
583	112	2	0	2	99.3099308972
583	113	4	0	4	92.7040025351
583	120	1	0	1	97.7182770515
583	146	1	0	1	87.2265524015
583	155	3	0	3	71.2385121942
583	156	2	0	2	72.7352756304
583	160	0	0	0	80.383141541
583	164	1	0	1	77.6859784139
583	166	8	0	8	63.0759299052
583	168	5	0	5	76.0271179048
583	169	1	0	1	75.4161219028
583	171	4	0	4	74.9308741036
583	172	2	0	2	75.825753251
583	177	3	0	3	70.5927912623
583	229	1	0	1	138.161519169
583	251	1	0	1	93.9377552284
583	277	0	0	0	127.045782519
583	303	1	0	1	136.108231924
583	310	0	0	0	83.6789063621
583	318	1	0	1	49.1898102596
583	319	250	144	106	42.7451122094
583	320	14	1	13	40.0648919283
583	321	3	0	3	49.3533256371
583	323	4	1	3	50.0536887937
583	324	3	0	3	42.623935341
583	325	15	7	8	34.5960100209
583	326	1	0	1	53.5295081554
583	327	7	2	5	38.4415184673
583	328	1	0	1	53.4124785053
583	329	2	0	2	58.8052684555
583	330	1	0	1	41.3821463743
583	331	2	0	2	54.5504623955
583	338	10	1	9	58.6278908573
583	341	1	0	1	69.5410031028
583	342	1	0	1	61.0684044679
583	347	1	0	1	68.6676960236
583	349	5	0	5	53.6625651439
583	353	1	0	1	66.6402017794
583	356	7	0	7	26.5116353889
583	357	2	0	2	46.5645013433
583	358	257	4	253	11.2002722347
583	359	2	0	2	38.3479052859
583	360	12	8	4	17.0489184255
583	363	30	0	30	19.2362889716
583	364	4	1	3	34.0721290612
583	366	12	3	9	32.5540248737
583	367	3	2	1	48.5821024427
583	368	13	5	8	23.592413571
583	371	1	0	1	111.275260174
583	375	1	0	1	99.7123474723
583	392	0	0	0	76.435351681
583	408	2	0	2	102.808483305
583	411	2	0	2	95.7203069728
583	441	0	0	0	108.559407458
583	442	1	0	1	115.729838754
583	471	1	0	1	131.791814469
583	474	1	0	1	135.542468656
583	507	1	0	1	102.428069451
583	512	2	0	2	91.5400489126
583	522	1	0	1	72.4824534198
583	524	12	0	12	64.4123214663
583	536	0	0	0	49.1102250554
583	540	0	0	0	68.0865090762
583	548	1	0	1	93.9770846038
583	552	2	1	1	34.2271454309
583	554	1	0	1	52.4797257399
583	555	18	6	12	40.4815515429
583	557	0	0	0	57.5104641385
583	558	1	0	1	65.3923566931
583	559	2	0	2	40.7116078018
583	563	6	0	6	45.7587259
583	564	3	0	3	30.1732473417
583	566	0	0	0	64.6197962029
583	568	1	0	1	67.7207238758
583	569	3	0	3	48.2953214355
583	570	1	0	1	42.007629751
583	572	7	1	6	34.5073885662
583	573	62	3	59	54.6332883863
583	576	4	0	4	55.0471055563
583	577	14	1	13	46.5171726034
583	579	2	0	2	50.216454729
583	580	1	0	1	59.4896679555
583	581	4	0	4	59.6848828154
583	582	3	0	3	16.0653150429
583	584	4	0	4	19.5423808653
583	585	63	2	61	26.2938109777
583	586	146	37	109	16.4808317945
583	587	29	0	29	25.6465054421
583	588	78	8	70	10.4628823066
584	14	1	0	1	110.306492113
584	42	1	0	1	103.843655687
584	70	2	0	2	81.4022309386
584	73	14	1	13	84.2303456923
584	74	3	0	3	79.5769205036
584	75	6	1	5	83.192790552
584	78	5	0	5	78.781803025
584	80	1	0	1	84.2327433885
584	81	1	0	1	83.536734008
584	82	4	0	4	80.2339779187
584	85	3	0	3	75.6816375469
584	87	4	0	4	80.5198792882
584	89	1	0	1	91.49997065
584	113	1	0	1	82.2606661814
584	118	2	0	2	73.7490734012
584	158	0	0	0	54.507313483
584	166	3	0	3	56.6832763643
584	168	2	0	2	65.299398027
584	171	1	0	1	66.294252981
584	172	1	0	1	64.0197285497
584	177	2	0	2	59.2932488686
584	309	1	0	1	115.360715207
584	310	0	0	0	85.7046345334
584	319	47	0	47	36.0707247289
584	320	7	0	7	30.8052439669
584	321	2	1	1	44.4936621998
584	322	2	0	2	34.0371553265
584	324	3	1	2	39.6887058993
584	325	3	0	3	25.6747334566
584	330	2	1	1	30.2655117913
584	337	1	0	1	73.2840528812
584	338	0	0	0	61.9985064995
584	349	1	0	1	53.1590604142
584	353	0	0	0	66.332549394
584	355	1	0	1	42.2063637645
584	356	1	0	1	32.7124876195
584	358	10	3	7	29.1053108137
584	361	1	0	1	40.128785435
584	363	0	0	0	37.811701592
584	364	1	0	1	34.1032826067
584	366	3	0	3	28.7482757008
584	379	1	0	1	62.9071585946
584	408	0	0	0	83.3011149079
584	411	0	0	0	76.2095201801
584	413	1	0	1	80.3590021867
584	415	1	0	1	75.9564451698
584	424	1	0	1	113.052715187
584	442	1	0	1	96.2794165363
584	474	1	0	1	117.166545001
584	507	2	0	2	94.1948130602
584	512	1	1	0	77.1798922615
584	524	5	1	4	46.4947102507
584	539	1	0	1	30.0050162571
584	540	0	0	0	56.1703119702
584	548	0	0	0	89.3494364463
584	552	6	0	6	18.9611359656
584	554	6	0	6	33.2154746383
584	555	28	5	23	20.9541892665
584	556	1	0	1	22.9727555705
584	559	3	1	2	22.1482153309
584	560	4	0	4	15.2220729362
584	563	5	0	5	26.4807668026
584	564	15	9	6	10.6577798848
584	566	0	0	0	45.8435608488
584	568	3	0	3	51.1178642662
584	569	1	0	1	32.5852271584
584	570	3	0	3	27.7250483392
584	572	5	2	3	20.0041671472
584	573	32	6	26	37.2726432547
584	575	1	1	0	27.2913711944
584	576	4	0	4	43.0834064917
584	577	5	0	5	34.0725533873
584	579	2	0	2	36.468037343
584	580	1	0	1	43.5958442299
584	582	1	0	1	19.0868152445
584	583	60	0	60	19.5423808653
584	585	33	9	24	13.1039049588
584	586	55	39	16	8.38984358601
584	587	7	1	6	23.2056334868
584	588	21	2	19	11.3441614096
585	1	1	0	1	112.804627942
585	5	1	0	1	117.79686105
585	48	1	0	1	104.531589187
585	70	7	0	7	68.3009246446
585	71	1	0	1	63.36758532
585	73	54	2	52	71.2090205315
585	74	11	0	11	66.5579982145
585	75	5	0	5	70.218327891
585	76	7	0	7	65.9961491382
585	78	10	3	7	65.734732699
585	79	1	0	1	73.1939467605
585	81	1	0	1	70.4527344598
585	82	8	3	5	67.1590371805
585	83	1	0	1	69.2575980845
585	84	2	0	2	69.8187725721
585	85	3	0	3	62.6036576243
585	86	4	1	3	61.7392488881
585	87	4	0	4	67.5709090834
585	90	1	0	1	59.9533590423
585	94	1	0	1	69.8007343401
585	102	1	0	1	87.8230344923
585	103	2	0	2	73.3772913111
585	112	1	0	1	76.522295502
585	113	3	0	3	69.4483636619
585	120	1	0	1	76.4088165
585	142	1	0	1	70.0960171136
585	155	3	0	3	50.6018145152
585	158	3	0	3	41.7415133762
585	159	1	0	1	41.5339442792
585	166	15	1	14	43.6614799892
585	168	6	0	6	52.4841766265
585	169	1	0	1	57.697474895
585	171	1	0	1	53.2168239193
585	172	5	2	3	51.4650681354
585	175	1	0	1	49.1580546588
585	176	1	0	1	53.9046599149
585	177	8	0	8	46.5760849083
585	179	1	0	1	58.4528203423
585	225	1	0	1	125.085698621
585	314	1	0	1	69.6697024265
585	318	2	0	2	33.67358977
585	319	525	66	459	23.2611938264
585	320	77	0	77	17.7218620002
585	321	7	0	7	31.8736501714
585	322	3	1	2	20.964350894
585	323	31	1	30	26.6802617378
585	324	5	1	4	27.8295586626
585	325	55	40	15	12.7507331572
585	326	2	1	1	38.5751975461
585	327	4	0	4	22.9488285734
585	329	8	1	7	41.8581830656
585	330	9	0	9	17.2463420925
585	331	3	0	3	33.1366794842
585	332	1	0	1	62.1121079705
585	338	6	0	6	51.7485530806
585	341	2	0	2	64.375777527
585	345	1	0	1	111.43786056
585	349	7	0	7	41.6144123643
585	351	1	0	1	46.7116870933
585	355	1	0	1	30.8515336086
585	356	6	0	6	26.6040769662
585	358	10	2	8	32.2426078354
585	359	0	0	0	35.4629033205
585	360	7	1	6	22.4787953536
585	361	2	1	1	29.8950428215
585	363	2	1	1	40.6358131744
585	364	6	0	6	24.0762130146
585	366	15	4	11	17.4837358708
585	367	8	0	8	34.9448451243
585	375	2	0	2	95.5828636723
585	377	2	0	2	80.6583392692
585	379	3	0	3	58.5950399951
585	385	1	0	1	50.6748169807
585	390	1	0	1	61.7953009701
585	391	1	0	1	57.4818011307
585	397	1	0	1	76.0690682406
585	406	2	0	2	83.845877636
585	408	7	1	6	79.9071347557
585	411	0	0	0	72.944988153
585	415	2	0	2	71.4109179928
585	426	0	0	0	113.038673269
585	438	2	0	2	90.9793017981
585	460	0	0	0	66.4841715367
585	469	1	0	1	89.6266831831
585	507	0	0	0	105.170086855
585	512	1	0	1	84.8230449027
585	524	23	0	23	50.9315315071
585	529	1	0	1	62.5002671632
585	535	1	0	1	72.7199122762
585	536	0	0	0	52.7647328891
585	551	14	3	11	14.6197540968
585	552	2	0	2	29.0423735315
585	554	14	0	14	34.9737705608
585	555	53	0	53	22.1838697633
585	557	1	0	1	37.2902673082
585	560	8	3	5	12.8872705037
585	561	1	0	1	39.786470554
585	563	14	3	11	23.382953043
585	564	6	1	5	15.3038784885
585	565	2	0	2	49.2713109884
585	566	4	0	4	39.8462573519
585	568	2	1	1	41.4421146736
585	569	7	0	7	22.0019129269
585	570	6	0	6	15.9066065983
585	572	112	38	74	8.22817347271
585	573	128	1	127	28.6649274231
585	575	1	0	1	19.4603487712
585	576	5	0	5	30.4196735235
585	577	16	2	14	21.4436520701
585	579	19	5	14	24.4555662626
585	581	7	0	7	33.8815657222
585	582	2	0	2	16.1152847609
585	583	28	0	28	26.2938109777
585	584	7	1	6	13.1039049588
585	586	115	2	113	9.89716497769
585	587	43	0	43	14.0329525782
585	588	4	0	4	22.242994545
586	1	1	0	1	121.690257644
586	35	1	0	1	105.574735893
586	38	1	0	1	98.1065083364
586	70	5	0	5	76.2903625055
586	71	1	0	1	72.066294974
586	73	32	5	27	79.7088238706
586	74	8	0	8	75.080547807
586	75	3	0	3	78.8649081106
586	76	3	0	3	74.1143949107
586	78	4	1	3	74.1504922802
586	79	1	0	1	81.4567499862
586	81	5	0	5	78.6420539922
586	82	6	1	5	75.4235628604
586	84	5	0	5	78.3495920317
586	85	7	1	6	70.864433064
586	86	1	0	1	70.3380183311
586	87	3	1	2	76.2899202882
586	88	1	0	1	74.3247330586
586	89	1	0	1	86.20926383
586	103	1	0	1	82.2107554152
586	109	1	0	1	72.9263273947
586	112	2	0	2	85.3425402417
586	113	2	0	2	78.4229117788
586	119	0	0	0	65.7608034034
586	124	0	0	0	93.2498086248
586	129	1	0	1	90.2099616079
586	145	1	0	1	88.4955137528
586	146	1	0	1	72.7025676813
586	155	1	0	1	58.4482289724
586	163	1	0	1	65.1153419887
586	166	9	0	9	50.9156625756
586	168	1	0	1	61.5107103691
586	169	1	0	1	64.4162380969
586	171	1	0	1	61.5227867791
586	177	2	0	2	55.7619364645
586	183	1	0	1	153.337341566
586	277	1	0	1	117.640257454
586	310	1	0	1	77.9262999254
586	318	1	0	1	38.9751886502
586	319	281	52	229	30.0522182101
586	320	13	0	13	25.7726066611
586	321	5	1	4	38.0150638738
586	322	1	0	1	29.6368842423
586	323	17	4	13	35.4415947931
586	324	7	2	5	32.5410068503
586	325	14	1	13	20.2798095385
586	326	1	0	1	43.7818671864
586	327	7	2	5	27.7044955469
586	328	2	1	1	41.0415708116
586	329	6	0	6	48.0172893054
586	330	1	0	1	26.2208420003
586	331	4	0	4	41.1053656708
586	338	11	0	11	53.914542008
586	341	1	0	1	66.132982579
586	347	2	0	2	58.9004921951
586	349	4	1	3	45.6466940962
586	350	1	0	1	80.687278742
586	353	0	0	0	58.8978632198
586	355	2	0	2	34.7018070134
586	356	2	0	2	24.3328212864
586	357	2	0	2	39.5126120143
586	358	13	0	13	23.6128914703
586	359	1	0	1	35.3033737135
586	360	7	0	7	17.1311913116
586	363	5	0	5	32.2882653535
586	364	6	2	4	26.1779965368
586	366	10	0	10	21.5099596981
586	367	1	0	1	39.4438675569
586	368	3	0	3	26.9039585552
586	375	0	0	0	97.32398117
586	392	0	0	0	60.5736844079
586	396	2	0	2	86.5757130184
586	408	0	0	0	87.751771743
586	411	1	0	1	80.7059661472
586	415	3	0	3	79.7416199201
586	421	1	0	1	107.245593108
586	438	1	0	1	96.8812023758
586	475	3	0	3	83.5493448851
586	520	1	0	1	67.4686207451
586	524	15	2	13	54.0093651977
586	529	1	0	1	58.6868819055
586	536	0	0	0	48.8311229432
586	549	0	0	0	88.0817209804
586	552	3	0	3	27.3472990547
586	553	1	0	1	41.3204793289
586	554	6	0	6	39.6488310138
586	555	30	3	27	26.8121815406
586	556	1	0	1	30.4599720933
586	557	1	0	1	43.4512712529
586	559	1	0	1	29.6201703008
586	560	5	2	3	18.907895578
586	561	1	0	1	41.4484337703
586	563	3	0	3	30.5102357271
586	564	7	2	5	17.1842092788
586	566	3	0	3	48.5927019229
586	569	4	2	2	31.8682956657
586	570	2	0	2	25.7767314485
586	572	27	0	27	18.1225990623
586	573	75	10	65	38.1841165935
586	575	3	0	3	28.59066847
586	576	4	1	3	39.7688179693
586	577	13	0	13	30.9218559763
586	578	1	0	1	51.3257698458
586	579	6	0	6	34.2295313342
586	581	6	0	6	43.6874875953
586	582	11	5	6	10.8220244006
586	583	112	31	81	16.4808317945
586	584	9	0	9	8.38984358601
586	585	183	106	77	9.89716497769
586	587	39	23	16	15.3537450583
586	588	21	2	19	13.1102596857
587	1	5	0	5	110.029401255
587	14	1	0	1	95.8860807894
587	18	1	0	1	92.0178529506
587	70	16	0	16	63.3539559635
587	71	2	0	2	60.4570884476
587	73	122	0	122	67.5834941669
587	74	7	0	7	63.0616036358
587	75	19	0	19	67.0424713906
587	76	18	0	18	61.4012520918
587	78	17	4	13	61.9430486525
587	79	1	0	1	68.8886079682
587	80	2	0	2	66.8010463391
587	81	7	0	7	65.9855406883
587	82	14	0	14	62.9316775957
587	83	5	1	4	65.4802393566
587	84	10	1	9	66.3014087983
587	85	14	4	10	58.4317910486
587	86	4	1	3	58.5471961204
587	87	10	2	8	64.6581028808
587	88	5	1	4	62.7904186829
587	90	1	0	1	54.6329368259
587	92	1	0	1	66.786500076
587	96	6	0	6	53.0206848395
587	98	1	0	1	55.000489686
587	99	2	1	1	75.5658474563
587	103	4	0	4	70.755229117
587	110	1	0	1	72.9460189177
587	111	1	0	1	69.6367597227
587	112	3	0	3	73.8180530658
587	113	11	3	8	67.365819098
587	114	1	0	1	79.2466404463
587	116	3	0	3	59.2972430893
587	119	1	0	1	53.3384587403
587	131	1	0	1	93.1843118318
587	142	0	0	0	71.0975147262
587	145	1	0	1	79.8833436968
587	146	1	0	1	62.0592221222
587	147	1	0	1	70.4483572875
587	149	0	0	0	78.8419399347
587	155	14	0	14	45.5921564464
587	156	2	0	2	47.1697441373
587	158	1	0	1	41.0404949604
587	159	5	0	5	38.2413370361
587	162	1	0	1	43.6553469598
587	163	1	0	1	59.5316503258
587	164	2	0	2	52.2844824732
587	166	30	1	29	37.4629525831
587	168	12	0	12	50.9309989192
587	169	1	0	1	50.1862881319
587	170	1	0	1	33.5518347885
587	171	3	0	3	49.3434676445
587	172	8	0	8	51.2102385153
587	175	1	0	1	46.2840635142
587	177	8	0	8	45.8319877562
587	180	1	0	1	44.6093213419
587	183	3	0	3	138.09563602
587	257	1	0	1	88.0579437821
587	277	0	0	0	102.830515224
587	309	2	0	2	97.7238525729
587	310	0	0	0	62.5899309528
587	318	6	0	6	24.1710243128
587	319	1791	33	1758	17.1817993431
587	320	132	120	12	15.7908263785
587	321	30	1	29	23.8531104552
587	322	8	2	6	20.2853153041
587	323	84	0	84	25.5413661092
587	324	15	8	7	17.5955921682
587	325	119	1	118	11.1606145884
587	326	8	0	8	28.835388652
587	327	92	0	92	13.0144405844
587	328	5	1	4	27.7664566809
587	329	18	0	18	33.5830712899
587	330	13	0	13	18.3813382236
587	331	8	1	7	29.0801799526
587	332	1	0	1	48.5073215652
587	334	1	0	1	41.3027855332
587	338	26	0	26	38.8190984139
587	341	2	0	2	51.2337068914
587	347	3	1	2	44.0627477445
587	349	27	4	23	30.3270469016
587	351	1	0	1	35.5014698587
587	353	2	0	2	43.5911798575
587	355	12	0	12	19.4124565712
587	356	15	0	15	13.1679120923
587	357	12	3	9	24.1802340585
587	358	14	2	12	26.313325956
587	359	5	2	3	21.4693561152
587	360	9	0	9	12.8919995202
587	361	11	0	11	16.9231945648
587	362	1	0	1	18.1179192305
587	363	3	0	3	33.2061965245
587	364	24	3	21	10.8977369783
587	365	1	0	1	26.8247244355
587	366	78	25	53	6.92902942583
587	367	8	0	8	24.2717624086
587	368	1	0	1	19.8889378891
587	375	2	0	2	82.4895453838
587	377	1	0	1	67.9353669394
587	379	3	0	3	69.8269061236
587	385	0	0	0	62.0633881731
587	387	1	0	1	65.6101195275
587	396	2	0	2	88.834638551
587	404	1	0	1	85.8604104727
587	405	1	0	1	96.6056358787
587	408	8	0	8	91.3713488261
587	411	1	0	1	84.5750469378
587	415	2	0	2	82.2407137958
587	416	1	0	1	100.958545938
587	418	1	0	1	80.7827117465
587	437	0	0	0	120.210878731
587	453	1	0	1	81.4924429855
587	460	1	0	1	75.6667600719
587	465	1	0	1	99.7900548771
587	475	1	0	1	81.2809664743
587	493	2	0	2	124.250730016
587	507	1	0	1	117.378235767
587	512	1	0	1	98.5988362406
587	524	7	4	3	64.9638701014
587	529	1	0	1	73.907632211
587	536	0	0	0	64.0546822747
587	540	1	0	1	78.9409830755
587	548	1	0	1	112.320042739
587	551	3	0	3	27.2807799199
587	552	0	0	0	41.6158674963
587	554	4	0	4	48.8844342865
587	555	11	0	11	36.1870897446
587	556	1	0	1	45.8034107178
587	559	1	0	1	41.3972356595
587	560	2	0	2	26.8336205289
587	563	4	1	3	36.5247023576
587	564	1	0	1	28.9232392844
587	566	1	0	1	50.5223832187
587	567	3	0	3	41.4350673339
587	568	2	0	2	48.222509682
587	569	5	2	3	29.480584662
587	570	2	0	2	22.4401460739
587	571	2	0	2	47.1982260852
587	572	22	9	13	17.9343616175
587	573	123	38	85	37.8054272878
587	575	1	0	1	30.4520242147
587	576	5	2	3	31.2756034922
587	577	19	0	19	23.9593027823
587	578	1	0	1	50.5422578723
587	579	16	10	6	28.5276729216
587	580	1	0	1	39.5363997519
587	581	13	0	13	37.4435974201
587	582	7	3	4	9.68293794626
587	583	55	8	47	25.6465054421
587	584	3	0	3	23.2056334868
587	585	140	0	140	14.0329525782
587	586	128	9	119	15.3537450583
587	588	4	0	4	27.2757955095
588	1	1	0	1	134.758358107
588	41	1	0	1	112.352490169
588	51	1	0	1	121.09412197
588	70	2	0	2	89.3734216846
588	73	18	1	17	92.817439535
588	74	1	0	1	88.1877486632
588	75	4	0	4	91.9635340785
588	76	1	0	1	87.2121474971
588	78	2	0	2	87.2606529052
588	81	4	0	4	91.7443231449
588	82	1	0	1	88.5308156902
588	84	1	0	1	91.4567552129
588	85	2	0	2	83.9721632955
588	87	2	0	2	89.3793998694
588	108	1	0	1	83.9276825951
588	155	2	1	1	71.5244928206
588	158	1	0	1	63.8513353705
588	162	1	0	1	70.4826808672
588	163	1	0	1	76.8551293206
588	166	2	0	2	63.8972494248
588	177	2	1	1	68.7092836793
588	208	1	0	1	127.224093609
588	277	0	0	0	130.102530085
588	307	1	0	1	128.833361293
588	318	1	0	1	51.4104651751
588	319	82	5	77	43.0390191411
588	320	3	1	2	38.88037617
588	322	1	0	1	42.6951121261
588	323	4	0	4	48.4960103241
588	325	5	0	5	33.3899096305
588	326	2	0	2	56.1088776065
588	327	1	0	1	40.1664740678
588	329	2	0	2	60.6860615105
588	333	1	0	1	70.250069807
588	338	2	1	1	64.2273339778
588	341	0	0	0	75.8860598564
588	347	0	0	0	71.328664114
588	349	2	0	2	57.3559587708
588	356	2	1	1	32.5828184707
588	357	2	1	1	50.7395313055
588	358	30	0	30	21.5528393292
588	359	1	0	1	44.4508758761
588	360	11	0	11	23.3598807152
588	363	3	0	3	29.6955634433
588	364	1	0	1	37.493297854
588	365	0	0	0	51.9723830739
588	366	5	1	4	33.9497218697
588	368	1	0	1	31.8557955619
588	375	0	0	0	106.687021816
588	385	0	0	0	66.0831076252
588	396	1	0	1	93.7969082663
588	408	3	0	3	93.9538729061
588	411	0	0	0	86.8596139864
588	474	1	0	1	128.488486907
588	492	2	0	2	132.0121512
588	507	2	0	2	93.7725860124
588	512	1	0	1	81.2886294214
588	524	3	0	3	54.0631372751
588	530	1	0	1	42.8368449876
588	534	2	0	2	44.6046683822
588	535	1	0	1	62.0762781631
588	536	0	0	0	40.040309078
588	552	4	0	4	23.7653760563
588	554	2	0	2	42.785053995
588	555	14	3	11	31.4037458706
588	561	1	0	1	40.4661221303
588	563	2	0	2	37.6274512859
588	564	3	1	2	21.2389496974
588	568	0	0	0	62.2590617989
588	569	1	0	1	43.3917601669
588	570	3	1	2	37.9563124104
588	572	3	0	3	30.1387370401
588	573	31	3	28	48.524232002
588	575	1	0	1	38.5586749276
588	576	10	0	10	52.6154436368
588	577	4	0	4	43.6707355285
588	581	0	0	0	55.985418329
588	582	1	0	1	19.3956451564
588	583	211	50	161	10.4628823066
588	584	9	2	7	11.3441614096
588	585	31	3	28	22.242994545
588	586	70	0	70	13.1102596857
588	587	13	0	13	27.2757955095
